,Total population,Total_pop of Male,Total_pop of Female,Year,zipcode
1,514,248,266,2019,89010
2,2158,994,1164,2019,89019
3,9473,5109,4364,2019,89060
4,6160,3164,2996,2019,89061
5,1284,615,669,2019,89439
6,59832,30910,28922,2019,90001
7,53302,25422,27880,2019,90002
8,73730,36135,37595,2019,90003
9,60541,29834,30707,2019,90004
10,39732,20041,19691,2019,90005
11,59576,29494,30082,2019,90006
12,42433,21877,20556,2019,90007
13,31754,13922,17832,2019,90008
14,3822,1822,2000,2019,90010
15,111165,56227,54938,2019,90011
16,36552,22600,13952,2019,90012
17,12559,7969,4590,2019,90013
18,8688,5206,3482,2019,90014
19,22651,11517,11134,2019,90015
20,45899,22920,22979,2019,90016
21,27723,14905,12818,2019,90017
22,53490,25864,27626,2019,90018
23,64534,31779,32755,2019,90019
24,39189,19172,20017,2019,90020
25,2945,1813,1132,2019,90021
26,67014,33009,34005,2019,90022
27,46680,23685,22995,2019,90023
28,51627,22964,28663,2019,90024
29,46883,24061,22822,2019,90025
30,68906,35124,33782,2019,90026
31,44770,21731,23039,2019,90027
32,29774,16031,13743,2019,90028
33,36668,18469,18199,2019,90029
34,39916,19501,20415,2019,90031
35,48031,23664,24367,2019,90032
36,49155,23620,25535,2019,90033
37,53861,27438,26423,2019,90034
38,27272,13000,14272,2019,90035
39,37965,17540,20425,2019,90036
40,67640,33928,33712,2019,90037
41,28580,15315,13265,2019,90038
42,29510,14774,14736,2019,90039
43,12328,5979,6349,2019,90040
44,29090,13943,15147,2019,90041
45,63193,31144,32049,2019,90042
46,45873,22191,23682,2019,90043
47,99443,46908,52535,2019,90044
48,40567,19189,21378,2019,90045
49,50900,27736,23164,2019,90046
50,51411,22935,28476,2019,90047
51,21489,9723,11766,2019,90048
52,36418,16728,19690,2019,90049
53,7649,2963,4686,2019,90056
54,50152,27341,22811,2019,90057
55,2718,1138,1580,2019,90058
56,46185,21894,24291,2019,90059
57,27873,13246,14627,2019,90061
58,35916,17201,18715,2019,90062
59,53980,26611,27369,2019,90063
60,25925,12831,13094,2019,90064
61,46461,23218,23243,2019,90065
62,59167,29805,29362,2019,90066
63,2428,1117,1311,2019,90067
64,21092,10801,10291,2019,90068
65,20230,11873,8357,2019,90069
66,126,85,41,2019,90071
67,953,858,95,2019,90073
68,8382,4094,4288,2019,90077
69,0,0,0,2019,90079
70,3786,1819,1967,2019,90089
71,0,0,0,2019,90090
72,9827,4592,5235,2019,90094
73,0,0,0,2019,90095
74,101965,51445,50520,2019,90201
75,19314,9380,9934,2019,90210
76,8019,3678,4341,2019,90211
77,13314,6488,6826,2019,90212
78,52817,24735,28082,2019,90220
79,51688,26313,25375,2019,90221
80,33200,16443,16757,2019,90222
81,32687,15431,17256,2019,90230
82,14780,7054,7726,2019,90232
83,26413,13052,13361,2019,90240
84,43215,21649,21566,2019,90241
85,42694,20075,22619,2019,90242
86,16731,8258,8473,2019,90245
87,48293,23667,24626,2019,90247
88,11607,5560,6047,2019,90248
89,26429,12847,13582,2019,90249
90,97072,47533,49539,2019,90250
91,19539,10501,9038,2019,90254
92,75019,37443,37576,2019,90255
93,34827,17793,17034,2019,90260
94,70536,34414,36122,2019,90262
95,1838,770,1068,2019,90263
96,17954,8949,9005,2019,90265
97,35500,17155,18345,2019,90266
98,27287,13520,13767,2019,90270
99,21629,10423,11206,2019,90272
100,25061,12189,12872,2019,90274
101,42146,20214,21932,2019,90275
102,34827,17080,17747,2019,90277
103,40252,20545,19707,2019,90278
104,94642,46826,47816,2019,90280
105,5681,2783,2898,2019,90290
106,26950,13856,13094,2019,90291
107,23549,12260,11289,2019,90292
108,12728,6276,6452,2019,90293
109,38234,19135,19099,2019,90301
110,30017,13994,16023,2019,90302
111,24374,12045,12329,2019,90303
112,25946,13147,12799,2019,90304
113,15042,7073,7969,2019,90305
114,7111,3841,3270,2019,90401
115,11882,5730,6152,2019,90402
116,23902,11394,12508,2019,90403
117,22929,11490,11439,2019,90404
118,28156,14366,13790,2019,90405
119,41975,20663,21312,2019,90501
120,17778,8974,8804,2019,90502
121,44605,21583,23022,2019,90503
122,33410,16144,17266,2019,90504
123,37220,18080,19140,2019,90505
124,0,0,0,2019,90506
125,32053,15226,16827,2019,90601
126,25581,12726,12855,2019,90602
127,21584,10921,10663,2019,90603
128,42911,20818,22093,2019,90604
129,40192,20087,20105,2019,90605
130,32987,16743,16244,2019,90606
131,46414,22218,24196,2019,90620
132,35598,18329,17269,2019,90621
133,15662,7786,7876,2019,90623
134,49205,23866,25339,2019,90630
135,69064,33771,35293,2019,90631
136,49227,24009,25218,2019,90638
137,62730,30411,32319,2019,90640
138,105304,52545,52759,2019,90650
139,63001,30077,32924,2019,90660
140,16700,7995,8705,2019,90670
141,30531,14626,15905,2019,90680
142,16801,7886,8915,2019,90701
143,50589,25062,25527,2019,90703
144,3979,1998,1981,2019,90704
145,77195,37604,39591,2019,90706
146,28045,13311,14734,2019,90710
147,31217,14962,16255,2019,90712
148,28202,14118,14084,2019,90713
149,20256,9674,10582,2019,90715
150,14285,7261,7024,2019,90716
151,21508,10543,10965,2019,90717
152,22261,10736,11525,2019,90720
153,54513,27491,27022,2019,90723
154,60659,29853,30806,2019,90731
155,22780,10837,11943,2019,90732
156,24307,11293,13014,2019,90740
157,692,367,325,2019,90742
158,236,129,107,2019,90743
159,56880,28563,28317,2019,90744
160,56930,27920,29010,2019,90745
161,27075,13039,14036,2019,90746
162,0,0,0,2019,90747
163,11545,5205,6340,2019,90755
164,38962,20513,18449,2019,90802
165,32126,15575,16551,2019,90803
166,39239,19245,19994,2019,90804
167,95995,46711,49284,2019,90805
168,41990,20762,21228,2019,90806
169,32202,16291,15911,2019,90807
170,39330,19492,19838,2019,90808
171,37251,18056,19195,2019,90810
172,58380,29354,29026,2019,90813
173,19685,9212,10473,2019,90814
174,41312,20155,21157,2019,90815
175,133,111,22,2019,90822
176,0,0,0,2019,90831
177,37818,18596,19222,2019,91001
178,32958,15966,16992,2019,91006
179,34116,16004,18112,2019,91007
180,1084,488,596,2019,91008
181,26380,12287,14093,2019,91010
182,20301,9831,10470,2019,91011
183,41105,19997,21108,2019,91016
184,8633,4105,4528,2019,91020
185,10932,5077,5855,2019,91024
186,25637,12570,13067,2019,91030
187,20049,9900,10149,2019,91040
188,26966,13237,13729,2019,91042
189,158,91,67,2019,91046
190,21395,9680,11715,2019,91101
191,27659,13143,14516,2019,91103
192,37874,17951,19923,2019,91104
193,12617,6120,6497,2019,91105
194,25543,12715,12828,2019,91106
195,32503,15946,16557,2019,91107
196,13375,6540,6835,2019,91108
197,23281,10671,12610,2019,91201
198,23345,10859,12486,2019,91202
199,15410,7411,7999,2019,91203
200,18723,9084,9639,2019,91204
201,37638,17452,20186,2019,91205
202,34739,16132,18607,2019,91206
203,11031,5230,5801,2019,91207
204,15860,7522,8338,2019,91208
205,529,308,221,2019,91210
206,30787,14687,16100,2019,91214
207,26334,12929,13405,2019,91301
208,26712,12940,13772,2019,91302
209,31586,15906,15680,2019,91303
210,54361,26904,27457,2019,91304
211,49678,24715,24963,2019,91306
212,26341,12896,13445,2019,91307
213,40839,20289,20550,2019,91311
214,30499,14136,16363,2019,91316
215,44968,22326,22642,2019,91320
216,34014,16896,17118,2019,91321
217,29670,15959,13711,2019,91324
218,34575,16614,17961,2019,91325
219,36339,18047,18292,2019,91326
220,3257,1250,2007,2019,91330
221,105458,52761,52697,2019,91331
222,81824,40184,41640,2019,91335
223,36156,17781,18375,2019,91340
224,94595,46949,47646,2019,91342
225,66743,32289,34454,2019,91343
226,53613,27002,26611,2019,91344
227,19145,9652,9493,2019,91345
228,36173,18209,17964,2019,91350
229,32711,16406,16305,2019,91351
230,47076,23219,23857,2019,91352
231,32544,15864,16680,2019,91354
232,30526,15527,14999,2019,91355
233,29822,14483,15339,2019,91356
234,43121,21316,21805,2019,91360
235,20258,9622,10636,2019,91361
236,36604,17697,18907,2019,91362
237,27971,13825,14146,2019,91364
238,45970,21723,24247,2019,91367
239,0,0,0,2019,91371
240,13853,6785,7068,2019,91377
241,19390,9651,9739,2019,91381
242,29212,17228,11984,2019,91384
243,42034,20726,21308,2019,91387
244,19168,10049,9119,2019,91390
245,39755,19499,20256,2019,91401
246,72059,35712,36347,2019,91402
247,25156,12459,12697,2019,91403
248,55506,26917,28589,2019,91405
249,54890,27763,27127,2019,91406
250,26111,12850,13261,2019,91411
251,33172,15936,17236,2019,91423
252,15292,7284,8008,2019,91436
253,20511,9925,10586,2019,91501
254,10708,4901,5807,2019,91502
255,26749,13272,13477,2019,91504
256,30902,14965,15937,2019,91505
257,18591,8570,10021,2019,91506
258,36841,19056,17785,2019,91601
259,19672,9539,10133,2019,91602
260,32910,16163,16747,2019,91604
261,53113,26667,26446,2019,91605
262,44295,22505,21790,2019,91606
263,30611,14882,15729,2019,91607
264,21,11,10,2019,91608
265,39461,19827,19634,2019,91701
266,62066,30068,31998,2019,91702
267,76930,38765,38165,2019,91706
268,4009,1122,2887,2019,91708
269,80701,39281,41420,2019,91709
270,91773,52507,39266,2019,91710
271,36777,17509,19268,2019,91711
272,34631,16854,17777,2019,91722
273,18521,8935,9586,2019,91723
274,26717,13260,13457,2019,91724
275,72407,35112,37295,2019,91730
276,30222,15160,15062,2019,91731
277,62905,31144,31761,2019,91732
278,45365,22818,22547,2019,91733
279,25154,12366,12788,2019,91737
280,39875,19899,19976,2019,91739
281,25877,12648,13229,2019,91740
282,26794,12934,13860,2019,91741
283,85421,42896,42525,2019,91744
284,55202,27878,27324,2019,91745
285,29709,14513,15196,2019,91746
286,47079,23225,23854,2019,91748
287,34129,16518,17611,2019,91750
288,35694,17861,17833,2019,91752
289,33636,15842,17794,2019,91754
290,26803,13199,13604,2019,91755
291,307,146,161,2019,91759
292,61425,30136,31289,2019,91761
293,61718,30071,31647,2019,91762
294,38863,19048,19815,2019,91763
295,56677,27972,28705,2019,91764
296,46593,22633,23960,2019,91765
297,72348,36585,35763,2019,91766
298,50606,24650,25956,2019,91767
299,35191,17085,18106,2019,91768
300,62703,30918,31785,2019,91770
301,34007,15802,18205,2019,91773
302,25004,12165,12839,2019,91775
303,38664,18803,19861,2019,91776
304,35133,16734,18399,2019,91780
305,26090,12438,13652,2019,91784
306,53697,25733,27964,2019,91786
307,44440,21260,23180,2019,91789
308,45444,22166,23278,2019,91790
309,33397,16326,17071,2019,91791
310,29619,13980,15639,2019,91792
311,54768,26117,28651,2019,91801
312,29567,14867,14700,2019,91803
313,18162,9032,9130,2019,91901
314,18896,9235,9661,2019,91902
315,1472,759,713,2019,91905
316,4428,2519,1909,2019,91906
317,74855,36694,38161,2019,91910
318,84026,41145,42881,2019,91911
319,54114,26956,27158,2019,91913
320,17379,8801,8578,2019,91914
321,33485,16745,16740,2019,91915
322,1939,1001,938,2019,91916
323,986,441,545,2019,91917
324,613,263,350,2019,91931
325,26492,13705,12787,2019,91932
326,323,216,107,2019,91934
327,8550,4294,4256,2019,91935
328,31918,15199,16719,2019,91941
329,40151,18621,21530,2019,91942
330,27236,13218,14018,2019,91945
331,130,76,54,2019,91948
332,62859,31691,31168,2019,91950
333,2106,1159,947,2019,91962
334,1182,656,526,2019,91963
335,64750,32015,32735,2019,91977
336,10506,5269,5237,2019,91978
337,0,0,0,2019,91980
338,5160,2719,2441,2019,92003
339,2299,1157,1142,2019,92004
340,11417,5649,5768,2019,92007
341,27151,13700,13451,2019,92008
342,46612,22143,24469,2019,92009
343,16346,7854,8492,2019,92010
344,24144,11656,12488,2019,92011
345,13568,6843,6725,2019,92014
346,43272,21232,22040,2019,92019
347,59743,29866,29877,2019,92020
348,70148,35601,34547,2019,92021
349,51381,25237,26144,2019,92024
350,52985,26628,26357,2019,92025
351,50321,25339,24982,2019,92026
352,56788,29328,27460,2019,92027
353,48173,23987,24186,2019,92028
354,19382,9555,9827,2019,92029
355,2593,1497,1096,2019,92036
356,38168,18868,19300,2019,92037
357,46306,23860,22446,2019,92040
358,41807,20631,21176,2019,92054
359,11765,10671,1094,2019,92055
360,52337,25573,26764,2019,92056
361,60414,30125,30289,2019,92057
362,46029,25029,21000,2019,92058
363,1464,654,810,2019,92059
364,166,137,29,2019,92060
365,2660,1427,1233,2019,92061
366,49805,24310,25495,2019,92064
367,37505,19399,18106,2019,92065
368,693,329,364,2019,92066
369,7724,3586,4138,2019,92067
370,50376,24744,25632,2019,92069
371,786,428,358,2019,92070
372,57710,27491,30219,2019,92071
373,12752,5905,6847,2019,92075
374,50510,24755,25755,2019,92078
375,29596,14862,14734,2019,92081
376,18705,9371,9334,2019,92082
377,39509,20342,19167,2019,92083
378,51619,26279,25340,2019,92084
379,1543,751,792,2019,92086
380,1313,614,699,2019,92091
381,41159,23061,18098,2019,92101
382,44010,22740,21270,2019,92102
383,34700,16817,17883,2019,92103
384,45435,22682,22753,2019,92104
385,73623,36964,36659,2019,92105
386,20155,10218,9937,2019,92106
387,31223,15760,15463,2019,92107
388,22280,11108,11172,2019,92108
389,47111,24946,22165,2019,92109
390,30108,14603,15505,2019,92110
391,50693,26458,24235,2019,92111
392,58408,30923,27485,2019,92113
393,68851,34488,34363,2019,92114
394,64343,31593,32750,2019,92115
395,33408,16855,16553,2019,92116
396,56983,29065,27918,2019,92117
397,22548,11760,10788,2019,92118
398,24831,11785,13046,2019,92119
399,30550,15847,14703,2019,92120
400,4729,2554,2175,2019,92121
401,48071,24603,23468,2019,92122
402,32473,16965,15508,2019,92123
403,32600,15917,16683,2019,92124
404,82658,42442,40216,2019,92126
405,49935,24398,25537,2019,92127
406,51357,24364,26993,2019,92128
407,54762,26676,28086,2019,92129
408,56134,27482,28652,2019,92130
409,34727,17011,17716,2019,92131
410,0,0,0,2019,92132
411,285,221,64,2019,92134
412,635,563,72,2019,92135
413,36105,17465,18640,2019,92139
414,3737,3642,95,2019,92140
415,1883,935,948,2019,92145
416,518,465,53,2019,92147
417,88979,45922,43057,2019,92154
418,456,422,34,2019,92155
419,31000,14779,16221,2019,92173
420,65726,31550,34176,2019,92201
421,31140,15419,15721,2019,92203
422,5138,2460,2678,2019,92210
423,25056,11309,13747,2019,92211
424,33525,15882,17643,2019,92220
425,0,0,0,2019,92222
426,55580,26725,28855,2019,92223
427,22460,14462,7998,2019,92225
428,27189,13258,13931,2019,92227
429,2705,1026,1679,2019,92230
430,40064,18952,21112,2019,92231
431,7509,5846,1663,2019,92233
432,54357,27206,27151,2019,92234
433,45477,21799,23678,2019,92236
434,227,129,98,2019,92239
435,35278,17852,17426,2019,92240
436,7699,3961,3738,2019,92241
437,1312,683,629,2019,92242
438,50402,25332,25070,2019,92243
439,7861,4103,3758,2019,92249
440,8655,4461,4194,2019,92250
441,23970,13245,10725,2019,92251
442,9351,4695,4656,2019,92252
443,40929,20657,20272,2019,92253
444,9779,5082,4697,2019,92254
445,3100,1556,1544,2019,92256
446,1281,651,630,2019,92257
447,559,330,229,2019,92258
448,121,53,68,2019,92259
449,34660,17162,17498,2019,92260
450,28618,16795,11823,2019,92262
451,20072,11908,8164,2019,92264
452,112,85,27,2019,92266
453,6,6,0,2019,92267
454,455,265,190,2019,92268
455,18193,9262,8931,2019,92270
456,2010,889,1121,2019,92273
457,15317,8216,7101,2019,92274
458,2632,1188,1444,2019,92275
459,6748,3513,3235,2019,92276
460,23172,11857,11315,2019,92277
461,4890,4081,809,2019,92278
462,0,0,0,2019,92280
463,2591,1286,1305,2019,92281
464,1372,756,616,2019,92282
465,1684,772,912,2019,92283
466,26182,12604,13578,2019,92284
467,2430,1320,1110,2019,92285
468,34250,18407,15843,2019,92301
469,23,23,0,2019,92304
470,657,286,371,2019,92305
471,39149,18988,20161,2019,92307
472,42207,20215,21992,2019,92308
473,572,271,301,2019,92309
474,9872,5917,3955,2019,92310
475,33454,15398,18056,2019,92311
476,12547,5966,6581,2019,92313
477,11385,5761,5624,2019,92314
478,5247,2617,2630,2019,92315
479,28704,14526,14178,2019,92316
480,8753,4398,4355,2019,92320
481,1042,494,548,2019,92321
482,672,333,339,2019,92322
483,59972,28515,31457,2019,92324
484,7948,4098,3850,2019,92325
485,737,450,287,2019,92327
486,438,223,215,2019,92328
487,97,94,3,2019,92332
488,392,205,187,2019,92333
489,99306,49854,49452,2019,92335
490,98346,48849,49497,2019,92336
491,39240,19865,19375,2019,92337
492,0,0,0,2019,92338
493,1077,530,547,2019,92339
494,222,110,112,2019,92341
495,6737,3350,3387,2019,92342
496,23349,12013,11336,2019,92344
497,82110,40242,41868,2019,92345
498,63857,33554,30303,2019,92346
499,702,294,408,2019,92347
500,5578,2632,2946,2019,92352
501,22050,10130,11920,2019,92354
502,6573,3417,3156,2019,92356
503,722,389,333,2019,92358
504,9170,4585,4585,2019,92359
505,5348,2670,2678,2019,92363
506,6,6,0,2019,92364
507,2733,1521,1212,2019,92365
508,1019,511,508,2019,92368
509,18269,9131,9138,2019,92371
510,6071,2845,3226,2019,92372
511,33353,15499,17854,2019,92373
512,43391,21076,22315,2019,92374
513,86085,43049,43036,2019,92376
514,20476,9837,10639,2019,92377
515,234,118,116,2019,92378
516,4462,2241,2221,2019,92382
517,17,13,4,2019,92384
518,216,122,94,2019,92385
519,2248,1018,1230,2019,92386
520,168,105,63,2019,92389
521,1959,1042,917,2019,92391
522,58393,27623,30770,2019,92392
523,34915,18896,16019,2019,92394
524,43908,21282,22626,2019,92395
525,4562,2353,2209,2019,92397
526,2195,1206,989,2019,92398
527,54268,26454,27814,2019,92399
528,2257,1065,1192,2019,92401
529,62915,30707,32208,2019,92404
530,30112,14698,15414,2019,92405
531,68545,35359,33186,2019,92407
532,13635,7222,6413,2019,92408
533,45052,21606,23446,2019,92410
534,25650,12341,13309,2019,92411
535,21590,11311,10279,2019,92501
536,95551,47995,47556,2019,92503
537,59896,29690,30206,2019,92504
538,53282,26696,26586,2019,92505
539,46241,23109,23132,2019,92506
540,59152,29519,29633,2019,92507
541,38428,19076,19352,2019,92508
542,81383,40711,40672,2019,92509
543,1021,454,567,2019,92518
544,58184,28876,29308,2019,92530
545,25923,12846,13077,2019,92532
546,3076,1586,1490,2019,92536
547,4557,2349,2208,2019,92539
548,38314,18162,20152,2019,92543
549,49923,24676,25247,2019,92544
550,41879,20289,21590,2019,92545
551,7859,4124,3735,2019,92548
552,2517,1199,1318,2019,92549
553,34011,16088,17923,2019,92551
554,76102,37418,38684,2019,92553
555,44452,21263,23189,2019,92555
556,53406,25837,27569,2019,92557
557,1462,838,624,2019,92561
558,64286,30537,33749,2019,92562
559,69469,34233,35236,2019,92563
560,10648,5245,5403,2019,92567
561,60686,31378,29308,2019,92570
562,57622,29369,28253,2019,92571
563,17219,8489,8730,2019,92582
564,32697,15855,16842,2019,92583
565,54235,26832,27403,2019,92584
566,21907,10983,10924,2019,92585
567,19472,8792,10680,2019,92586
568,17237,9140,8097,2019,92587
569,5154,2530,2624,2019,92590
570,41609,20243,21366,2019,92591
571,84930,42497,42433,2019,92592
572,33649,16614,17035,2019,92595
573,32256,16558,15698,2019,92596
574,23238,11333,11905,2019,92602
575,19558,9447,10111,2019,92603
576,28990,14326,14664,2019,92604
577,26171,12454,13717,2019,92606
578,16360,7808,8552,2019,92610
579,33234,16258,16976,2019,92612
580,27187,13865,13322,2019,92614
581,17197,7459,9738,2019,92617
582,48997,25793,23204,2019,92618
583,52569,24872,27697,2019,92620
584,6372,3141,3231,2019,92624
585,12394,5959,6435,2019,92625
586,50605,25421,25184,2019,92626
587,63161,31793,31368,2019,92627
588,26877,13139,13738,2019,92629
589,59403,29350,30053,2019,92630
590,16053,5725,10328,2019,92637
591,55870,27286,28584,2019,92646
592,62199,31540,30659,2019,92647
593,46228,23700,22528,2019,92648
594,35278,17768,17510,2019,92649
595,24800,12306,12494,2019,92651
596,30012,14611,15401,2019,92653
597,8382,3996,4386,2019,92655
598,52268,24940,27328,2019,92656
599,9802,4590,5212,2019,92657
600,35446,16349,19097,2019,92660
601,3445,1910,1535,2019,92661
602,2519,1192,1327,2019,92662
603,21951,11812,10139,2019,92663
604,34218,16706,17512,2019,92672
605,30768,15605,15163,2019,92673
606,38803,18573,20230,2019,92675
607,2068,1010,1058,2019,92676
608,66314,31839,34475,2019,92677
609,584,281,303,2019,92678
610,32657,16252,16405,2019,92679
611,91105,44436,46669,2019,92683
612,44832,21683,23149,2019,92688
613,50839,25197,25642,2019,92691
614,46800,23193,23607,2019,92692
615,29570,14389,15181,2019,92694
616,55058,28399,26659,2019,92701
617,69112,36088,33024,2019,92703
618,88321,44261,44060,2019,92704
619,47298,24283,23015,2019,92705
620,35748,17820,17928,2019,92706
621,60831,31055,29776,2019,92707
622,56953,27552,29401,2019,92708
623,59499,29559,29940,2019,92780
624,23084,11442,11642,2019,92782
625,66594,32421,34173,2019,92801
626,42016,21232,20784,2019,92802
627,89915,44249,45666,2019,92804
628,74478,36677,37801,2019,92805
629,39442,19838,19604,2019,92806
630,35687,17739,17948,2019,92807
631,20483,9682,10801,2019,92808
632,37712,17982,19730,2019,92821
633,4872,2384,2488,2019,92823
634,37359,19146,18213,2019,92831
635,25837,12924,12913,2019,92832
636,52435,26179,26256,2019,92833
637,23528,11127,12401,2019,92835
638,54735,27563,27172,2019,92840
639,33754,16822,16932,2019,92841
640,46873,23216,23657,2019,92843
641,23189,11304,11885,2019,92844
642,16273,8409,7864,2019,92845
643,26849,14415,12434,2019,92860
644,5822,2820,3002,2019,92861
645,20664,10386,10278,2019,92865
646,15574,7168,8406,2019,92866
647,44655,21658,22997,2019,92867
648,27072,14597,12475,2019,92868
649,36846,18242,18604,2019,92869
650,53600,26602,26998,2019,92870
651,47872,23805,24067,2019,92879
652,69656,34170,35486,2019,92880
653,33531,16831,16700,2019,92881
654,73250,36396,36854,2019,92882
655,35933,17528,18405,2019,92883
656,50784,24421,26363,2019,92886
657,20012,9732,10280,2019,92887
658,32396,16263,16133,2019,93001
659,51629,25656,25973,2019,93003
660,31525,15514,16011,2019,93004
661,46063,22918,23145,2019,93010
662,36052,16757,19295,2019,93012
663,16652,8470,8182,2019,93013
664,17989,8460,9529,2019,93015
665,38581,18596,19985,2019,93021
666,7179,3699,3480,2019,93022
667,19895,9501,10394,2019,93023
668,58422,29355,29067,2019,93030
669,84701,43557,41144,2019,93033
670,29354,14460,14894,2019,93035
671,48162,24439,23723,2019,93036
672,1827,851,976,2019,93040
673,24208,12470,11738,2019,93041
674,118,113,5,2019,93042
675,144,62,82,2019,93043
676,33773,16885,16888,2019,93060
677,56458,27534,28924,2019,93063
678,0,0,0,2019,93064
679,71832,34857,36975,2019,93065
680,3220,1627,1593,2019,93066
681,410,173,237,2019,93067
682,31371,15338,16033,2019,93101
683,20538,10729,9809,2019,93103
684,28545,13956,14589,2019,93105
685,10401,4780,5621,2019,93108
686,10771,5679,5092,2019,93109
687,16849,8633,8216,2019,93110
688,17329,7970,9359,2019,93111
689,58546,28421,30125,2019,93117
690,1580,857,723,2019,93201
691,4273,2277,1996,2019,93202
692,22662,11461,11201,2019,93203
693,12961,8066,4895,2019,93204
694,2030,984,1046,2019,93205
695,1704,928,776,2019,93206
696,256,126,130,2019,93207
697,106,24,82,2019,93208
698,18336,10786,7550,2019,93210
699,23357,15813,7544,2019,93212
700,54958,31133,23825,2019,93215
701,871,458,413,2019,93218
702,10285,5543,4742,2019,93219
703,65,65,0,2019,93220
704,14129,6802,7327,2019,93221
705,1583,833,750,2019,93222
706,10716,5154,5562,2019,93223
707,471,252,219,2019,93224
708,4782,2325,2457,2019,93225
709,121,71,50,2019,93226
710,67605,34357,33248,2019,93230
711,7355,3774,3581,2019,93234
712,4215,2072,2143,2019,93235
713,673,394,279,2019,93238
714,1246,621,625,2019,93239
715,6327,3168,3159,2019,93240
716,16397,8644,7753,2019,93241
717,3474,1579,1895,2019,93242
718,1532,771,761,2019,93243
719,308,184,124,2019,93244
720,38480,20368,18112,2019,93245
721,18234,9629,8605,2019,93247
722,1875,994,881,2019,93249
723,16191,9135,7056,2019,93250
724,202,104,98,2019,93251
725,2488,1695,793,2019,93252
726,786,400,386,2019,93254
727,691,311,380,2019,93255
728,5431,2769,2662,2019,93256
729,76519,38909,37610,2019,93257
730,1952,1049,903,2019,93258
731,226,130,96,2019,93260
732,2434,1355,1079,2019,93261
733,53,18,35,2019,93262
734,22210,11043,11167,2019,93263
735,3379,1794,1585,2019,93265
736,1337,615,722,2019,93266
737,6788,3276,3512,2019,93267
738,18731,9509,9222,2019,93268
739,5367,2781,2586,2019,93270
740,2479,1302,1177,2019,93271
741,4707,2405,2302,2019,93272
742,74000,36366,37634,2019,93274
743,144,83,61,2019,93276
744,52271,25297,26974,2019,93277
745,28138,16584,11554,2019,93280
746,2261,1376,885,2019,93283
747,2477,1073,1404,2019,93285
748,9906,4971,4935,2019,93286
749,72,43,29,2019,93287
750,59270,29382,29888,2019,93291
751,42031,20258,21773,2019,93292
752,12325,6112,6213,2019,93301
753,49115,24198,24917,2019,93304
754,37902,18548,19354,2019,93305
755,72280,35786,36494,2019,93306
756,86832,43280,43552,2019,93307
757,53981,27511,26470,2019,93308
758,58538,28749,29789,2019,93309
759,45481,22578,22903,2019,93311
760,61628,30225,31403,2019,93312
761,55221,28037,27184,2019,93313
762,28963,14533,14430,2019,93314
763,28854,14929,13925,2019,93401
764,16562,8440,8122,2019,93402
765,35898,20424,15474,2019,93405
766,0,0,0,2019,93410
767,30740,14421,16319,2019,93420
768,33466,16862,16604,2019,93422
769,795,384,411,2019,93424
770,1568,870,698,2019,93426
771,6200,3038,3162,2019,93427
772,5859,2770,3089,2019,93428
773,144,47,97,2019,93429
774,2847,1453,1394,2019,93430
775,1503,637,866,2019,93432
776,13535,6595,6940,2019,93433
777,7451,3813,3638,2019,93434
778,56323,30674,25649,2019,93436
779,3387,2025,1362,2019,93437
780,1659,819,840,2019,93440
781,922,418,504,2019,93441
782,10917,5298,5619,2019,93442
783,21331,10843,10488,2019,93444
784,7106,3648,3458,2019,93445
785,44636,22125,22511,2019,93446
786,8180,3860,4320,2019,93449
787,767,378,389,2019,93450
788,4477,2532,1945,2019,93451
789,658,412,246,2019,93452
790,2578,1301,1277,2019,93453
791,40432,20081,20351,2019,93454
792,46175,22136,24039,2019,93455
793,57256,29033,28223,2019,93458
794,5284,2541,2743,2019,93460
795,1349,716,633,2019,93461
796,7911,3637,4274,2019,93463
797,9202,4418,4784,2019,93465
798,4802,2394,2408,2019,93501
799,13774,8097,5677,2019,93505
800,7644,3960,3684,2019,93510
801,328,199,129,2019,93512
802,1621,782,839,2019,93513
803,14175,7114,7061,2019,93514
804,2244,1152,1092,2019,93516
805,641,431,210,2019,93517
806,814,392,422,2019,93518
807,0,0,0,2019,93519
808,100,61,39,2019,93522
809,3556,1870,1686,2019,93523
810,165,157,8,2019,93524
811,629,326,303,2019,93526
812,1559,627,932,2019,93527
813,119,50,69,2019,93528
814,390,200,190,2019,93529
815,10,5,5,2019,93530
816,338,193,145,2019,93531
817,2683,1511,1172,2019,93532
818,39367,18355,21012,2019,93534
819,74264,36797,37467,2019,93535
820,70237,37373,32864,2019,93536
821,244,167,77,2019,93541
822,14392,7222,7170,2019,93543
823,1164,699,465,2019,93544
824,1821,978,843,2019,93545
825,9591,5023,4568,2019,93546
826,293,176,117,2019,93549
827,77506,37463,40043,2019,93550
828,50601,24633,25968,2019,93551
829,39905,20487,19418,2019,93552
830,1709,801,908,2019,93553
831,125,49,76,2019,93554
832,33833,16901,16932,2019,93555
833,26,17,9,2019,93558
834,21756,11194,10562,2019,93560
835,34979,19991,14988,2019,93561
836,1771,920,851,2019,93562
837,357,233,124,2019,93563
838,6744,2978,3766,2019,93591
839,115,60,55,2019,93592
840,1674,903,771,2019,93601
841,3530,1735,1795,2019,93602
842,175,90,85,2019,93603
843,541,222,319,2019,93604
844,198,93,105,2019,93605
845,1035,468,567,2019,93606
846,1280,731,549,2019,93608
847,5177,2594,2583,2019,93609
848,22724,10054,12670,2019,93610
849,49053,23908,25145,2019,93611
850,35140,17474,17666,2019,93612
851,11982,5550,6432,2019,93614
852,6347,3467,2880,2019,93615
853,2582,1408,1174,2019,93616
854,31470,16092,15378,2019,93618
855,39473,19802,19671,2019,93619
856,8906,4352,4554,2019,93620
857,136,99,37,2019,93621
858,10335,5470,4865,2019,93622
859,114,63,51,2019,93623
860,871,512,359,2019,93624
861,8059,3835,4224,2019,93625
862,2427,1105,1322,2019,93626
863,247,101,146,2019,93627
864,83,45,38,2019,93628
865,20764,10692,10072,2019,93630
866,16282,7657,8625,2019,93631
867,0,0,0,2019,93633
868,22,9,13,2019,93634
869,41180,20796,20384,2019,93635
870,13255,6720,6535,2019,93636
871,41108,19135,21973,2019,93637
872,49932,25345,24587,2019,93638
873,12920,6928,5992,2019,93640
874,223,177,46,2019,93641
875,2783,1589,1194,2019,93643
876,9055,4349,4706,2019,93644
877,148,52,96,2019,93645
878,11738,5980,5758,2019,93646
879,11407,5872,5535,2019,93647
880,16087,8284,7803,2019,93648
881,3173,1457,1716,2019,93650
882,1798,1016,782,2019,93651
883,540,308,232,2019,93652
884,1377,692,685,2019,93653
885,30373,15384,14989,2019,93654
886,5806,2901,2905,2019,93656
887,35666,18268,17398,2019,93657
888,4090,1969,2121,2019,93660
889,30725,15544,15181,2019,93662
890,380,221,159,2019,93664
891,752,324,428,2019,93665
892,866,446,420,2019,93666
893,2405,1130,1275,2019,93667
894,1219,675,544,2019,93668
895,238,98,140,2019,93669
896,754,357,397,2019,93673
897,3905,2107,1798,2019,93675
898,10166,4863,5303,2019,93701
899,43601,22188,21413,2019,93702
900,32754,16144,16610,2019,93703
901,29740,14316,15424,2019,93704
902,36808,18016,18792,2019,93705
903,40586,20440,20146,2019,93706
904,33448,15870,17578,2019,93710
905,38007,18281,19726,2019,93711
906,47081,22161,24920,2019,93720
907,7650,5048,2602,2019,93721
908,84621,42007,42614,2019,93722
909,13936,6695,7241,2019,93723
910,27214,13428,13786,2019,93725
911,42824,21094,21730,2019,93726
912,84449,41963,42486,2019,93727
913,16574,8535,8039,2019,93728
914,12770,6243,6527,2019,93730
915,28194,14154,14040,2019,93901
916,60531,31312,29219,2019,93905
917,64348,31850,32498,2019,93906
918,23299,11389,11910,2019,93907
919,12398,6130,6268,2019,93908
920,1545,829,716,2019,93920
921,3316,1581,1735,2019,93921
922,12837,5903,6934,2019,93923
923,6514,3050,3464,2019,93924
924,2073,1015,1058,2019,93925
925,9171,4840,4331,2019,93926
926,18812,9389,9423,2019,93927
927,854,691,163,2019,93928
928,17067,8940,8127,2019,93930
929,709,355,354,2019,93932
930,25442,11995,13447,2019,93933
931,32236,16048,16188,2019,93940
932,0,0,0,2019,93943
933,15547,7039,8508,2019,93950
934,4028,1933,2095,2019,93953
935,551,250,301,2019,93954
936,34566,17574,16992,2019,93955
937,26966,18260,8706,2019,93960
938,414,226,188,2019,93962
939,27155,13495,13660,2019,94002
940,4697,2272,2425,2019,94005
941,42760,20554,22206,2019,94010
942,49170,24462,24708,2019,94014
943,65041,31991,33050,2019,94015
944,20512,9770,10742,2019,94019
945,1697,990,707,2019,94020
946,511,191,320,2019,94021
947,19406,9500,9906,2019,94022
948,23675,11214,12461,2019,94024
949,43392,21043,22349,2019,94025
950,7415,3700,3715,2019,94027
951,7125,3348,3777,2019,94028
952,22625,11111,11514,2019,94030
953,2504,1153,1351,2019,94037
954,3450,1797,1653,2019,94038
955,36526,19166,17360,2019,94040
956,14572,7623,6949,2019,94041
957,31161,16048,15113,2019,94043
958,38984,19678,19306,2019,94044
959,926,536,390,2019,94060
960,39023,18733,20290,2019,94061
961,28423,13851,14572,2019,94062
962,34867,19016,15851,2019,94063
963,12461,5661,6800,2019,94065
964,43101,21156,21945,2019,94066
965,31074,14893,16181,2019,94070
966,170,99,71,2019,94074
967,67600,33196,34404,2019,94080
968,23223,12771,10452,2019,94085
969,50477,26554,23923,2019,94086
970,56668,28216,28452,2019,94087
971,22882,12083,10799,2019,94089
972,31392,17595,13797,2019,94102
973,30703,18215,12488,2019,94103
974,429,261,168,2019,94104
975,10916,5880,5036,2019,94105
976,31461,16458,15003,2019,94107
977,14143,6884,7259,2019,94108
978,57302,29248,28054,2019,94109
979,72380,38749,33631,2019,94110
980,3611,1790,1821,2019,94111
981,84707,42385,42322,2019,94112
982,34918,20323,14595,2019,94114
983,34604,17714,16890,2019,94115
984,47346,22936,24410,2019,94116
985,44650,22654,21996,2019,94117
986,42095,19562,22533,2019,94118
987,43616,21284,22332,2019,94121
988,62128,30820,31308,2019,94122
989,25890,12536,13354,2019,94123
990,35747,17213,18534,2019,94124
991,21151,10286,10865,2019,94127
992,146,78,68,2019,94128
993,4136,1901,2235,2019,94129
994,3008,1715,1293,2019,94130
995,29523,16066,13457,2019,94131
996,31436,14874,16562,2019,94132
997,26796,13729,13067,2019,94133
998,42418,21151,21267,2019,94134
999,8455,4057,4398,2019,94158
1000,16582,7940,8642,2019,94301
1001,48244,24424,23820,2019,94303
1002,3852,1850,2002,2019,94304
1003,16397,8610,7787,2019,94305
1004,27435,13156,14279,2019,94306
1005,36001,18225,17776,2019,94401
1006,25703,12685,13018,2019,94402
1007,44408,22269,22139,2019,94403
1008,36985,18328,18657,2019,94404
1009,63821,30930,32891,2019,94501
1010,14701,7309,7392,2019,94502
1011,20276,10096,10180,2019,94503
1012,16382,8027,8355,2019,94505
1013,25240,11740,13500,2019,94506
1014,15105,7872,7233,2019,94507
1015,3935,1980,1955,2019,94508
1016,68166,33223,34943,2019,94509
1017,28350,13838,14512,2019,94510
1018,2161,1177,984,2019,94511
1019,16,16,0,2019,94512
1020,64313,31254,33059,2019,94513
1021,1475,700,775,2019,94514
1022,7491,4002,3489,2019,94515
1023,103,57,46,2019,94516
1024,13687,6658,7029,2019,94517
1025,28734,14367,14367,2019,94518
1026,20041,9809,10232,2019,94519
1027,38753,20144,18609,2019,94520
1028,43281,20628,22653,2019,94521
1029,35005,17059,17946,2019,94523
1030,3290,1536,1754,2019,94525
1031,33135,16454,16681,2019,94526
1032,384,201,183,2019,94528
1033,26145,12411,13734,2019,94530
1034,43022,20271,22751,2019,94531
1035,75909,37332,38577,2019,94533
1036,39239,19275,19964,2019,94534
1037,3842,1963,1879,2019,94535
1038,74837,37638,37199,2019,94536
1039,67474,33966,33508,2019,94538
1040,54982,26490,28492,2019,94539
1041,65928,33764,32164,2019,94541
1042,14699,7339,7360,2019,94542
1043,79747,39608,40139,2019,94544
1044,32724,16153,16571,2019,94545
1045,44378,21678,22700,2019,94546
1046,25616,12385,13231,2019,94547
1047,377,219,158,2019,94548
1048,29795,13978,15817,2019,94549
1049,50374,24360,26014,2019,94550
1050,47227,23369,23858,2019,94551
1051,14938,7202,7736,2019,94552
1052,49784,24332,25452,2019,94553
1053,38478,18764,19714,2019,94555
1054,16428,7916,8512,2019,94556
1055,68315,33815,34500,2019,94558
1056,27593,14091,13502,2019,94559
1057,47171,23829,23342,2019,94560
1058,42473,21230,21243,2019,94561
1059,19644,9320,10324,2019,94563
1060,19260,8949,10311,2019,94564
1061,97671,48968,48703,2019,94565
1062,45893,22632,23261,2019,94566
1063,658,284,374,2019,94567
1064,55608,27525,28083,2019,94568
1065,180,97,83,2019,94569
1066,10605,5343,5262,2019,94571
1067,10384,4935,5449,2019,94572
1068,36,28,8,2019,94573
1069,8757,4149,4608,2019,94574
1070,1178,362,816,2019,94575
1071,105,56,49,2019,94576
1072,47682,22791,24891,2019,94577
1073,41865,19690,22175,2019,94578
1074,21883,11129,10754,2019,94579
1075,30488,15028,15460,2019,94580
1076,42576,21214,21362,2019,94582
1077,35231,17824,17407,2019,94583
1078,29525,14679,14846,2019,94585
1079,831,455,376,2019,94586
1080,74722,38683,36039,2019,94587
1081,37253,17797,19456,2019,94588
1082,31536,15031,16505,2019,94589
1083,37280,18358,18922,2019,94590
1084,55157,26806,28351,2019,94591
1085,952,447,505,2019,94592
1086,18117,7522,10595,2019,94595
1087,21700,10433,11267,2019,94596
1088,23108,11668,11440,2019,94597
1089,27831,13138,14693,2019,94598
1090,3108,1428,1680,2019,94599
1091,53039,26347,26692,2019,94601
1092,30162,14694,15468,2019,94602
1093,35862,17380,18482,2019,94603
1094,43399,21006,22393,2019,94605
1095,38220,18162,20058,2019,94606
1096,26823,13046,13777,2019,94607
1097,31013,15268,15745,2019,94608
1098,23726,11640,12086,2019,94609
1099,31936,15118,16818,2019,94610
1100,38975,18594,20381,2019,94611
1101,15785,8187,7598,2019,94612
1102,855,31,824,2019,94613
1103,17252,8017,9235,2019,94618
1104,24112,11269,12843,2019,94619
1105,35035,16932,18103,2019,94621
1106,16860,8118,8742,2019,94702
1107,21697,11273,10424,2019,94703
1108,29597,14360,15237,2019,94704
1109,13527,6540,6987,2019,94705
1110,21218,10527,10691,2019,94706
1111,11767,5805,5962,2019,94707
1112,11394,5542,5852,2019,94708
1113,11951,6127,5824,2019,94709
1114,7893,3958,3935,2019,94710
1115,2845,1295,1550,2019,94720
1116,31210,15827,15383,2019,94801
1117,25893,12601,13292,2019,94803
1118,40931,19878,21053,2019,94804
1119,14188,6816,7372,2019,94805
1120,64286,32410,31876,2019,94806
1121,0,0,0,2019,94850
1122,41713,21372,20341,2019,94901
1123,30427,14867,15560,2019,94903
1124,12994,6162,6832,2019,94904
1125,12740,6099,6641,2019,94920
1126,1075,577,498,2019,94922
1127,808,426,382,2019,94923
1128,1127,484,643,2019,94924
1129,9838,4305,5533,2019,94925
1130,44323,21249,23074,2019,94928
1131,254,107,147,2019,94929
1132,8728,4216,4512,2019,94930
1133,8926,4042,4884,2019,94931
1134,837,327,510,2019,94933
1135,742,339,403,2019,94937
1136,920,414,506,2019,94938
1137,6747,3045,3702,2019,94939
1138,287,132,155,2019,94940
1139,32009,14943,17066,2019,94941
1140,19043,9493,9550,2019,94945
1141,658,301,357,2019,94946
1142,25867,12432,13435,2019,94947
1143,18695,9481,9214,2019,94949
1144,123,76,47,2019,94950
1145,4574,2401,2173,2019,94951
1146,35503,17285,18218,2019,94952
1147,38763,19321,19442,2019,94954
1148,1146,461,685,2019,94956
1149,1219,604,615,2019,94957
1150,15868,7566,8302,2019,94960
1151,404,168,236,2019,94963
1152,3155,3030,125,2019,94964
1153,11394,5001,6393,2019,94965
1154,698,347,351,2019,94970
1155,226,92,134,2019,94971
1156,25,13,12,2019,94972
1157,1228,676,552,2019,94973
1158,2348,1242,1106,2019,95002
1159,25185,11903,13282,2019,95003
1160,4218,2280,1938,2019,95004
1161,7661,3679,3982,2019,95005
1162,9632,5019,4613,2019,95006
1163,374,150,224,2019,95007
1164,46352,22854,23498,2019,95008
1165,8856,3932,4924,2019,95010
1166,10780,5581,5199,2019,95012
1167,85,17,68,2019,95013
1168,61866,30828,31038,2019,95014
1169,681,391,290,2019,95017
1170,6841,3383,3458,2019,95018
1171,7368,3918,3450,2019,95019
1172,64833,31575,33258,2019,95020
1173,53423,26535,26888,2019,95023
1174,13481,6450,7031,2019,95030
1175,26047,12905,13142,2019,95032
1176,9511,4862,4649,2019,95033
1177,79655,41551,38104,2019,95035
1178,51994,25458,26536,2019,95037
1179,1074,587,487,2019,95039
1180,436,272,164,2019,95041
1181,731,371,360,2019,95043
1182,4217,2122,2095,2019,95045
1183,5918,2966,2952,2019,95046
1184,38699,20456,18243,2019,95050
1185,59851,31175,28676,2019,95051
1186,3862,1818,2044,2019,95053
1187,24524,12593,11931,2019,95054
1188,47801,23881,23920,2019,95060
1189,36737,18024,18713,2019,95062
1190,10486,4895,5591,2019,95064
1191,8491,3989,4502,2019,95065
1192,15341,7775,7566,2019,95066
1193,31196,15461,15735,2019,95070
1194,11013,5273,5740,2019,95073
1195,459,209,250,2019,95075
1196,86905,43823,43082,2019,95076
1197,19928,11331,8597,2019,95110
1198,61830,31169,30661,2019,95111
1199,62228,32456,29772,2019,95112
1200,2107,1181,926,2019,95113
1201,55825,28541,27284,2019,95116
1202,30369,14965,15404,2019,95117
1203,32421,15695,16726,2019,95118
1204,10027,5007,5020,2019,95119
1205,38122,18918,19204,2019,95120
1206,37531,18739,18792,2019,95121
1207,56121,28326,27795,2019,95122
1208,68766,33980,34786,2019,95123
1209,51455,26418,25037,2019,95124
1210,53155,24998,28157,2019,95125
1211,36206,18611,17595,2019,95126
1212,66256,34670,31586,2019,95127
1213,36975,18906,18069,2019,95128
1214,39741,20178,19563,2019,95129
1215,14660,7183,7477,2019,95130
1216,31236,16554,14682,2019,95131
1217,41790,21252,20538,2019,95132
1218,28565,14077,14488,2019,95133
1219,29349,15949,13400,2019,95134
1220,22015,10708,11307,2019,95135
1221,47476,23197,24279,2019,95136
1222,20674,10179,10495,2019,95138
1223,7363,3785,3578,2019,95139
1224,102,61,41,2019,95140
1225,48273,23615,24658,2019,95148
1226,6066,2921,3145,2019,95202
1227,15487,7453,8034,2019,95203
1228,28667,13833,14834,2019,95204
1229,38350,20150,18200,2019,95205
1230,64250,32029,32221,2019,95206
1231,52269,24800,27469,2019,95207
1232,44980,22446,22534,2019,95209
1233,41509,20023,21486,2019,95210
1234,1624,648,976,2019,95211
1235,29426,14269,15157,2019,95212
1236,24326,13840,10486,2019,95215
1237,29270,14302,14968,2019,95219
1238,7576,3902,3674,2019,95220
1239,5029,2323,2706,2019,95222
1240,2666,1470,1196,2019,95223
1241,167,81,86,2019,95224
1242,378,203,175,2019,95225
1243,0,0,0,2019,95226
1244,654,346,308,2019,95227
1245,4541,2331,2210,2019,95228
1246,840,432,408,2019,95230
1247,5165,3441,1724,2019,95231
1248,161,84,77,2019,95232
1249,548,198,350,2019,95233
1250,0,0,0,2019,95234
1251,4199,2133,2066,2019,95236
1252,3639,2036,1603,2019,95237
1253,48799,24511,24288,2019,95240
1254,26409,12468,13941,2019,95242
1255,1717,815,902,2019,95245
1256,1159,607,552,2019,95246
1257,4024,1903,2121,2019,95247
1258,106,58,48,2019,95248
1259,5444,2870,2574,2019,95249
1260,0,0,0,2019,95250
1261,625,259,366,2019,95251
1262,16262,8094,8168,2019,95252
1263,1035,506,529,2019,95254
1264,1289,724,565,2019,95255
1265,407,165,242,2019,95257
1266,3599,1868,1731,2019,95258
1267,39186,20225,18961,2019,95301
1268,1110,614,496,2019,95303
1269,14282,8310,5972,2019,95304
1270,0,0,0,2019,95305
1271,654,311,343,2019,95306
1272,46283,23044,23239,2019,95307
1273,1874,1051,823,2019,95310
1274,1893,918,975,2019,95311
1275,276,145,131,2019,95312
1276,1305,635,670,2019,95313
1277,95,58,37,2019,95314
1278,14520,7455,7065,2019,95315
1279,7022,3542,3480,2019,95316
1280,1203,674,529,2019,95317
1281,220,125,95,2019,95318
1282,1745,859,886,2019,95319
1283,12822,6315,6507,2019,95320
1284,3541,1611,1930,2019,95321
1285,10373,4955,5418,2019,95322
1286,1299,634,665,2019,95323
1287,8380,4355,4025,2019,95324
1288,78,38,40,2019,95325
1289,10147,4806,5341,2019,95326
1290,7918,5095,2823,2019,95327
1291,4480,2088,2392,2019,95328
1292,2570,1238,1332,2019,95329
1293,22760,11404,11356,2019,95330
1294,2539,1345,1194,2019,95333
1295,17057,8203,8854,2019,95334
1296,153,98,55,2019,95335
1297,47855,23758,24097,2019,95336
1298,39177,19015,20162,2019,95337
1299,10827,5579,5248,2019,95338
1300,35827,17434,18393,2019,95340
1301,33090,16918,16172,2019,95341
1302,802,258,544,2019,95345
1303,1251,679,572,2019,95346
1304,34002,16981,17021,2019,95348
1305,54210,26309,27901,2019,95350
1306,48542,24056,24486,2019,95351
1307,24923,12603,12320,2019,95354
1308,59621,29595,30026,2019,95355
1309,32622,16097,16525,2019,95356
1310,11765,5959,5806,2019,95357
1311,32524,17551,14973,2019,95358
1312,13278,6281,6997,2019,95360
1313,35308,17236,18072,2019,95361
1314,27908,14364,13544,2019,95363
1315,0,0,0,2019,95364
1316,4775,2527,2248,2019,95365
1317,17909,8910,8999,2019,95366
1318,25072,12203,12869,2019,95367
1319,14041,7326,6715,2019,95368
1320,1024,535,489,2019,95369
1321,28096,13654,14442,2019,95370
1322,2056,1199,857,2019,95372
1323,1682,847,835,2019,95374
1324,5,5,0,2019,95375
1325,55655,27637,28018,2019,95376
1326,32091,16074,16017,2019,95377
1327,4003,1963,2040,2019,95379
1328,42866,20262,22604,2019,95380
1329,38700,18518,20182,2019,95382
1330,3611,1971,1640,2019,95383
1331,415,209,206,2019,95385
1332,10557,5354,5203,2019,95386
1333,636,320,316,2019,95387
1334,14116,7642,6474,2019,95388
1335,1417,965,452,2019,95389
1336,20131,9499,10632,2019,95391
1337,38839,18800,20039,2019,95401
1338,45096,21695,23401,2019,95403
1339,40497,20278,20219,2019,95404
1340,21082,9873,11209,2019,95405
1341,42026,21551,20475,2019,95407
1342,27186,12361,14825,2019,95409
1343,997,497,500,2019,95410
1344,397,215,182,2019,95412
1345,1388,670,718,2019,95415
1346,356,221,135,2019,95417
1347,523,282,241,2019,95420
1348,1808,919,889,2019,95421
1349,15696,7646,8050,2019,95422
1350,3751,2026,1725,2019,95423
1351,10984,5107,5877,2019,95425
1352,1350,789,561,2019,95426
1353,226,124,102,2019,95427
1354,2580,1340,1240,2019,95428
1355,116,81,35,2019,95429
1356,7,7,0,2019,95430
1357,161,99,62,2019,95431
1358,706,406,300,2019,95432
1359,299,169,130,2019,95435
1360,6240,3206,3034,2019,95436
1361,14859,7294,7565,2019,95437
1362,728,416,312,2019,95439
1363,1797,998,799,2019,95441
1364,3213,1526,1687,2019,95442
1365,193,104,89,2019,95443
1366,705,262,443,2019,95444
1367,2257,1023,1234,2019,95445
1368,5168,2671,2497,2019,95446
1369,17407,8655,8752,2019,95448
1370,1560,838,722,2019,95449
1371,227,113,114,2019,95450
1372,11603,5679,5924,2019,95451
1373,919,428,491,2019,95452
1374,11369,5576,5793,2019,95453
1375,2107,979,1128,2019,95454
1376,838,313,525,2019,95456
1377,3227,1572,1655,2019,95457
1378,2960,1565,1395,2019,95458
1379,641,327,314,2019,95459
1380,2508,1370,1138,2019,95460
1381,2567,1204,1363,2019,95461
1382,1124,620,504,2019,95462
1383,136,57,79,2019,95463
1384,2505,1259,1246,2019,95464
1385,2244,1101,1143,2019,95465
1386,976,554,422,2019,95466
1387,5506,2638,2868,2019,95467
1388,1280,607,673,2019,95468
1389,1911,914,997,2019,95469
1390,5561,2857,2704,2019,95470
1391,573,237,336,2019,95471
1392,30736,14586,16150,2019,95472
1393,36586,17750,18836,2019,95476
1394,31482,15337,16145,2019,95482
1395,2650,1425,1225,2019,95485
1396,51,34,17,2019,95486
1397,179,107,72,2019,95488
1398,12975,6496,6479,2019,95490
1399,29271,14900,14371,2019,95492
1400,377,165,212,2019,95493
1401,171,95,76,2019,95494
1402,1134,485,649,2019,95497
1403,23324,12044,11280,2019,95501
1404,25972,12159,13813,2019,95503
1405,262,91,171,2019,95511
1406,140,90,50,2019,95514
1407,19763,10119,9644,2019,95519
1408,21068,10552,10516,2019,95521
1409,1668,798,870,2019,95524
1410,1401,765,636,2019,95525
1411,196,109,87,2019,95526
1412,499,258,241,2019,95527
1413,1437,696,741,2019,95528
1414,23737,12864,10873,2019,95531
1415,2899,1480,1419,2019,95536
1416,251,140,111,2019,95537
1417,14196,6750,7446,2019,95540
1418,1871,896,975,2019,95542
1419,705,349,356,2019,95543
1420,118,78,40,2019,95545
1421,3466,1493,1973,2019,95546
1422,1063,482,581,2019,95547
1423,1251,599,652,2019,95548
1424,929,500,429,2019,95549
1425,94,78,16,2019,95550
1426,1416,697,719,2019,95551
1427,750,389,361,2019,95552
1428,767,566,201,2019,95553
1429,508,273,235,2019,95554
1430,437,191,246,2019,95555
1431,598,312,286,2019,95556
1432,416,203,213,2019,95558
1433,70,21,49,2019,95559
1434,1615,979,636,2019,95560
1435,3401,1612,1789,2019,95562
1436,665,281,384,2019,95563
1437,389,182,207,2019,95564
1438,762,419,343,2019,95565
1439,1802,933,869,2019,95567
1440,274,178,96,2019,95568
1441,371,220,151,2019,95569
1442,2338,1142,1196,2019,95570
1443,304,127,177,2019,95571
1444,1568,793,775,2019,95573
1445,457,227,230,2019,95585
1446,51,10,41,2019,95587
1447,963,574,389,2019,95589
1448,139,86,53,2019,95595
1449,151,73,78,2019,95601
1450,17557,8738,8819,2019,95602
1451,29474,14361,15113,2019,95603
1452,85,39,46,2019,95604
1453,14493,7441,7052,2019,95605
1454,249,122,127,2019,95606
1455,389,208,181,2019,95607
1456,62539,29607,32932,2019,95608
1457,46305,22361,23944,2019,95610
1458,1321,692,629,2019,95612
1459,4359,2158,2201,2019,95614
1460,704,392,312,2019,95615
1461,52212,24180,28032,2019,95616
1462,27519,13429,14090,2019,95618
1463,5718,2844,2874,2019,95619
1464,21954,11202,10752,2019,95620
1465,41740,20201,21539,2019,95621
1466,3665,1931,1734,2019,95623
1467,65948,32522,33426,2019,95624
1468,74,67,7,2019,95625
1469,6065,3217,2848,2019,95626
1470,3802,1802,2000,2019,95627
1471,40855,19483,21372,2019,95628
1472,940,379,561,2019,95629
1473,78159,40472,37687,2019,95630
1474,6851,3532,3319,2019,95631
1475,31911,15882,16029,2019,95632
1476,4188,2091,2097,2019,95633
1477,3559,2060,1499,2019,95634
1478,1058,494,564,2019,95635
1479,1195,583,612,2019,95636
1480,268,160,108,2019,95637
1481,2126,1127,999,2019,95638
1482,335,192,143,2019,95639
1483,11598,7548,4050,2019,95640
1484,1489,686,803,2019,95641
1485,7101,3327,3774,2019,95642
1486,1881,969,912,2019,95645
1487,80,58,22,2019,95646
1488,52949,25345,27604,2019,95648
1489,14808,7534,7274,2019,95650
1490,624,347,277,2019,95651
1491,789,370,419,2019,95652
1492,581,279,302,2019,95653
1493,4156,2026,2130,2019,95655
1494,6837,3342,3495,2019,95658
1495,932,479,453,2019,95659
1496,35461,17139,18322,2019,95660
1497,31315,15016,16299,2019,95661
1498,32172,15968,16204,2019,95662
1499,2493,1097,1396,2019,95663
1500,1603,848,755,2019,95664
1501,4303,2125,2178,2019,95665
1502,5164,2718,2446,2019,95666
1503,36487,17398,19089,2019,95667
1504,664,312,352,2019,95668
1505,2315,1162,1153,2019,95669
1506,55558,27454,28104,2019,95670
1507,5266,2459,2807,2019,95672
1508,16636,8184,8452,2019,95673
1509,767,368,399,2019,95674
1510,566,296,270,2019,95675
1511,25477,12327,13150,2019,95677
1512,42053,20725,21328,2019,95678
1513,56,31,25,2019,95679
1514,10,0,10,2019,95680
1515,1246,628,618,2019,95681
1516,30314,14891,15423,2019,95682
1517,6326,2960,3366,2019,95683
1518,3129,1503,1626,2019,95684
1519,4665,2104,2561,2019,95685
1520,1262,678,584,2019,95686
1521,69060,36375,32685,2019,95687
1522,37260,18522,18738,2019,95688
1523,1698,942,756,2019,95689
1524,2215,1171,1044,2019,95690
1525,38690,18664,20026,2019,95691
1526,5251,2693,2558,2019,95692
1527,7037,3447,3590,2019,95693
1528,10495,5268,5227,2019,95694
1529,41278,20160,21118,2019,95695
1530,183,117,66,2019,95697
1531,148,93,55,2019,95698
1532,21,20,1,2019,95699
1533,915,457,458,2019,95701
1534,831,439,392,2019,95703
1535,5498,2887,2611,2019,95709
1536,10472,5390,5082,2019,95713
1537,522,233,289,2019,95714
1538,104,59,45,2019,95715
1539,176,103,73,2019,95717
1540,103,46,57,2019,95720
1541,0,0,0,2019,95721
1542,5123,2529,2594,2019,95722
1543,22,22,0,2019,95724
1544,8449,4089,4360,2019,95726
1545,231,121,110,2019,95728
1546,12,7,5,2019,95735
1547,289,86,203,2019,95736
1548,12472,6450,6022,2019,95742
1549,23934,11590,12344,2019,95746
1550,66931,32325,34606,2019,95747
1551,50727,25004,25723,2019,95757
1552,65811,31321,34490,2019,95758
1553,43052,21177,21875,2019,95762
1554,39214,19006,20208,2019,95765
1555,23911,11926,11985,2019,95776
1556,6294,3227,3067,2019,95811
1557,11908,6894,5014,2019,95814
1558,25673,13224,12449,2019,95815
1559,17199,8108,9091,2019,95816
1560,13758,6284,7474,2019,95817
1561,21625,10030,11595,2019,95818
1562,19890,9309,10581,2019,95819
1563,36437,17831,18606,2019,95820
1564,35812,16971,18841,2019,95821
1565,44741,22184,22557,2019,95822
1566,79440,38601,40839,2019,95823
1567,30296,15095,15201,2019,95824
1568,37473,17789,19684,2019,95825
1569,39145,19021,20124,2019,95826
1570,20666,10638,10028,2019,95827
1571,58717,28632,30085,2019,95828
1572,28264,13764,14500,2019,95829
1573,734,366,368,2019,95830
1574,43094,20193,22901,2019,95831
1575,12114,6144,5970,2019,95832
1576,39905,19653,20252,2019,95833
1577,30076,14497,15579,2019,95834
1578,40170,19440,20730,2019,95835
1579,300,186,114,2019,95837
1580,39053,19632,19421,2019,95838
1581,21229,9791,11438,2019,95841
1582,33522,15832,17690,2019,95842
1583,47823,23571,24252,2019,95843
1584,23352,11273,12079,2019,95864
1585,33455,16755,16700,2019,95901
1586,1653,990,663,2019,95903
1587,123,69,54,2019,95910
1588,5380,2770,2610,2019,95912
1589,752,397,355,2019,95914
1590,0,0,0,2019,95915
1591,1359,741,618,2019,95916
1592,3717,2039,1678,2019,95917
1593,2915,1727,1188,2019,95918
1594,971,526,445,2019,95919
1595,315,154,161,2019,95920
1596,831,383,448,2019,95922
1597,28,11,17,2019,95923
1598,276,140,136,2019,95925
1599,40000,19467,20533,2019,95926
1600,37735,18789,18946,2019,95928
1601,72,38,34,2019,95930
1602,7633,4019,3614,2019,95932
1603,146,97,49,2019,95934
1604,261,91,170,2019,95935
1605,158,83,75,2019,95936
1606,1540,729,811,2019,95937
1607,4446,2096,2350,2019,95938
1608,605,337,268,2019,95939
1609,775,406,369,2019,95941
1610,934,475,459,2019,95942
1611,871,527,344,2019,95943
1612,26,14,12,2019,95944
1613,25381,11790,13591,2019,95945
1614,8977,4346,4631,2019,95946
1615,1657,812,845,2019,95947
1616,11917,5952,5965,2019,95948
1617,21036,10228,10808,2019,95949
1618,350,162,188,2019,95950
1619,2686,1377,1309,2019,95951
1620,10925,5565,5360,2019,95953
1621,12371,5755,6616,2019,95954
1622,1386,761,625,2019,95955
1623,348,165,183,2019,95956
1624,879,480,399,2019,95957
1625,18343,9681,8662,2019,95959
1626,684,379,305,2019,95960
1627,28489,14378,14111,2019,95961
1628,1324,790,534,2019,95962
1629,15492,7690,7802,2019,95963
1630,20498,10516,9982,2019,95965
1631,29860,14971,14889,2019,95966
1632,1231,664,567,2019,95968
1633,23572,11128,12444,2019,95969
1634,616,297,319,2019,95970
1635,5924,2888,3036,2019,95971
1636,36682,18281,18401,2019,95973
1637,65,49,16,2019,95974
1638,1877,1026,851,2019,95975
1639,1488,774,714,2019,95977
1640,245,147,98,2019,95978
1641,414,215,199,2019,95979
1642,39,29,10,2019,95981
1643,3259,1667,1592,2019,95982
1644,380,184,196,2019,95983
1645,327,139,188,2019,95984
1646,56,40,16,2019,95986
1647,5950,2877,3073,2019,95987
1648,8298,4282,4016,2019,95988
1649,40861,19957,20904,2019,95991
1650,37077,18687,18390,2019,95993
1651,34293,16999,17294,2019,96001
1652,34196,16229,17967,2019,96002
1653,44328,21683,22645,2019,96003
1654,389,200,189,2019,96006
1655,23228,11589,11639,2019,96007
1656,1191,444,747,2019,96008
1657,321,169,152,2019,96009
1658,122,73,49,2019,96010
1659,199,114,85,2019,96011
1660,4819,2366,2453,2019,96013
1661,135,69,66,2019,96014
1662,320,152,168,2019,96015
1663,424,206,218,2019,96016
1664,140,81,59,2019,96017
1665,10178,5056,5122,2019,96019
1666,2369,1237,1132,2019,96020
1667,16017,7663,8354,2019,96021
1668,16253,7562,8691,2019,96022
1669,1184,657,527,2019,96023
1670,846,470,376,2019,96024
1671,2126,1011,1115,2019,96025
1672,2327,1258,1069,2019,96027
1673,1368,650,718,2019,96028
1674,167,88,79,2019,96029
1675,133,75,58,2019,96031
1676,2653,1384,1269,2019,96032
1677,490,255,235,2019,96033
1678,279,132,147,2019,96034
1679,3629,1932,1697,2019,96035
1680,279,113,166,2019,96037
1681,732,362,370,2019,96038
1682,904,425,479,2019,96039
1683,124,60,64,2019,96040
1684,2934,1441,1493,2019,96041
1685,963,488,475,2019,96044
1686,115,58,57,2019,96046
1687,849,478,371,2019,96047
1688,730,368,362,2019,96048
1689,90,45,45,2019,96049
1690,381,219,162,2019,96050
1691,1358,678,680,2019,96051
1692,1574,841,733,2019,96052
1693,319,177,142,2019,96054
1694,3866,1902,1964,2019,96055
1695,1530,775,755,2019,96056
1696,1235,624,611,2019,96057
1697,553,345,208,2019,96058
1698,542,274,268,2019,96059
1699,21,10,11,2019,96061
1700,1042,490,552,2019,96062
1701,359,236,123,2019,96063
1702,4533,2313,2220,2019,96064
1703,403,224,179,2019,96065
1704,7094,3537,3557,2019,96067
1705,204,158,46,2019,96068
1706,800,381,419,2019,96069
1707,31,15,16,2019,96071
1708,3980,1971,2009,2019,96073
1709,164,93,71,2019,96074
1710,350,246,104,2019,96075
1711,284,141,143,2019,96076
1712,29139,14865,14274,2019,96080
1713,536,223,313,2019,96084
1714,54,24,30,2019,96085
1715,278,139,139,2019,96086
1716,544,317,227,2019,96087
1717,4690,2642,2048,2019,96088
1718,481,240,241,2019,96090
1719,618,320,298,2019,96091
1720,343,253,90,2019,96092
1721,3570,1893,1677,2019,96093
1722,6611,3326,3285,2019,96094
1723,703,366,337,2019,96096
1724,9746,4538,5208,2019,96097
1725,5262,2731,2531,2019,96101
1726,1401,681,720,2019,96103
1727,842,407,435,2019,96104
1728,372,205,167,2019,96105
1729,274,139,135,2019,96106
1730,1433,693,740,2019,96107
1731,80,49,31,2019,96108
1732,812,461,351,2019,96109
1733,126,69,57,2019,96110
1734,83,46,37,2019,96111
1735,224,95,129,2019,96112
1736,1925,1463,462,2019,96113
1737,3267,1541,1726,2019,96114
1738,115,68,47,2019,96115
1739,172,92,80,2019,96116
1740,355,163,192,2019,96117
1741,1779,971,808,2019,96118
1742,59,15,44,2019,96119
1743,926,475,451,2019,96120
1744,358,242,116,2019,96121
1745,3266,1595,1671,2019,96122
1746,25,14,11,2019,96123
1747,458,157,301,2019,96124
1748,126,67,59,2019,96125
1749,85,60,25,2019,96126
1750,685,396,289,2019,96128
1751,408,269,139,2019,96129
1752,20119,14380,5739,2019,96130
1753,50,23,27,2019,96132
1754,126,60,66,2019,96133
1755,2059,1101,958,2019,96134
1756,301,152,149,2019,96135
1757,44,13,31,2019,96136
1758,3252,1538,1714,2019,96137
1759,953,489,464,2019,96140
1760,403,210,193,2019,96141
1761,885,484,401,2019,96142
1762,3585,1878,1707,2019,96143
1763,2147,1091,1056,2019,96145
1764,1145,639,506,2019,96146
1765,580,353,227,2019,96148
1766,29327,15573,13754,2019,96150
1767,0,0,0,2019,96155
1768,18488,9341,9147,2019,96161
1769,170,104,66,2019,97635
0,Estimate!!SEX AND AGE!!Total population,Estimate!!SEX AND AGE!!Total population!!Male,Estimate!!SEX AND AGE!!Total population!!Female,2018,Geographic Area Name
1,487,212,275,2018,89010
2,2376,1192,1184,2018,89019
3,9042,4873,4169,2018,89060
4,5828,2858,2970,2018,89061
5,1355,621,734,2018,89439
6,58975,30349,28626,2018,90001
7,53111,25518,27593,2018,90002
8,72741,35361,37380,2018,90003
9,61586,30602,30984,2018,90004
10,39479,19602,19877,2018,90005
11,61698,30450,31248,2018,90006
12,41716,21129,20587,2018,90007
13,31739,14018,17721,2018,90008
14,3702,1857,1845,2018,90010
15,109414,54875,54539,2018,90011
16,35913,22055,13858,2018,90012
17,11937,7379,4558,2018,90013
18,8335,5239,3096,2018,90014
19,21801,10915,10886,2018,90015
20,46581,23041,23540,2018,90016
21,26728,14436,12292,2018,90017
22,53256,25673,27583,2018,90018
23,66245,32342,33903,2018,90019
24,39102,19171,19931,2018,90020
25,2922,1837,1085,2018,90021
26,65890,32317,33573,2018,90022
27,46780,23778,23002,2018,90023
28,50288,22580,27708,2018,90024
29,47967,24387,23580,2018,90025
30,69589,35246,34343,2018,90026
31,44686,21741,22945,2018,90027
32,30734,16917,13817,2018,90028
33,37898,19101,18797,2018,90029
34,38535,18994,19541,2018,90031
35,47627,23068,24559,2018,90032
36,47583,22853,24730,2018,90033
37,55652,27996,27656,2018,90034
38,28085,13035,15050,2018,90035
39,37988,17613,20375,2018,90036
40,65016,32005,33011,2018,90037
41,27660,14742,12918,2018,90038
42,29589,14500,15089,2018,90039
43,12645,6114,6531,2018,90040
44,29516,14317,15199,2018,90041
45,63911,31573,32338,2018,90042
46,44627,21139,23488,2018,90043
47,96436,45700,50736,2018,90044
48,41149,19877,21272,2018,90045
49,50587,27208,23379,2018,90046
50,48883,21536,27347,2018,90047
51,22892,10745,12147,2018,90048
52,36964,17187,19777,2018,90049
53,7795,3122,4673,2018,90056
54,49492,26957,22535,2018,90057
55,2758,1284,1474,2018,90058
56,45952,22119,23833,2018,90059
57,27646,13079,14567,2018,90061
58,34422,16221,18201,2018,90062
59,52951,26376,26575,2018,90063
60,25429,12354,13075,2018,90064
61,47887,24231,23656,2018,90065
62,59394,30186,29208,2018,90066
63,2314,1113,1201,2018,90067
64,20982,10871,10111,2018,90068
65,20435,12351,8084,2018,90069
66,0,0,0,2018,90071
67,916,823,93,2018,90073
68,8993,4417,4576,2018,90077
69,0,0,0,2018,90079
70,3862,1842,2020,2018,90089
71,0,0,0,2018,90090
72,9368,4366,5002,2018,90094
73,0,0,0,2018,90095
74,102433,51632,50801,2018,90201
75,19909,9599,10310,2018,90210
76,7969,3752,4217,2018,90211
77,13156,6193,6963,2018,90212
78,53703,25562,28141,2018,90220
79,52322,26491,25831,2018,90221
80,32850,16111,16739,2018,90222
81,32808,15576,17232,2018,90230
82,14660,7093,7567,2018,90232
83,26205,12867,13338,2018,90240
84,44143,21976,22167,2018,90241
85,42553,20394,22159,2018,90242
86,16850,8117,8733,2018,90245
87,47531,23161,24370,2018,90247
88,11512,5664,5848,2018,90248
89,26587,12512,14075,2018,90249
90,96836,47518,49318,2018,90250
91,19650,10546,9104,2018,90254
92,75560,37709,37851,2018,90255
93,35161,17989,17172,2018,90260
94,70936,34586,36350,2018,90262
95,1846,766,1080,2018,90263
96,18389,9103,9286,2018,90265
97,35573,17503,18070,2018,90266
98,27454,13858,13596,2018,90270
99,22551,10753,11798,2018,90272
100,25279,12090,13189,2018,90274
101,42421,20180,22241,2018,90275
102,34506,17127,17379,2018,90277
103,40649,20964,19685,2018,90278
104,95103,46470,48633,2018,90280
105,5371,2598,2773,2018,90290
106,27525,14223,13302,2018,90291
107,22490,11665,10825,2018,90292
108,12694,6171,6523,2018,90293
109,37291,18288,19003,2018,90301
110,30828,14160,16668,2018,90302
111,24693,11821,12872,2018,90303
112,25591,12902,12689,2018,90304
113,15397,7020,8377,2018,90305
114,7256,3632,3624,2018,90401
115,11866,5740,6126,2018,90402
116,24354,11396,12958,2018,90403
117,22819,11391,11428,2018,90404
118,28115,14139,13976,2018,90405
119,42335,20508,21827,2018,90501
120,18188,9158,9030,2018,90502
121,44908,21825,23083,2018,90503
122,33721,16566,17155,2018,90504
123,37641,18656,18985,2018,90505
124,0,0,0,2018,90506
125,33058,16097,16961,2018,90601
126,25981,12659,13322,2018,90602
127,21299,10825,10474,2018,90603
128,42063,20230,21833,2018,90604
129,40957,20081,20876,2018,90605
130,32803,16509,16294,2018,90606
131,46842,22554,24288,2018,90620
132,35398,18213,17185,2018,90621
133,15813,7792,8021,2018,90623
134,49169,23902,25267,2018,90630
135,69502,33901,35601,2018,90631
136,49383,23994,25389,2018,90638
137,63177,30747,32430,2018,90640
138,105886,52976,52910,2018,90650
139,63380,30971,32409,2018,90660
140,16578,7926,8652,2018,90670
141,30321,14772,15549,2018,90680
142,16858,8145,8713,2018,90701
143,50963,24952,26011,2018,90703
144,3922,1955,1967,2018,90704
145,77529,38057,39472,2018,90706
146,28185,13484,14701,2018,90710
147,31063,14987,16076,2018,90712
148,29061,14312,14749,2018,90713
149,20136,9624,10512,2018,90715
150,14344,7173,7171,2018,90716
151,21696,10601,11095,2018,90717
152,22389,10779,11610,2018,90720
153,54776,27261,27515,2018,90723
154,61850,31170,30680,2018,90731
155,22273,10375,11898,2018,90732
156,24494,11512,12982,2018,90740
157,699,367,332,2018,90742
158,267,148,119,2018,90743
159,57206,28854,28352,2018,90744
160,56821,27739,29082,2018,90745
161,26996,12989,14007,2018,90746
162,0,0,0,2018,90747
163,11555,5367,6188,2018,90755
164,39453,20958,18495,2018,90802
165,32389,16004,16385,2018,90803
166,39344,19256,20088,2018,90804
167,96708,46972,49736,2018,90805
168,42817,20865,21952,2018,90806
169,32067,15847,16220,2018,90807
170,38860,18819,20041,2018,90808
171,38579,18863,19716,2018,90810
172,59000,29348,29652,2018,90813
173,18587,8640,9947,2018,90814
174,41026,20082,20944,2018,90815
175,139,119,20,2018,90822
176,0,0,0,2018,90831
177,37711,18762,18949,2018,91001
178,33012,15871,17141,2018,91006
179,34523,16251,18272,2018,91007
180,1141,513,628,2018,91008
181,26601,12631,13970,2018,91010
182,20423,9746,10677,2018,91011
183,41671,20638,21033,2018,91016
184,8720,4245,4475,2018,91020
185,11006,5331,5675,2018,91024
186,25794,12655,13139,2018,91030
187,20207,10058,10149,2018,91040
188,26631,13347,13284,2018,91042
189,143,77,66,2018,91046
190,21394,9722,11672,2018,91101
191,28425,13842,14583,2018,91103
192,37974,17888,20086,2018,91104
193,12191,6067,6124,2018,91105
194,25375,12611,12764,2018,91106
195,32364,15883,16481,2018,91107
196,13538,6394,7144,2018,91108
197,23619,10765,12854,2018,91201
198,23317,10922,12395,2018,91202
199,15000,7391,7609,2018,91203
200,18720,8818,9902,2018,91204
201,37618,17509,20109,2018,91205
202,34386,16227,18159,2018,91206
203,11371,5364,6007,2018,91207
204,16049,7713,8336,2018,91208
205,689,421,268,2018,91210
206,30654,14256,16398,2018,91214
207,25631,12447,13184,2018,91301
208,26634,12776,13858,2018,91302
209,31053,15962,15091,2018,91303
210,53761,26700,27061,2018,91304
211,49158,24678,24480,2018,91306
212,26595,12786,13809,2018,91307
213,40420,20113,20307,2018,91311
214,29964,13764,16200,2018,91316
215,45520,22685,22835,2018,91320
216,34355,17050,17305,2018,91321
217,29617,15891,13726,2018,91324
218,34635,17188,17447,2018,91325
219,37035,18341,18694,2018,91326
220,3273,1328,1945,2018,91330
221,105799,52871,52928,2018,91331
222,80524,39785,40739,2018,91335
223,36227,18102,18125,2018,91340
224,96487,48682,47805,2018,91342
225,66590,32471,34119,2018,91343
226,53266,26652,26614,2018,91344
227,19205,9761,9444,2018,91345
228,37350,18298,19052,2018,91350
229,32572,16146,16426,2018,91351
230,47438,23289,24149,2018,91352
231,32096,15824,16272,2018,91354
232,31455,15712,15743,2018,91355
233,30804,15103,15701,2018,91356
234,43342,20854,22488,2018,91360
235,20443,9706,10737,2018,91361
236,36062,17524,18538,2018,91362
237,27340,13495,13845,2018,91364
238,45282,21952,23330,2018,91367
239,0,0,0,2018,91371
240,13730,6768,6962,2018,91377
241,20371,9621,10750,2018,91381
242,28842,16710,12132,2018,91384
243,43717,21425,22292,2018,91387
244,19053,9953,9100,2018,91390
245,41412,20939,20473,2018,91401
246,70686,34815,35871,2018,91402
247,25218,12185,13033,2018,91403
248,55384,27262,28122,2018,91405
249,55215,28466,26749,2018,91406
250,25801,12687,13114,2018,91411
251,33737,15966,17771,2018,91423
252,15070,6974,8096,2018,91436
253,20300,9889,10411,2018,91501
254,11598,5777,5821,2018,91502
255,26863,13413,13450,2018,91504
256,30680,14874,15806,2018,91505
257,18575,8497,10078,2018,91506
258,37085,19568,17517,2018,91601
259,19358,9445,9913,2018,91602
260,32117,15778,16339,2018,91604
261,52210,26082,26128,2018,91605
262,44476,22219,22257,2018,91606
263,30873,14501,16372,2018,91607
264,0,0,0,2018,91608
265,40034,20040,19994,2018,91701
266,62348,30168,32180,2018,91702
267,77342,39036,38306,2018,91706
268,3892,1156,2736,2018,91708
269,79298,38601,40697,2018,91709
270,90582,53315,37267,2018,91710
271,36854,17688,19166,2018,91711
272,35708,17340,18368,2018,91722
273,18875,9213,9662,2018,91723
274,26091,12726,13365,2018,91724
275,71422,34752,36670,2018,91730
276,30139,15371,14768,2018,91731
277,63572,31558,32014,2018,91732
278,44968,23028,21940,2018,91733
279,25339,12225,13114,2018,91737
280,39803,20166,19637,2018,91739
281,26115,12659,13456,2018,91740
282,26565,12861,13704,2018,91741
283,87240,43241,43999,2018,91744
284,54975,27480,27495,2018,91745
285,30708,14968,15740,2018,91746
286,47084,23324,23760,2018,91748
287,33836,16602,17234,2018,91750
288,33135,16731,16404,2018,91752
289,33058,15562,17496,2018,91754
290,27734,13741,13993,2018,91755
291,374,178,196,2018,91759
292,61124,29998,31126,2018,91761
293,60699,29786,30913,2018,91762
294,38406,18623,19783,2018,91763
295,54825,27189,27636,2018,91764
296,47139,23430,23709,2018,91765
297,72332,36297,36035,2018,91766
298,50264,24420,25844,2018,91767
299,35389,17170,18219,2018,91768
300,63425,31287,32138,2018,91770
301,34496,16196,18300,2018,91773
302,25192,12062,13130,2018,91775
303,38410,18533,19877,2018,91776
304,35351,16632,18719,2018,91780
305,25567,12464,13103,2018,91784
306,53849,25661,28188,2018,91786
307,44474,21609,22865,2018,91789
308,45206,21972,23234,2018,91790
309,34363,16508,17855,2018,91791
310,29839,14596,15243,2018,91792
311,54479,26079,28400,2018,91801
312,30385,15190,15195,2018,91803
313,18558,9257,9301,2018,91901
314,20138,9869,10269,2018,91902
315,1478,789,689,2018,91905
316,4351,2399,1952,2018,91906
317,74297,36775,37522,2018,91910
318,85365,42535,42830,2018,91911
319,53072,25871,27201,2018,91913
320,16357,8476,7881,2018,91914
321,31740,15382,16358,2018,91915
322,1962,965,997,2018,91916
323,920,402,518,2018,91917
324,496,198,298,2018,91931
325,26701,13340,13361,2018,91932
326,267,185,82,2018,91934
327,8332,4109,4223,2018,91935
328,32384,15575,16809,2018,91941
329,40205,18933,21272,2018,91942
330,27193,13297,13896,2018,91945
331,15,15,0,2018,91948
332,62639,31449,31190,2018,91950
333,2378,1247,1131,2018,91962
334,999,528,471,2018,91963
335,63393,31255,32138,2018,91977
336,10518,5229,5289,2018,91978
337,636,375,261,2018,91980
338,5042,2703,2339,2018,92003
339,2414,1249,1165,2018,92004
340,11234,5414,5820,2018,92007
341,27330,13676,13654,2018,92008
342,45827,22070,23757,2018,92009
343,16131,7692,8439,2018,92010
344,24382,11602,12780,2018,92011
345,13863,7014,6849,2018,92014
346,42400,21265,21135,2018,92019
347,58742,29539,29203,2018,92020
348,71321,35997,35324,2018,92021
349,51496,25456,26040,2018,92024
350,53772,27005,26767,2018,92025
351,49921,25049,24872,2018,92026
352,56811,29023,27788,2018,92027
353,49380,24543,24837,2018,92028
354,19149,9459,9690,2018,92029
355,2221,1211,1010,2018,92036
356,39724,19366,20358,2018,92037
357,46261,23682,22579,2018,92040
358,42173,21422,20751,2018,92054
359,12120,11156,964,2018,92055
360,53845,26545,27300,2018,92056
361,58347,28959,29388,2018,92057
362,45894,24868,21026,2018,92058
363,1456,669,787,2018,92059
364,92,43,49,2018,92060
365,2376,1311,1065,2018,92061
366,49933,24332,25601,2018,92064
367,36309,18349,17960,2018,92065
368,572,268,304,2018,92066
369,8756,4075,4681,2018,92067
370,51447,25337,26110,2018,92069
371,829,408,421,2018,92070
372,57511,27524,29987,2018,92071
373,12624,5872,6752,2018,92075
374,49034,24333,24701,2018,92078
375,29405,14821,14584,2018,92081
376,18065,9005,9060,2018,92082
377,39043,20709,18334,2018,92083
378,51419,25666,25753,2018,92084
379,1544,750,794,2018,92086
380,1343,652,691,2018,92091
381,39313,22255,17058,2018,92101
382,44500,22992,21508,2018,92102
383,34878,17354,17524,2018,92103
384,45202,22825,22377,2018,92104
385,72848,36049,36799,2018,92105
386,19080,9711,9369,2018,92106
387,31148,15640,15508,2018,92107
388,22565,11426,11139,2018,92108
389,48417,25726,22691,2018,92109
390,29911,14429,15482,2018,92110
391,49369,25323,24046,2018,92111
392,55623,29376,26247,2018,92113
393,70039,34909,35130,2018,92114
394,65853,31899,33954,2018,92115
395,33767,16957,16810,2018,92116
396,56173,28563,27610,2018,92117
397,22484,11661,10823,2018,92118
398,23990,11495,12495,2018,92119
399,29142,14521,14621,2018,92120
400,4655,2422,2233,2018,92121
401,48438,25171,23267,2018,92122
402,31216,16041,15175,2018,92123
403,32170,15634,16536,2018,92124
404,82572,42755,39817,2018,92126
405,48721,23490,25231,2018,92127
406,51066,24071,26995,2018,92128
407,54986,27006,27980,2018,92129
408,55316,27583,27733,2018,92130
409,34359,16594,17765,2018,92131
410,0,0,0,2018,92132
411,280,209,71,2018,92134
412,646,559,87,2018,92135
413,37040,17684,19356,2018,92139
414,3669,3560,109,2018,92140
415,2389,1188,1201,2018,92145
416,551,512,39,2018,92147
417,86811,44887,41924,2018,92154
418,490,474,16,2018,92155
419,31866,15222,16644,2018,92173
420,65347,31487,33860,2018,92201
421,30744,15223,15521,2018,92203
422,5049,2447,2602,2018,92210
423,25339,11819,13520,2018,92211
424,33014,15914,17100,2018,92220
425,0,0,0,2018,92222
426,53914,25865,28049,2018,92223
427,22149,13966,8183,2018,92225
428,27255,13198,14057,2018,92227
429,3406,1407,1999,2018,92230
430,40019,18614,21405,2018,92231
431,7618,5970,1648,2018,92233
432,53961,27550,26411,2018,92234
433,45090,21773,23317,2018,92236
434,274,152,122,2018,92239
435,34447,17228,17219,2018,92240
436,7904,4086,3818,2018,92241
437,1306,651,655,2018,92242
438,50484,25240,25244,2018,92243
439,7898,3872,4026,2018,92249
440,8979,4823,4156,2018,92250
441,23388,13171,10217,2018,92251
442,9394,4795,4599,2018,92252
443,40368,19905,20463,2018,92253
444,10385,5475,4910,2018,92254
445,3282,1681,1601,2018,92256
446,1332,676,656,2018,92257
447,778,478,300,2018,92258
448,94,39,55,2018,92259
449,34225,16598,17627,2018,92260
450,28517,16255,12262,2018,92262
451,19881,11817,8064,2018,92264
452,108,80,28,2018,92266
453,5,5,0,2018,92267
454,597,344,253,2018,92268
455,18075,9132,8943,2018,92270
456,1704,745,959,2018,92273
457,15118,8136,6982,2018,92274
458,2456,1162,1294,2018,92275
459,7772,3962,3810,2018,92276
460,23517,11950,11567,2018,92277
461,4737,4171,566,2018,92278
462,19,19,0,2018,92280
463,2859,1387,1472,2018,92281
464,1373,740,633,2018,92282
465,1694,865,829,2018,92283
466,26085,12728,13357,2018,92284
467,2142,1115,1027,2018,92285
468,33967,17614,16353,2018,92301
469,21,21,0,2018,92304
470,622,284,338,2018,92305
471,39273,19170,20103,2018,92307
472,41807,20082,21725,2018,92308
473,633,309,324,2018,92309
474,9086,5140,3946,2018,92310
475,33612,15698,17914,2018,92311
476,12512,6011,6501,2018,92313
477,11361,5701,5660,2018,92314
478,5234,2513,2721,2018,92315
479,28783,14329,14454,2018,92316
480,8597,4245,4352,2018,92320
481,1166,613,553,2018,92321
482,686,310,376,2018,92322
483,59409,28236,31173,2018,92324
484,8621,4306,4315,2018,92325
485,740,447,293,2018,92327
486,354,205,149,2018,92328
487,92,89,3,2018,92332
488,316,142,174,2018,92333
489,99284,49552,49732,2018,92335
490,96575,47574,49001,2018,92336
491,38868,19537,19331,2018,92337
492,0,0,0,2018,92338
493,1185,569,616,2018,92339
494,203,109,94,2018,92341
495,6508,3256,3252,2018,92342
496,23003,11909,11094,2018,92344
497,80808,39632,41176,2018,92345
498,61751,32175,29576,2018,92346
499,843,406,437,2018,92347
500,5729,2586,3143,2018,92352
501,21679,10199,11480,2018,92354
502,6065,3096,2969,2018,92356
503,782,394,388,2018,92358
504,9056,4453,4603,2018,92359
505,5407,2583,2824,2018,92363
506,0,0,0,2018,92364
507,2792,1565,1227,2018,92365
508,1100,555,545,2018,92368
509,17882,9162,8720,2018,92371
510,6282,3115,3167,2018,92372
511,33264,15257,18007,2018,92373
512,43633,21227,22406,2018,92374
513,87027,43147,43880,2018,92376
514,19556,9425,10131,2018,92377
515,263,127,136,2018,92378
516,4709,2338,2371,2018,92382
517,13,10,3,2018,92384
518,202,109,93,2018,92385
519,2140,987,1153,2018,92386
520,146,75,71,2018,92389
521,2479,1391,1088,2018,92391
522,58204,27424,30780,2018,92392
523,35365,19112,16253,2018,92394
524,42741,21184,21557,2018,92395
525,4571,2207,2364,2018,92397
526,2098,1100,998,2018,92398
527,54163,26413,27750,2018,92399
528,1929,883,1046,2018,92401
529,61216,29977,31239,2018,92404
530,30511,15051,15460,2018,92405
531,69222,35051,34171,2018,92407
532,14434,7618,6816,2018,92408
533,45641,21683,23958,2018,92410
534,26563,12601,13962,2018,92411
535,21656,11117,10539,2018,92501
536,94512,47098,47414,2018,92503
537,59556,29495,30061,2018,92504
538,51322,25359,25963,2018,92505
539,45854,22499,23355,2018,92506
540,57886,29272,28614,2018,92507
541,39225,18975,20250,2018,92508
542,81214,41379,39835,2018,92509
543,1186,550,636,2018,92518
544,56511,28269,28242,2018,92530
545,25475,12362,13113,2018,92532
546,3028,1589,1439,2018,92536
547,4703,2352,2351,2018,92539
548,37615,17426,20189,2018,92543
549,48923,24351,24572,2018,92544
550,42248,20663,21585,2018,92545
551,8273,4281,3992,2018,92548
552,2464,1237,1227,2018,92549
553,33578,15607,17971,2018,92551
554,75830,37527,38303,2018,92553
555,43957,21133,22824,2018,92555
556,52089,25177,26912,2018,92557
557,1278,755,523,2018,92561
558,64116,30339,33777,2018,92562
559,68128,33670,34458,2018,92563
560,10228,5176,5052,2018,92567
561,60944,31492,29452,2018,92570
562,56446,29308,27138,2018,92571
563,16783,8175,8608,2018,92582
564,32692,15975,16717,2018,92583
565,51298,25464,25834,2018,92584
566,21732,10798,10934,2018,92585
567,20032,8872,11160,2018,92586
568,17468,9040,8428,2018,92587
569,4388,2206,2182,2018,92590
570,41107,19534,21573,2018,92591
571,84418,42147,42271,2018,92592
572,33642,16555,17087,2018,92595
573,30573,15808,14765,2018,92596
574,26044,12475,13569,2018,92602
575,19650,9645,10005,2018,92603
576,28819,14107,14712,2018,92604
577,24694,12292,12402,2018,92606
578,14149,6828,7321,2018,92610
579,32362,16069,16293,2018,92612
580,26676,13374,13302,2018,92614
581,17086,7253,9833,2018,92617
582,43316,22617,20699,2018,92618
583,48952,22924,26028,2018,92620
584,6402,3196,3206,2018,92624
585,12148,5784,6364,2018,92625
586,50541,24776,25765,2018,92626
587,63212,32493,30719,2018,92627
588,26744,12872,13872,2018,92629
589,61304,30495,30809,2018,92630
590,16228,5816,10412,2018,92637
591,55893,27531,28362,2018,92646
592,62718,31831,30887,2018,92647
593,46890,24086,22804,2018,92648
594,34406,17247,17159,2018,92649
595,24746,12213,12533,2018,92651
596,29986,14740,15246,2018,92653
597,8415,3969,4446,2018,92655
598,52124,24554,27570,2018,92656
599,9670,4909,4761,2018,92657
600,36906,17376,19530,2018,92660
601,3225,1702,1523,2018,92661
602,2606,1228,1378,2018,92662
603,21572,11235,10337,2018,92663
604,34110,16798,17312,2018,92672
605,30927,15466,15461,2018,92673
606,37457,17896,19561,2018,92675
607,2154,1136,1018,2018,92676
608,66406,32320,34086,2018,92677
609,570,265,305,2018,92678
610,32579,16081,16498,2018,92679
611,91376,45146,46230,2018,92683
612,45178,22034,23144,2018,92688
613,50782,25179,25603,2018,92691
614,47576,23374,24202,2018,92692
615,29064,14077,14987,2018,92694
616,53565,27695,25870,2018,92701
617,70595,36423,34172,2018,92703
618,90340,46059,44281,2018,92704
619,46470,23295,23175,2018,92705
620,35083,17072,18011,2018,92706
621,61026,31027,29999,2018,92707
622,57416,27901,29515,2018,92708
623,61660,30414,31246,2018,92780
624,22704,11188,11516,2018,92782
625,67053,32839,34214,2018,92801
626,42248,21083,21165,2018,92802
627,88749,43455,45294,2018,92804
628,74413,36951,37462,2018,92805
629,39719,20050,19669,2018,92806
630,35777,17505,18272,2018,92807
631,20667,9917,10750,2018,92808
632,37529,18060,19469,2018,92821
633,4721,2296,2425,2018,92823
634,37353,18756,18597,2018,92831
635,25134,12649,12485,2018,92832
636,52922,26245,26677,2018,92833
637,23867,11511,12356,2018,92835
638,55186,28124,27062,2018,92840
639,34061,16915,17146,2018,92841
640,46036,23294,22742,2018,92843
641,23878,11422,12456,2018,92844
642,16600,8352,8248,2018,92845
643,26591,14399,12192,2018,92860
644,5872,2824,3048,2018,92861
645,20741,10366,10375,2018,92865
646,15017,6653,8364,2018,92866
647,44628,21540,23088,2018,92867
648,27693,15184,12509,2018,92868
649,36913,18299,18614,2018,92869
650,53582,26514,27068,2018,92870
651,46920,23079,23841,2018,92879
652,69720,34190,35530,2018,92880
653,33996,17179,16817,2018,92881
654,71581,35682,35899,2018,92882
655,35072,17454,17618,2018,92883
656,50545,24484,26061,2018,92886
657,20194,10003,10191,2018,92887
658,33185,16763,16422,2018,93001
659,52272,25677,26595,2018,93003
660,30502,14689,15813,2018,93004
661,45092,22434,22658,2018,93010
662,36225,16770,19455,2018,93012
663,16644,8275,8369,2018,93013
664,17817,8590,9227,2018,93015
665,38063,18299,19764,2018,93021
666,7232,3942,3290,2018,93022
667,20231,9602,10629,2018,93023
668,59755,30324,29431,2018,93030
669,83782,43576,40206,2018,93033
670,29404,14467,14937,2018,93035
671,47442,23766,23676,2018,93036
672,2007,929,1078,2018,93040
673,24506,12621,11885,2018,93041
674,107,107,0,2018,93042
675,184,60,124,2018,93043
676,34181,16903,17278,2018,93060
677,56651,27794,28857,2018,93063
678,0,0,0,2018,93064
679,72061,35083,36978,2018,93065
680,3112,1646,1466,2018,93066
681,454,179,275,2018,93067
682,31624,15681,15943,2018,93101
683,20353,10650,9703,2018,93103
684,27515,13242,14273,2018,93105
685,10896,5047,5849,2018,93108
686,11573,6111,5462,2018,93109
687,16660,8572,8088,2018,93110
688,17263,8250,9013,2018,93111
689,58431,28891,29540,2018,93117
690,1431,772,659,2018,93201
691,3777,2037,1740,2018,93202
692,22744,11490,11254,2018,93203
693,12923,8275,4648,2018,93204
694,1384,711,673,2018,93205
695,1970,1062,908,2018,93206
696,239,124,115,2018,93207
697,47,2,45,2018,93208
698,18025,10645,7380,2018,93210
699,23424,15926,7498,2018,93212
700,55269,31769,23500,2018,93215
701,873,440,433,2018,93218
702,10167,5452,4715,2018,93219
703,58,58,0,2018,93220
704,14328,7078,7250,2018,93221
705,1481,806,675,2018,93222
706,10742,5057,5685,2018,93223
707,453,239,214,2018,93224
708,4816,2437,2379,2018,93225
709,180,96,84,2018,93226
710,66800,33951,32849,2018,93230
711,7260,3584,3676,2018,93234
712,4198,2127,2071,2018,93235
713,1015,585,430,2018,93238
714,1520,739,781,2018,93239
715,6343,2923,3420,2018,93240
716,16834,8649,8185,2018,93241
717,3541,1576,1965,2018,93242
718,1938,860,1078,2018,93243
719,395,227,168,2018,93244
720,38606,20140,18466,2018,93245
721,18522,9855,8667,2018,93247
722,2088,1122,966,2018,93249
723,16088,8760,7328,2018,93250
724,229,131,98,2018,93251
725,2738,2006,732,2018,93252
726,858,397,461,2018,93254
727,556,241,315,2018,93255
728,5939,2805,3134,2018,93256
729,76923,39069,37854,2018,93257
730,2075,1137,938,2018,93258
731,228,115,113,2018,93260
732,2715,1504,1211,2018,93261
733,63,32,31,2018,93262
734,21572,10779,10793,2018,93263
735,3271,1690,1581,2018,93265
736,1406,637,769,2018,93266
737,6347,3118,3229,2018,93267
738,17964,9120,8844,2018,93268
739,5542,2877,2665,2018,93270
740,2432,1292,1140,2018,93271
741,4454,2346,2108,2018,93272
742,73778,36576,37202,2018,93274
743,186,106,80,2018,93276
744,53015,25571,27444,2018,93277
745,27698,16264,11434,2018,93280
746,2343,1357,986,2018,93283
747,2085,978,1107,2018,93285
748,9755,4856,4899,2018,93286
749,96,56,40,2018,93287
750,57968,28669,29299,2018,93291
751,41031,19977,21054,2018,93292
752,12028,5948,6080,2018,93301
753,49976,24880,25096,2018,93304
754,38725,19240,19485,2018,93305
755,73401,36616,36785,2018,93306
756,84809,41457,43352,2018,93307
757,53702,27362,26340,2018,93308
758,59378,29144,30234,2018,93309
759,45763,22869,22894,2018,93311
760,60238,29886,30352,2018,93312
761,52637,26086,26551,2018,93313
762,28590,14462,14128,2018,93314
763,28423,14497,13926,2018,93401
764,16350,8165,8185,2018,93402
765,36550,21034,15516,2018,93405
766,0,0,0,2018,93410
767,30136,14333,15803,2018,93420
768,33806,17209,16597,2018,93422
769,776,418,358,2018,93424
770,1604,914,690,2018,93426
771,6071,2807,3264,2018,93427
772,5981,2802,3179,2018,93428
773,111,42,69,2018,93429
774,2947,1468,1479,2018,93430
775,1125,444,681,2018,93432
776,13538,6682,6856,2018,93433
777,7350,3799,3551,2018,93434
778,56406,30079,26327,2018,93436
779,3379,1989,1390,2018,93437
780,1648,793,855,2018,93440
781,1013,485,528,2018,93441
782,10976,5367,5609,2018,93442
783,20775,10608,10167,2018,93444
784,7383,3785,3598,2018,93445
785,44753,22151,22602,2018,93446
786,8116,3827,4289,2018,93449
787,806,405,401,2018,93450
788,4089,2166,1923,2018,93451
789,795,537,258,2018,93452
790,2953,1489,1464,2018,93453
791,40604,20261,20343,2018,93454
792,45116,21526,23590,2018,93455
793,57369,28951,28418,2018,93458
794,4929,2484,2445,2018,93460
795,1451,749,702,2018,93461
796,8025,3874,4151,2018,93463
797,8914,4225,4689,2018,93465
798,4861,2599,2262,2018,93501
799,13606,7979,5627,2018,93505
800,7626,3985,3641,2018,93510
801,313,144,169,2018,93512
802,1692,856,836,2018,93513
803,14412,7295,7117,2018,93514
804,2335,1162,1173,2018,93516
805,526,335,191,2018,93517
806,975,474,501,2018,93518
807,22,22,0,2018,93519
808,56,32,24,2018,93522
809,3700,1966,1734,2018,93523
810,168,159,9,2018,93524
811,570,305,265,2018,93526
812,1618,677,941,2018,93527
813,138,72,66,2018,93528
814,508,328,180,2018,93529
815,15,10,5,2018,93530
816,388,185,203,2018,93531
817,2871,1465,1406,2018,93532
818,39088,18108,20980,2018,93534
819,72948,36037,36911,2018,93535
820,72383,38678,33705,2018,93536
821,226,155,71,2018,93541
822,15135,7365,7770,2018,93543
823,1181,647,534,2018,93544
824,1899,935,964,2018,93545
825,9359,4637,4722,2018,93546
826,264,151,113,2018,93549
827,77006,37405,39601,2018,93550
828,51085,25055,26030,2018,93551
829,40266,20896,19370,2018,93552
830,1781,815,966,2018,93553
831,64,28,36,2018,93554
832,33742,16960,16782,2018,93555
833,40,31,9,2018,93558
834,20929,10920,10009,2018,93560
835,34839,19709,15130,2018,93561
836,1723,888,835,2018,93562
837,408,235,173,2018,93563
838,6579,3033,3546,2018,93591
839,77,40,37,2018,93592
840,1726,980,746,2018,93601
841,3967,2047,1920,2018,93602
842,183,93,90,2018,93603
843,629,266,363,2018,93604
844,188,73,115,2018,93605
845,949,398,551,2018,93606
846,940,507,433,2018,93608
847,5586,2841,2745,2018,93609
848,23607,10531,13076,2018,93610
849,48473,23474,24999,2018,93611
850,35450,17650,17800,2018,93612
851,11676,5340,6336,2018,93614
852,6513,3578,2935,2018,93615
853,2664,1478,1186,2018,93616
854,31230,15730,15500,2018,93618
855,37463,18771,18692,2018,93619
856,8889,4421,4468,2018,93620
857,94,64,30,2018,93621
858,10395,5164,5231,2018,93622
859,123,66,57,2018,93623
860,1041,647,394,2018,93624
861,7862,3823,4039,2018,93625
862,1983,906,1077,2018,93626
863,188,78,110,2018,93627
864,239,87,152,2018,93628
865,20195,10350,9845,2018,93630
866,16349,8056,8293,2018,93631
867,0,0,0,2018,93633
868,21,8,13,2018,93634
869,40759,20453,20306,2018,93635
870,12690,6474,6216,2018,93636
871,39381,18240,21141,2018,93637
872,50894,25743,25151,2018,93638
873,12727,6723,6004,2018,93640
874,198,172,26,2018,93641
875,2960,1576,1384,2018,93643
876,8981,4481,4500,2018,93644
877,344,117,227,2018,93645
878,10873,5333,5540,2018,93646
879,10896,5607,5289,2018,93647
880,16194,8143,8051,2018,93648
881,3477,1832,1645,2018,93650
882,1915,1052,863,2018,93651
883,426,233,193,2018,93652
884,1383,641,742,2018,93653
885,30935,15801,15134,2018,93654
886,6323,3358,2965,2018,93656
887,34723,17569,17154,2018,93657
888,4228,2076,2152,2018,93660
889,30922,15515,15407,2018,93662
890,408,227,181,2018,93664
891,875,424,451,2018,93665
892,952,437,515,2018,93666
893,2415,1181,1234,2018,93667
894,1173,629,544,2018,93668
895,164,85,79,2018,93669
896,740,344,396,2018,93673
897,3759,2017,1742,2018,93675
898,10274,5069,5205,2018,93701
899,44139,22796,21343,2018,93702
900,33000,16278,16722,2018,93703
901,29294,14424,14870,2018,93704
902,37707,18369,19338,2018,93705
903,40936,20516,20420,2018,93706
904,32625,15087,17538,2018,93710
905,38349,18408,19941,2018,93711
906,47270,22638,24632,2018,93720
907,7611,5105,2506,2018,93721
908,83179,41434,41745,2018,93722
909,13189,6449,6740,2018,93723
910,26980,13285,13695,2018,93725
911,43209,20873,22336,2018,93726
912,82920,41382,41538,2018,93727
913,16382,8253,8129,2018,93728
914,11926,5682,6244,2018,93730
915,27805,13601,14204,2018,93901
916,60408,31073,29335,2018,93905
917,65256,31935,33321,2018,93906
918,22766,11291,11475,2018,93907
919,12093,6050,6043,2018,93908
920,1403,766,637,2018,93920
921,3379,1582,1797,2018,93921
922,12833,5874,6959,2018,93923
923,6568,3088,3480,2018,93924
924,2155,1070,1085,2018,93925
925,9262,4787,4475,2018,93926
926,18778,9605,9173,2018,93927
927,820,650,170,2018,93928
928,17142,9013,8129,2018,93930
929,810,361,449,2018,93932
930,25015,12083,12932,2018,93933
931,32411,16549,15862,2018,93940
932,0,0,0,2018,93943
933,15595,7237,8358,2018,93950
934,4117,1937,2180,2018,93953
935,472,202,270,2018,93954
936,34395,16999,17396,2018,93955
937,26610,18111,8499,2018,93960
938,385,240,145,2018,93962
939,27202,13580,13622,2018,94002
940,4692,2214,2478,2018,94005
941,42730,20359,22371,2018,94010
942,49515,24900,24615,2018,94014
943,64887,31685,33202,2018,94015
944,20314,9657,10657,2018,94019
945,1334,727,607,2018,94020
946,436,173,263,2018,94021
947,19378,9554,9824,2018,94022
948,23961,11305,12656,2018,94024
949,42788,20405,22383,2018,94025
950,7444,3715,3729,2018,94027
951,6868,3278,3590,2018,94028
952,22710,11137,11573,2018,94030
953,2692,1368,1324,2018,94037
954,3687,1933,1754,2018,94038
955,35845,18914,16931,2018,94040
956,14394,7653,6741,2018,94041
957,31488,16753,14735,2018,94043
958,39065,19313,19752,2018,94044
959,1081,602,479,2018,94060
960,39624,19400,20224,2018,94061
961,27757,13496,14261,2018,94062
962,34503,18648,15855,2018,94063
963,12579,5756,6823,2018,94065
964,43124,21159,21965,2018,94066
965,31049,15001,16048,2018,94070
966,197,103,94,2018,94074
967,67597,33132,34465,2018,94080
968,23612,12623,10989,2018,94085
969,49630,25722,23908,2018,94086
970,57219,28494,28725,2018,94087
971,22313,12029,10284,2018,94089
972,31067,17760,13307,2018,94102
973,28735,16788,11947,2018,94103
974,546,372,174,2018,94104
975,9155,4933,4222,2018,94105
976,29689,15618,14071,2018,94107
977,14550,7075,7475,2018,94108
978,56677,29771,26906,2018,94109
979,74161,40201,33960,2018,94110
980,3620,1847,1773,2018,94111
981,85166,42556,42610,2018,94112
982,34754,20097,14657,2018,94114
983,35004,17741,17263,2018,94115
984,47823,23025,24798,2018,94116
985,44239,22556,21683,2018,94117
986,41468,19090,22378,2018,94118
987,43795,21376,22419,2018,94121
988,62131,30424,31707,2018,94122
989,25941,12409,13532,2018,94123
990,35363,17037,18326,2018,94124
991,21423,10570,10853,2018,94127
992,135,67,68,2018,94128
993,3994,1814,2180,2018,94129
994,3064,1747,1317,2018,94130
995,29902,16425,13477,2018,94131
996,31488,15008,16480,2018,94132
997,26527,13231,13296,2018,94133
998,42471,21008,21463,2018,94134
999,7291,3491,3800,2018,94158
1000,17191,8544,8647,2018,94301
1001,48039,24161,23878,2018,94303
1002,3902,1950,1952,2018,94304
1003,15730,8605,7125,2018,94305
1004,27549,13359,14190,2018,94306
1005,35414,17952,17462,2018,94401
1006,25764,12743,13021,2018,94402
1007,44300,21962,22338,2018,94403
1008,36905,18351,18554,2018,94404
1009,63843,30784,33059,2018,94501
1010,14619,7201,7418,2018,94502
1011,20306,10091,10215,2018,94503
1012,16251,7813,8438,2018,94505
1013,25258,12128,13130,2018,94506
1014,15646,8096,7550,2018,94507
1015,4298,2198,2100,2018,94508
1016,66933,32881,34052,2018,94509
1017,28262,13931,14331,2018,94510
1018,2010,1127,883,2018,94511
1019,16,16,0,2018,94512
1020,62991,30581,32410,2018,94513
1021,1461,752,709,2018,94514
1022,7436,3776,3660,2018,94515
1023,148,86,62,2018,94516
1024,13476,6483,6993,2018,94517
1025,28428,13904,14524,2018,94518
1026,20121,9870,10251,2018,94519
1027,38568,19669,18899,2018,94520
1028,43103,20755,22348,2018,94521
1029,35096,16881,18215,2018,94523
1030,3094,1443,1651,2018,94525
1031,32539,15955,16584,2018,94526
1032,307,162,145,2018,94528
1033,25754,12097,13657,2018,94530
1034,43788,21221,22567,2018,94531
1035,75635,37510,38125,2018,94533
1036,38444,18635,19809,2018,94534
1037,3857,1983,1874,2018,94535
1038,73855,37138,36717,2018,94536
1039,68111,34224,33887,2018,94538
1040,52802,25468,27334,2018,94539
1041,66056,33388,32668,2018,94541
1042,14217,6813,7404,2018,94542
1043,79235,39468,39767,2018,94544
1044,32525,16188,16337,2018,94545
1045,44272,21309,22963,2018,94546
1046,25343,12297,13046,2018,94547
1047,501,293,208,2018,94548
1048,29639,14149,15490,2018,94549
1049,50500,24435,26065,2018,94550
1050,45753,22862,22891,2018,94551
1051,15412,7673,7739,2018,94552
1052,49699,24308,25391,2018,94553
1053,38388,19015,19373,2018,94555
1054,16368,7846,8522,2018,94556
1055,69142,34497,34645,2018,94558
1056,27523,14057,13466,2018,94559
1057,46276,23427,22849,2018,94560
1058,41911,20882,21029,2018,94561
1059,19341,9367,9974,2018,94563
1060,19200,8796,10404,2018,94564
1061,96081,47922,48159,2018,94565
1062,45910,23014,22896,2018,94566
1063,696,308,388,2018,94567
1064,54420,27069,27351,2018,94568
1065,205,122,83,2018,94569
1066,9784,4788,4996,2018,94571
1067,10411,5070,5341,2018,94572
1068,31,21,10,2018,94573
1069,8677,4059,4618,2018,94574
1070,1170,380,790,2018,94575
1071,98,58,40,2018,94576
1072,48088,22726,25362,2018,94577
1073,41059,19175,21884,2018,94578
1074,22040,11028,11012,2018,94579
1075,29942,14976,14966,2018,94580
1076,42059,21177,20882,2018,94582
1077,35102,17397,17705,2018,94583
1078,29599,14439,15160,2018,94585
1079,899,508,391,2018,94586
1080,74601,38120,36481,2018,94587
1081,36316,17344,18972,2018,94588
1082,30668,14516,16152,2018,94589
1083,37377,18293,19084,2018,94590
1084,55334,26959,28375,2018,94591
1085,1087,535,552,2018,94592
1086,17938,7623,10315,2018,94595
1087,20822,9969,10853,2018,94596
1088,22734,11470,11264,2018,94597
1089,27780,13136,14644,2018,94598
1090,3078,1399,1679,2018,94599
1091,52299,26145,26154,2018,94601
1092,29933,14845,15088,2018,94602
1093,34593,16828,17765,2018,94603
1094,43112,20613,22499,2018,94605
1095,38303,18330,19973,2018,94606
1096,26254,12912,13342,2018,94607
1097,30289,14820,15469,2018,94608
1098,22811,11192,11619,2018,94609
1099,31496,14762,16734,2018,94610
1100,39384,18554,20830,2018,94611
1101,16062,8490,7572,2018,94612
1102,861,26,835,2018,94613
1103,17041,7942,9099,2018,94618
1104,24308,11339,12969,2018,94619
1105,35287,16939,18348,2018,94621
1106,17092,8256,8836,2018,94702
1107,21937,11170,10767,2018,94703
1108,29190,14085,15105,2018,94704
1109,13365,6520,6845,2018,94705
1110,21040,10301,10739,2018,94706
1111,11916,5846,6070,2018,94707
1112,11455,5600,5855,2018,94708
1113,11740,5828,5912,2018,94709
1114,7461,3798,3663,2018,94710
1115,2971,1402,1569,2018,94720
1116,29958,14906,15052,2018,94801
1117,26165,12722,13443,2018,94803
1118,41510,20138,21372,2018,94804
1119,14208,6742,7466,2018,94805
1120,64410,32316,32094,2018,94806
1121,0,0,0,2018,94850
1122,42482,21911,20571,2018,94901
1123,30048,14637,15411,2018,94903
1124,12590,5983,6607,2018,94904
1125,12797,5987,6810,2018,94920
1126,603,272,331,2018,94922
1127,846,430,416,2018,94923
1128,1134,503,631,2018,94924
1129,9866,4287,5579,2018,94925
1130,44103,20803,23300,2018,94928
1131,219,95,124,2018,94929
1132,8678,3902,4776,2018,94930
1133,8601,3857,4744,2018,94931
1134,671,306,365,2018,94933
1135,816,402,414,2018,94937
1136,790,387,403,2018,94938
1137,7108,3174,3934,2018,94939
1138,234,102,132,2018,94940
1139,32013,15149,16864,2018,94941
1140,19035,9184,9851,2018,94945
1141,694,322,372,2018,94946
1142,26573,12931,13642,2018,94947
1143,17452,8864,8588,2018,94949
1144,134,72,62,2018,94950
1145,4571,2157,2414,2018,94951
1146,36184,17765,18419,2018,94952
1147,38414,19095,19319,2018,94954
1148,1224,507,717,2018,94956
1149,1400,723,677,2018,94957
1150,15725,7473,8252,2018,94960
1151,498,210,288,2018,94963
1152,3418,3246,172,2018,94964
1153,11408,5076,6332,2018,94965
1154,689,340,349,2018,94970
1155,288,106,182,2018,94971
1156,23,12,11,2018,94972
1157,1342,725,617,2018,94973
1158,2146,1167,979,2018,95002
1159,24837,11696,13141,2018,95003
1160,3956,2141,1815,2018,95004
1161,7710,3684,4026,2018,95005
1162,9238,4712,4526,2018,95006
1163,681,346,335,2018,95007
1164,46513,22753,23760,2018,95008
1165,9030,4143,4887,2018,95010
1166,10792,5646,5146,2018,95012
1167,77,22,55,2018,95013
1168,62430,30611,31819,2018,95014
1169,603,314,289,2018,95017
1170,7060,3537,3523,2018,95018
1171,7703,3850,3853,2018,95019
1172,63852,31452,32400,2018,95020
1173,52646,26278,26368,2018,95023
1174,13288,6473,6815,2018,95030
1175,26281,13007,13274,2018,95032
1176,9597,4922,4675,2018,95033
1177,77562,39606,37956,2018,95035
1178,51652,25501,26151,2018,95037
1179,1195,586,609,2018,95039
1180,353,221,132,2018,95041
1181,732,376,356,2018,95043
1182,4181,1975,2206,2018,95045
1183,6025,3107,2918,2018,95046
1184,39452,20812,18640,2018,95050
1185,58123,29996,28127,2018,95051
1186,3678,1709,1969,2018,95053
1187,24264,12545,11719,2018,95054
1188,47367,23335,24032,2018,95060
1189,38028,19362,18666,2018,95062
1190,10299,4410,5889,2018,95064
1191,8355,3909,4446,2018,95065
1192,15217,7581,7636,2018,95066
1193,31308,15521,15787,2018,95070
1194,10949,5389,5560,2018,95073
1195,484,222,262,2018,95075
1196,86703,44315,42388,2018,95076
1197,20203,11257,8946,2018,95110
1198,62392,31249,31143,2018,95111
1199,61060,31972,29088,2018,95112
1200,1939,1101,838,2018,95113
1201,56481,28823,27658,2018,95116
1202,29592,14928,14664,2018,95117
1203,32560,16265,16295,2018,95118
1204,10472,5155,5317,2018,95119
1205,37774,18706,19068,2018,95120
1206,38102,18939,19163,2018,95121
1207,57780,29193,28587,2018,95122
1208,67186,32907,34279,2018,95123
1209,51170,26248,24922,2018,95124
1210,53574,25637,27937,2018,95125
1211,35988,18389,17599,2018,95126
1212,65686,34324,31362,2018,95127
1213,37665,19374,18291,2018,95128
1214,39828,19991,19837,2018,95129
1215,14863,7328,7535,2018,95130
1216,31170,16157,15013,2018,95131
1217,41844,20717,21127,2018,95132
1218,28726,14288,14438,2018,95133
1219,27224,14780,12444,2018,95134
1220,22358,10647,11711,2018,95135
1221,47599,22951,24648,2018,95136
1222,20766,10301,10465,2018,95138
1223,7293,3768,3525,2018,95139
1224,115,64,51,2018,95140
1225,48854,23814,25040,2018,95148
1226,6001,2944,3057,2018,95202
1227,15775,7949,7826,2018,95203
1228,28425,13382,15043,2018,95204
1229,38544,19916,18628,2018,95205
1230,64034,32343,31691,2018,95206
1231,51879,24627,27252,2018,95207
1232,44313,21756,22557,2018,95209
1233,41117,19718,21399,2018,95210
1234,1629,712,917,2018,95211
1235,28049,13626,14423,2018,95212
1236,24371,13346,11025,2018,95215
1237,29668,14752,14916,2018,95219
1238,7538,3706,3832,2018,95220
1239,5090,2405,2685,2018,95222
1240,2860,1564,1296,2018,95223
1241,166,65,101,2018,95224
1242,470,198,272,2018,95225
1243,16,16,0,2018,95226
1244,842,426,416,2018,95227
1245,4501,2316,2185,2018,95228
1246,597,295,302,2018,95230
1247,5092,3404,1688,2018,95231
1248,164,77,87,2018,95232
1249,567,223,344,2018,95233
1250,113,51,62,2018,95234
1251,4223,2106,2117,2018,95236
1252,3531,1954,1577,2018,95237
1253,48838,24272,24566,2018,95240
1254,26235,12561,13674,2018,95242
1255,1851,913,938,2018,95245
1256,1032,578,454,2018,95246
1257,4270,1935,2335,2018,95247
1258,189,98,91,2018,95248
1259,4854,2543,2311,2018,95249
1260,0,0,0,2018,95250
1261,582,267,315,2018,95251
1262,15703,7716,7987,2018,95252
1263,1151,630,521,2018,95254
1264,1358,752,606,2018,95255
1265,433,155,278,2018,95257
1266,3881,1956,1925,2018,95258
1267,38707,20125,18582,2018,95301
1268,871,509,362,2018,95303
1269,14539,8530,6009,2018,95304
1270,37,20,17,2018,95305
1271,882,471,411,2018,95306
1272,44736,22432,22304,2018,95307
1273,1995,1087,908,2018,95310
1274,1649,809,840,2018,95311
1275,304,159,145,2018,95312
1276,1225,653,572,2018,95313
1277,95,67,28,2018,95314
1278,14019,7106,6913,2018,95315
1279,6616,3390,3226,2018,95316
1280,906,508,398,2018,95317
1281,268,169,99,2018,95318
1282,1529,913,616,2018,95319
1283,13094,6557,6537,2018,95320
1284,3337,1494,1843,2018,95321
1285,10546,5118,5428,2018,95322
1286,1222,610,612,2018,95323
1287,8016,3940,4076,2018,95324
1288,77,31,46,2018,95325
1289,9888,4569,5319,2018,95326
1290,7711,5118,2593,2018,95327
1291,4518,2141,2377,2018,95328
1292,2685,1297,1388,2018,95329
1293,21552,10932,10620,2018,95330
1294,2479,1300,1179,2018,95333
1295,16787,8229,8558,2018,95334
1296,201,127,74,2018,95335
1297,47612,23105,24507,2018,95336
1298,37706,18512,19194,2018,95337
1299,10898,5490,5408,2018,95338
1300,36373,18152,18221,2018,95340
1301,32446,16544,15902,2018,95341
1302,749,277,472,2018,95345
1303,1661,931,730,2018,95346
1304,34241,16759,17482,2018,95348
1305,53098,25467,27631,2018,95350
1306,50079,24743,25336,2018,95351
1307,24743,12395,12348,2018,95354
1308,59028,29196,29832,2018,95355
1309,32842,16300,16542,2018,95356
1310,11322,5788,5534,2018,95357
1311,33345,17720,15625,2018,95358
1312,13029,6332,6697,2018,95360
1313,34558,16892,17666,2018,95361
1314,26900,13889,13011,2018,95363
1315,0,0,0,2018,95364
1316,4710,2486,2224,2018,95365
1317,17654,8755,8899,2018,95366
1318,25162,11989,13173,2018,95367
1319,14520,7127,7393,2018,95368
1320,990,522,468,2018,95369
1321,27951,13474,14477,2018,95370
1322,2164,1257,907,2018,95372
1323,1758,926,832,2018,95374
1324,5,5,0,2018,95375
1325,53542,26525,27017,2018,95376
1326,32501,16694,15807,2018,95377
1327,3586,1748,1838,2018,95379
1328,42672,20719,21953,2018,95380
1329,38343,18476,19867,2018,95382
1330,3828,2103,1725,2018,95383
1331,440,281,159,2018,95385
1332,10587,5347,5240,2018,95386
1333,710,393,317,2018,95387
1334,14242,7583,6659,2018,95388
1335,1392,882,510,2018,95389
1336,16562,7805,8757,2018,95391
1337,38986,18684,20302,2018,95401
1338,45355,22470,22885,2018,95403
1339,40474,20288,20186,2018,95404
1340,21448,9924,11524,2018,95405
1341,42483,21505,20978,2018,95407
1342,27312,12427,14885,2018,95409
1343,1159,577,582,2018,95410
1344,402,221,181,2018,95412
1345,1262,674,588,2018,95415
1346,389,241,148,2018,95417
1347,648,339,309,2018,95420
1348,1681,836,845,2018,95421
1349,15550,7760,7790,2018,95422
1350,3757,2055,1702,2018,95423
1351,10586,5038,5548,2018,95425
1352,1404,844,560,2018,95426
1353,222,111,111,2018,95427
1354,2563,1376,1187,2018,95428
1355,124,83,41,2018,95429
1356,7,7,0,2018,95430
1357,196,122,74,2018,95431
1358,519,321,198,2018,95432
1359,14,0,14,2018,95435
1360,6352,3242,3110,2018,95436
1361,14632,7188,7444,2018,95437
1362,774,472,302,2018,95439
1363,2053,1183,870,2018,95441
1364,3136,1619,1517,2018,95442
1365,270,150,120,2018,95443
1366,715,222,493,2018,95444
1367,2201,988,1213,2018,95445
1368,5100,2620,2480,2018,95446
1369,17482,8528,8954,2018,95448
1370,1656,915,741,2018,95449
1371,298,167,131,2018,95450
1372,11627,5400,6227,2018,95451
1373,970,455,515,2018,95452
1374,11092,5337,5755,2018,95453
1375,2198,1015,1183,2018,95454
1376,754,277,477,2018,95456
1377,3330,1681,1649,2018,95457
1378,3019,1625,1394,2018,95458
1379,618,316,302,2018,95459
1380,2277,1245,1032,2018,95460
1381,2440,1213,1227,2018,95461
1382,1265,667,598,2018,95462
1383,152,56,96,2018,95463
1384,2538,1317,1221,2018,95464
1385,2104,1041,1063,2018,95465
1386,993,590,403,2018,95466
1387,6044,2942,3102,2018,95467
1388,1325,600,725,2018,95468
1389,2015,951,1064,2018,95469
1390,5719,2930,2789,2018,95470
1391,470,242,228,2018,95471
1392,30762,15005,15757,2018,95472
1393,36792,18370,18422,2018,95476
1394,31847,15493,16354,2018,95482
1395,2688,1406,1282,2018,95485
1396,73,56,17,2018,95486
1397,251,132,119,2018,95488
1398,12914,6530,6384,2018,95490
1399,29920,15101,14819,2018,95492
1400,241,104,137,2018,95493
1401,125,56,69,2018,95494
1402,1161,459,702,2018,95497
1403,23467,11889,11578,2018,95501
1404,25503,12202,13301,2018,95503
1405,290,128,162,2018,95511
1406,117,81,36,2018,95514
1407,19099,9858,9241,2018,95519
1408,21462,10444,11018,2018,95521
1409,1724,872,852,2018,95524
1410,1433,834,599,2018,95525
1411,210,117,93,2018,95526
1412,570,295,275,2018,95527
1413,1493,716,777,2018,95528
1414,23470,12672,10798,2018,95531
1415,2898,1523,1375,2018,95536
1416,325,216,109,2018,95537
1417,14305,6883,7422,2018,95540
1418,2072,1058,1014,2018,95542
1419,664,319,345,2018,95543
1420,101,67,34,2018,95545
1421,3768,1722,2046,2018,95546
1422,978,401,577,2018,95547
1423,1224,606,618,2018,95548
1424,1050,558,492,2018,95549
1425,71,37,34,2018,95550
1426,1374,654,720,2018,95551
1427,659,331,328,2018,95552
1428,913,589,324,2018,95553
1429,287,148,139,2018,95554
1430,337,161,176,2018,95555
1431,627,352,275,2018,95556
1432,423,217,206,2018,95558
1433,72,16,56,2018,95559
1434,1466,856,610,2018,95560
1435,3422,1662,1760,2018,95562
1436,604,274,330,2018,95563
1437,432,218,214,2018,95564
1438,772,402,370,2018,95565
1439,2066,978,1088,2018,95567
1440,253,153,100,2018,95568
1441,295,178,117,2018,95569
1442,2274,1106,1168,2018,95570
1443,271,116,155,2018,95571
1444,1554,859,695,2018,95573
1445,483,244,239,2018,95585
1446,49,10,39,2018,95587
1447,982,580,402,2018,95589
1448,182,106,76,2018,95595
1449,144,73,71,2018,95601
1450,18063,8690,9373,2018,95602
1451,29244,14220,15024,2018,95603
1452,87,42,45,2018,95604
1453,14960,7763,7197,2018,95605
1454,240,119,121,2018,95606
1455,327,180,147,2018,95607
1456,61860,28874,32986,2018,95608
1457,45995,22254,23741,2018,95610
1458,1078,613,465,2018,95612
1459,3961,2059,1902,2018,95614
1460,999,598,401,2018,95615
1461,52088,24509,27579,2018,95616
1462,26743,13077,13666,2018,95618
1463,5674,2893,2781,2018,95619
1464,21854,11127,10727,2018,95620
1465,41757,20218,21539,2018,95621
1466,3730,1956,1774,2018,95623
1467,65742,32407,33335,2018,95624
1468,67,59,8,2018,95625
1469,6335,3457,2878,2018,95626
1470,4263,2063,2200,2018,95627
1471,41121,20009,21112,2018,95628
1472,795,305,490,2018,95629
1473,76973,40091,36882,2018,95630
1474,6800,3632,3168,2018,95631
1475,31431,15447,15984,2018,95632
1476,3857,2052,1805,2018,95633
1477,3445,2030,1415,2018,95634
1478,807,397,410,2018,95635
1479,1087,531,556,2018,95636
1480,227,146,81,2018,95637
1481,2121,1068,1053,2018,95638
1482,321,152,169,2018,95639
1483,10977,7193,3784,2018,95640
1484,1548,693,855,2018,95641
1485,6826,3160,3666,2018,95642
1486,1652,879,773,2018,95645
1487,76,71,5,2018,95646
1488,52394,25281,27113,2018,95648
1489,14059,6965,7094,2018,95650
1490,819,479,340,2018,95651
1491,667,289,378,2018,95652
1492,563,347,216,2018,95653
1493,4178,2017,2161,2018,95655
1494,6853,3327,3526,2018,95658
1495,861,449,412,2018,95659
1496,36472,18006,18466,2018,95660
1497,31327,15010,16317,2018,95661
1498,32006,16002,16004,2018,95662
1499,2602,1128,1474,2018,95663
1500,1589,899,690,2018,95664
1501,4664,2392,2272,2018,95665
1502,5113,2567,2546,2018,95666
1503,36620,17439,19181,2018,95667
1504,743,359,384,2018,95668
1505,2348,1163,1185,2018,95669
1506,54648,27214,27434,2018,95670
1507,5220,2444,2776,2018,95672
1508,15753,7560,8193,2018,95673
1509,913,446,467,2018,95674
1510,607,315,292,2018,95675
1511,25279,12249,13030,2018,95677
1512,43132,21397,21735,2018,95678
1513,71,44,27,2018,95679
1514,10,0,10,2018,95680
1515,1148,682,466,2018,95681
1516,30141,15217,14924,2018,95682
1517,6279,2981,3298,2018,95683
1518,3384,1740,1644,2018,95684
1519,4711,2221,2490,2018,95685
1520,1209,632,577,2018,95686
1521,68069,35885,32184,2018,95687
1522,37227,18597,18630,2018,95688
1523,1698,911,787,2018,95689
1524,2122,1080,1042,2018,95690
1525,37906,18101,19805,2018,95691
1526,5152,2689,2463,2018,95692
1527,6759,3239,3520,2018,95693
1528,10386,5146,5240,2018,95694
1529,40857,19628,21229,2018,95695
1530,420,240,180,2018,95697
1531,179,100,79,2018,95698
1532,20,14,6,2018,95699
1533,806,386,420,2018,95701
1534,938,455,483,2018,95703
1535,5315,2777,2538,2018,95709
1536,9764,4875,4889,2018,95713
1537,440,200,240,2018,95714
1538,91,47,44,2018,95715
1539,106,62,44,2018,95717
1540,83,37,46,2018,95720
1541,15,15,0,2018,95721
1542,4822,2320,2502,2018,95722
1543,20,20,0,2018,95724
1544,8170,3818,4352,2018,95726
1545,229,153,76,2018,95728
1546,10,6,4,2018,95735
1547,198,99,99,2018,95736
1548,11921,6077,5844,2018,95742
1549,23492,11718,11774,2018,95746
1550,65335,31350,33985,2018,95747
1551,49683,24297,25386,2018,95757
1552,63894,30090,33804,2018,95758
1553,42494,20868,21626,2018,95762
1554,37878,18158,19720,2018,95765
1555,23375,11623,11752,2018,95776
1556,6050,3169,2881,2018,95811
1557,11340,6741,4599,2018,95814
1558,25224,13072,12152,2018,95815
1559,17217,8108,9109,2018,95816
1560,13461,5972,7489,2018,95817
1561,21732,10472,11260,2018,95818
1562,19659,8926,10733,2018,95819
1563,35477,17166,18311,2018,95820
1564,35430,16526,18904,2018,95821
1565,45323,22328,22995,2018,95822
1566,79272,38277,40995,2018,95823
1567,30296,15102,15194,2018,95824
1568,35825,17270,18555,2018,95825
1569,38256,18406,19850,2018,95826
1570,21185,10755,10430,2018,95827
1571,60270,29564,30706,2018,95828
1572,28134,13865,14269,2018,95829
1573,902,509,393,2018,95830
1574,42514,19937,22577,2018,95831
1575,11518,5932,5586,2018,95832
1576,41209,20298,20911,2018,95833
1577,28229,13797,14432,2018,95834
1578,40101,19351,20750,2018,95835
1579,305,184,121,2018,95837
1580,39187,19339,19848,2018,95838
1581,20586,9467,11119,2018,95841
1582,32269,15400,16869,2018,95842
1583,46709,23246,23463,2018,95843
1584,23733,11473,12260,2018,95864
1585,33442,16524,16918,2018,95901
1586,1630,973,657,2018,95903
1587,65,26,39,2018,95910
1588,5010,2658,2352,2018,95912
1589,815,387,428,2018,95914
1590,0,0,0,2018,95915
1591,1216,662,554,2018,95916
1592,4030,2140,1890,2018,95917
1593,2643,1538,1105,2018,95918
1594,1182,702,480,2018,95919
1595,285,143,142,2018,95920
1596,454,256,198,2018,95922
1597,28,14,14,2018,95923
1598,209,89,120,2018,95925
1599,39012,19122,19890,2018,95926
1600,37558,18834,18724,2018,95928
1601,191,94,97,2018,95930
1602,7742,4026,3716,2018,95932
1603,341,226,115,2018,95934
1604,602,204,398,2018,95935
1605,114,67,47,2018,95936
1606,1442,691,751,2018,95937
1607,4350,2014,2336,2018,95938
1608,673,358,315,2018,95939
1609,497,218,279,2018,95941
1610,629,370,259,2018,95942
1611,908,562,346,2018,95943
1612,29,20,9,2018,95944
1613,25519,11712,13807,2018,95945
1614,9370,4733,4637,2018,95946
1615,2005,1019,986,2018,95947
1616,11173,5422,5751,2018,95948
1617,20519,9959,10560,2018,95949
1618,394,183,211,2018,95950
1619,2788,1509,1279,2018,95951
1620,10942,5518,5424,2018,95953
1621,13495,6423,7072,2018,95954
1622,1435,772,663,2018,95955
1623,290,138,152,2018,95956
1624,888,460,428,2018,95957
1625,17910,9429,8481,2018,95959
1626,825,471,354,2018,95960
1627,27728,14141,13587,2018,95961
1628,1278,746,532,2018,95962
1629,15043,7526,7517,2018,95963
1630,20460,10542,9918,2018,95965
1631,29367,14458,14909,2018,95966
1632,1287,711,576,2018,95968
1633,27967,13348,14619,2018,95969
1634,551,258,293,2018,95970
1635,6254,3233,3021,2018,95971
1636,35445,17913,17532,2018,95973
1637,64,47,17,2018,95974
1638,1584,910,674,2018,95975
1639,1617,823,794,2018,95977
1640,163,95,68,2018,95978
1641,430,246,184,2018,95979
1642,32,22,10,2018,95981
1643,3229,1717,1512,2018,95982
1644,403,195,208,2018,95983
1645,33,8,25,2018,95984
1646,53,38,15,2018,95986
1647,6119,3080,3039,2018,95987
1648,8381,4179,4202,2018,95988
1649,40684,19788,20896,2018,95991
1650,36962,18715,18247,2018,95993
1651,34571,17041,17530,2018,96001
1652,33901,15804,18097,2018,96002
1653,44475,21946,22529,2018,96003
1654,380,186,194,2018,96006
1655,23106,11679,11427,2018,96007
1656,1328,520,808,2018,96008
1657,345,185,160,2018,96009
1658,146,102,44,2018,96010
1659,162,90,72,2018,96011
1660,4810,2323,2487,2018,96013
1661,145,79,66,2018,96014
1662,529,300,229,2018,96015
1663,375,166,209,2018,96016
1664,152,91,61,2018,96017
1665,10111,5108,5003,2018,96019
1666,2242,1164,1078,2018,96020
1667,16228,7748,8480,2018,96021
1668,16442,7682,8760,2018,96022
1669,1114,600,514,2018,96023
1670,933,493,440,2018,96024
1671,1957,947,1010,2018,96025
1672,2416,1275,1141,2018,96027
1673,1359,671,688,2018,96028
1674,195,108,87,2018,96029
1675,136,69,67,2018,96031
1676,2510,1362,1148,2018,96032
1677,500,246,254,2018,96033
1678,236,100,136,2018,96034
1679,3731,1963,1768,2018,96035
1680,335,139,196,2018,96037
1681,827,420,407,2018,96038
1682,907,437,470,2018,96039
1683,178,72,106,2018,96040
1684,2797,1284,1513,2018,96041
1685,931,491,440,2018,96044
1686,165,86,79,2018,96046
1687,851,482,369,2018,96047
1688,713,331,382,2018,96048
1689,87,43,44,2018,96049
1690,418,233,185,2018,96050
1691,1351,656,695,2018,96051
1692,1493,864,629,2018,96052
1693,339,190,149,2018,96054
1694,3914,1952,1962,2018,96055
1695,1572,825,747,2018,96056
1696,1299,677,622,2018,96057
1697,686,377,309,2018,96058
1698,599,309,290,2018,96059
1699,19,8,11,2018,96061
1700,1007,486,521,2018,96062
1701,292,184,108,2018,96063
1702,4769,2491,2278,2018,96064
1703,359,201,158,2018,96065
1704,6910,3277,3633,2018,96067
1705,193,150,43,2018,96068
1706,828,425,403,2018,96069
1707,49,25,24,2018,96071
1708,3939,1967,1972,2018,96073
1709,174,104,70,2018,96074
1710,331,229,102,2018,96075
1711,200,115,85,2018,96076
1712,28487,14436,14051,2018,96080
1713,458,190,268,2018,96084
1714,85,41,44,2018,96085
1715,309,160,149,2018,96086
1716,589,363,226,2018,96087
1717,4419,2360,2059,2018,96088
1718,445,227,218,2018,96090
1719,578,307,271,2018,96091
1720,254,193,61,2018,96092
1721,3955,2070,1885,2018,96093
1722,6556,3257,3299,2018,96094
1723,732,394,338,2018,96096
1724,9647,4555,5092,2018,96097
1725,5500,2836,2664,2018,96101
1726,1417,664,753,2018,96103
1727,603,312,291,2018,96104
1728,93,35,58,2018,96105
1729,209,108,101,2018,96106
1730,1450,685,765,2018,96107
1731,56,32,24,2018,96108
1732,758,431,327,2018,96109
1733,161,79,82,2018,96110
1734,94,75,19,2018,96111
1735,202,69,133,2018,96112
1736,1957,1504,453,2018,96113
1737,3316,1652,1664,2018,96114
1738,115,68,47,2018,96115
1739,159,83,76,2018,96116
1740,319,146,173,2018,96117
1741,1808,889,919,2018,96118
1742,59,22,37,2018,96119
1743,1044,540,504,2018,96120
1744,317,204,113,2018,96121
1745,3044,1439,1605,2018,96122
1746,38,18,20,2018,96123
1747,329,143,186,2018,96124
1748,184,82,102,2018,96125
1749,103,74,29,2018,96126
1750,674,410,264,2018,96128
1751,496,289,207,2018,96129
1752,20553,14603,5950,2018,96130
1753,93,44,49,2018,96132
1754,234,149,85,2018,96133
1755,1918,1020,898,2018,96134
1756,230,107,123,2018,96135
1757,42,6,36,2018,96136
1758,3336,1619,1717,2018,96137
1759,1019,525,494,2018,96140
1760,297,142,155,2018,96141
1761,807,434,373,2018,96142
1762,3391,1789,1602,2018,96143
1763,2151,1130,1021,2018,96145
1764,969,562,407,2018,96146
1765,696,419,277,2018,96148
1766,29357,14913,14444,2018,96150
1767,0,0,0,2018,96155
1768,18333,9461,8872,2018,96161
1769,138,74,64,2018,97635
0,Estimate!!SEX AND AGE!!Total population,Estimate!!SEX AND AGE!!Total population!!Male,Estimate!!SEX AND AGE!!Total population!!Female,2017,Geographic Area Name
1,512,215,297,2017,89010
2,1748,738,1010,2017,89019
3,9373,4828,4545,2017,89060
4,5360,2519,2841,2017,89061
5,1465,653,812,2017,89439
6,58738,30198,28540,2017,90001
7,52856,25245,27611,2017,90002
8,70490,34343,36147,2017,90003
9,62733,31340,31393,2017,90004
10,39562,19611,19951,2017,90005
11,62329,31166,31163,2017,90006
12,41221,20500,20721,2017,90007
13,32359,14202,18157,2017,90008
14,3759,1826,1933,2017,90010
15,108051,53897,54154,2017,90011
16,33783,20649,13134,2017,90012
17,11957,7472,4485,2017,90013
18,7408,4712,2696,2017,90014
19,20187,10114,10073,2017,90015
20,46303,22589,23714,2017,90016
21,26390,14099,12291,2017,90017
22,52287,25145,27142,2017,90018
23,67415,32822,34593,2017,90019
24,39191,19193,19998,2017,90020
25,3158,2125,1033,2017,90021
26,67446,32954,34492,2017,90022
27,47229,23815,23414,2017,90023
28,49718,22924,26794,2017,90024
29,47453,23943,23510,2017,90025
30,68609,34868,33741,2017,90026
31,45616,22443,23173,2017,90027
32,31054,17386,13668,2017,90028
33,38843,19721,19122,2017,90029
34,39103,19866,19237,2017,90031
35,47766,22957,24809,2017,90032
36,48841,23591,25250,2017,90033
37,56070,27840,28230,2017,90034
38,29920,14162,15758,2017,90035
39,38116,17674,20442,2017,90036
40,63238,31138,32100,2017,90037
41,27957,14728,13229,2017,90038
42,29092,14341,14751,2017,90039
43,12925,6445,6480,2017,90040
44,28651,13790,14861,2017,90041
45,63788,31196,32592,2017,90042
46,44571,20682,23889,2017,90043
47,94680,44254,50426,2017,90044
48,41420,19658,21762,2017,90045
49,51615,27957,23658,2017,90046
50,48491,20928,27563,2017,90047
51,22860,10451,12409,2017,90048
52,36362,16189,20173,2017,90049
53,8014,3358,4656,2017,90056
54,49389,26567,22822,2017,90057
55,3189,1553,1636,2017,90058
56,47351,23179,24172,2017,90059
57,28003,12885,15118,2017,90061
58,33627,16158,17469,2017,90062
59,53556,26804,26752,2017,90063
60,26007,12559,13448,2017,90064
61,48420,24627,23793,2017,90065
62,59747,30282,29465,2017,90066
63,2235,1163,1072,2017,90067
64,21726,11522,10204,2017,90068
65,20401,12516,7885,2017,90069
66,0,0,0,2017,90071
67,944,861,83,2017,90073
68,8936,4343,4593,2017,90077
69,0,0,0,2017,90079
70,3846,1803,2043,2017,90089
71,0,0,0,2017,90090
72,8568,3878,4690,2017,90094
73,0,0,0,2017,90095
74,102878,51664,51214,2017,90201
75,20016,9614,10402,2017,90210
76,8019,3675,4344,2017,90211
77,13207,6087,7120,2017,90212
78,51713,24714,26999,2017,90220
79,54259,27232,27027,2017,90221
80,32585,15661,16924,2017,90222
81,32657,15937,16720,2017,90230
82,14865,7077,7788,2017,90232
83,26339,13018,13321,2017,90240
84,44097,21781,22316,2017,90241
85,42922,20820,22102,2017,90242
86,16929,8313,8616,2017,90245
87,47969,23190,24779,2017,90247
88,10899,5477,5422,2017,90248
89,26286,12416,13870,2017,90249
90,97371,48146,49225,2017,90250
91,19750,10077,9673,2017,90254
92,75636,37757,37879,2017,90255
93,35614,18130,17484,2017,90260
94,71306,34459,36847,2017,90262
95,1868,783,1085,2017,90263
96,18119,8969,9150,2017,90265
97,35698,17466,18232,2017,90266
98,27597,13912,13685,2017,90270
99,22927,10966,11961,2017,90272
100,25374,12178,13196,2017,90274
101,42606,20182,22424,2017,90275
102,34922,17596,17326,2017,90277
103,40808,20683,20125,2017,90278
104,95420,46695,48725,2017,90280
105,5714,2674,3040,2017,90290
106,27170,13951,13219,2017,90291
107,22328,11574,10754,2017,90292
108,12762,6281,6481,2017,90293
109,37518,18449,19069,2017,90301
110,30892,14186,16706,2017,90302
111,24658,11655,13003,2017,90303
112,25937,12886,13051,2017,90304
113,15574,7239,8335,2017,90305
114,7485,3867,3618,2017,90401
115,11681,5624,6057,2017,90402
116,24764,12053,12711,2017,90403
117,22586,10830,11756,2017,90404
118,28305,14147,14158,2017,90405
119,43008,20967,22041,2017,90501
120,18010,9238,8772,2017,90502
121,45349,22064,23285,2017,90503
122,33422,16379,17043,2017,90504
123,37368,18311,19057,2017,90505
124,0,0,0,2017,90506
125,34025,16837,17188,2017,90601
126,26482,12621,13861,2017,90602
127,20697,10469,10228,2017,90603
128,41369,19767,21602,2017,90604
129,41818,20461,21357,2017,90605
130,32599,16523,16076,2017,90606
131,46038,22260,23778,2017,90620
132,36074,18623,17451,2017,90621
133,15882,7728,8154,2017,90623
134,49249,23878,25371,2017,90630
135,69579,34225,35354,2017,90631
136,49797,24534,25263,2017,90638
137,63547,30812,32735,2017,90640
138,106404,52830,53574,2017,90650
139,63694,30925,32769,2017,90660
140,16642,7915,8727,2017,90670
141,30530,15175,15355,2017,90680
142,16912,8297,8615,2017,90701
143,50877,24828,26049,2017,90703
144,3940,1834,2106,2017,90704
145,77852,38008,39844,2017,90706
146,28667,13806,14861,2017,90710
147,31471,15246,16225,2017,90712
148,28927,14189,14738,2017,90713
149,20313,9542,10771,2017,90715
150,14409,7182,7227,2017,90716
151,21740,10439,11301,2017,90717
152,22318,10729,11589,2017,90720
153,55020,27392,27628,2017,90723
154,61789,31330,30459,2017,90731
155,22408,10424,11984,2017,90732
156,24443,11337,13106,2017,90740
157,705,408,297,2017,90742
158,248,122,126,2017,90743
159,56779,28460,28319,2017,90744
160,57219,27866,29353,2017,90745
161,26852,13002,13850,2017,90746
162,0,0,0,2017,90747
163,11581,5697,5884,2017,90755
164,40226,20958,19268,2017,90802
165,32116,15904,16212,2017,90803
166,40225,19678,20547,2017,90804
167,96069,46911,49158,2017,90805
168,42587,20775,21812,2017,90806
169,32395,15640,16755,2017,90807
170,38487,18824,19663,2017,90808
171,38769,18994,19775,2017,90810
172,60935,30416,30519,2017,90813
173,18175,8775,9400,2017,90814
174,40359,19793,20566,2017,90815
175,143,132,11,2017,90822
176,0,0,0,2017,90831
177,37528,18725,18803,2017,91001
178,33200,15903,17297,2017,91006
179,34357,16175,18182,2017,91007
180,1191,530,661,2017,91008
181,26265,12210,14055,2017,91010
182,20499,10185,10314,2017,91011
183,42013,20843,21170,2017,91016
184,8551,3990,4561,2017,91020
185,11061,5238,5823,2017,91024
186,25940,12734,13206,2017,91030
187,20175,10084,10091,2017,91040
188,26767,12850,13917,2017,91042
189,160,70,90,2017,91046
190,20719,9311,11408,2017,91101
191,28435,14060,14375,2017,91103
192,39178,18450,20728,2017,91104
193,11907,6005,5902,2017,91105
194,25479,12815,12664,2017,91106
195,32199,15933,16266,2017,91107
196,13769,6745,7024,2017,91108
197,23466,10779,12687,2017,91201
198,23182,10776,12406,2017,91202
199,14393,7189,7204,2017,91203
200,18318,8735,9583,2017,91204
201,37514,17813,19701,2017,91205
202,34938,16739,18199,2017,91206
203,10288,4803,5485,2017,91207
204,17128,8450,8678,2017,91208
205,835,498,337,2017,91210
206,30991,14586,16405,2017,91214
207,26028,12475,13553,2017,91301
208,26500,12741,13759,2017,91302
209,30380,15426,14954,2017,91303
210,53627,26658,26969,2017,91304
211,49551,25180,24371,2017,91306
212,27233,13095,14138,2017,91307
213,40064,19641,20423,2017,91311
214,30888,14568,16320,2017,91316
215,45852,23135,22717,2017,91320
216,34510,17249,17261,2017,91321
217,30101,15715,14386,2017,91324
218,34240,17438,16802,2017,91325
219,36804,18164,18640,2017,91326
220,3306,1366,1940,2017,91330
221,105696,52882,52814,2017,91331
222,79687,38907,40780,2017,91335
223,35771,17860,17911,2017,91340
224,96177,48204,47973,2017,91342
225,65964,32476,33488,2017,91343
226,53453,26878,26575,2017,91344
227,19022,9624,9398,2017,91345
228,37149,18060,19089,2017,91350
229,32661,16348,16313,2017,91351
230,47934,23379,24555,2017,91352
231,31027,15094,15933,2017,91354
232,31645,15717,15928,2017,91355
233,30346,14826,15520,2017,91356
234,43389,20812,22577,2017,91360
235,20826,9972,10854,2017,91361
236,36071,17815,18256,2017,91362
237,27031,13502,13529,2017,91364
238,43370,21402,21968,2017,91367
239,0,0,0,2017,91371
240,14440,6855,7585,2017,91377
241,20530,9884,10646,2017,91381
242,29283,17099,12184,2017,91384
243,43319,21445,21874,2017,91387
244,19521,10301,9220,2017,91390
245,40995,20279,20716,2017,91401
246,71317,34799,36518,2017,91402
247,24677,12154,12523,2017,91403
248,54770,27083,27687,2017,91405
249,56200,28280,27920,2017,91406
250,25210,12345,12865,2017,91411
251,33641,16516,17125,2017,91423
252,14794,7066,7728,2017,91436
253,20892,10091,10801,2017,91501
254,11645,5635,6010,2017,91502
255,26558,12809,13749,2017,91504
256,30997,14749,16248,2017,91505
257,18245,8614,9631,2017,91506
258,38379,20095,18284,2017,91601
259,18944,9154,9790,2017,91602
260,30642,14825,15817,2017,91604
261,52386,25942,26444,2017,91605
262,44352,22302,22050,2017,91606
263,31383,15312,16071,2017,91607
264,0,0,0,2017,91608
265,39628,20045,19583,2017,91701
266,61739,29799,31940,2017,91702
267,77819,39405,38414,2017,91706
268,3154,820,2334,2017,91708
269,78025,37636,40389,2017,91709
270,88862,52898,35964,2017,91710
271,36933,17706,19227,2017,91711
272,36557,17738,18819,2017,91722
273,20193,9725,10468,2017,91723
274,25755,12525,13230,2017,91724
275,70545,35038,35507,2017,91730
276,30063,15432,14631,2017,91731
277,63557,31644,31913,2017,91732
278,44989,22816,22173,2017,91733
279,25759,12415,13344,2017,91737
280,39069,19762,19307,2017,91739
281,26067,12544,13523,2017,91740
282,26610,13325,13285,2017,91741
283,86982,43127,43855,2017,91744
284,54166,27444,26722,2017,91745
285,30640,15314,15326,2017,91746
286,47114,23211,23903,2017,91748
287,34017,16546,17471,2017,91750
288,30716,15407,15309,2017,91752
289,33114,15583,17531,2017,91754
290,27942,13613,14329,2017,91755
291,426,217,209,2017,91759
292,60560,29929,30631,2017,91761
293,59433,29191,30242,2017,91762
294,38211,18698,19513,2017,91763
295,53750,26430,27320,2017,91764
296,47398,23354,24044,2017,91765
297,72787,36734,36053,2017,91766
298,49492,24201,25291,2017,91767
299,36122,17916,18206,2017,91768
300,63981,31781,32200,2017,91770
301,34555,16247,18308,2017,91773
302,25156,12174,12982,2017,91775
303,38322,18176,20146,2017,91776
304,35184,16645,18539,2017,91780
305,25908,12611,13297,2017,91784
306,53339,25477,27862,2017,91786
307,44115,21660,22455,2017,91789
308,45958,22879,23079,2017,91790
309,33953,16476,17477,2017,91791
310,29787,14486,15301,2017,91792
311,54928,26337,28591,2017,91801
312,30137,15040,15097,2017,91803
313,18238,9174,9064,2017,91901
314,19762,9761,10001,2017,91902
315,1528,821,707,2017,91905
316,3426,1882,1544,2017,91906
317,76250,37794,38456,2017,91910
318,84025,41213,42812,2017,91911
319,49346,24213,25133,2017,91913
320,17186,8457,8729,2017,91914
321,32073,15011,17062,2017,91915
322,1752,910,842,2017,91916
323,1125,502,623,2017,91917
324,370,189,181,2017,91931
325,26713,13115,13598,2017,91932
326,298,220,78,2017,91934
327,8547,4154,4393,2017,91935
328,32944,16114,16830,2017,91941
329,40239,19119,21120,2017,91942
330,26983,13349,13634,2017,91945
331,14,14,0,2017,91948
332,62386,31158,31228,2017,91950
333,2530,1371,1159,2017,91962
334,957,502,455,2017,91963
335,61377,30439,30938,2017,91977
336,9829,4669,5160,2017,91978
337,623,369,254,2017,91980
338,5161,2701,2460,2017,92003
339,2315,1184,1131,2017,92004
340,11301,5489,5812,2017,92007
341,27537,13804,13733,2017,92008
342,44632,21675,22957,2017,92009
343,15694,7440,8254,2017,92010
344,24895,12088,12807,2017,92011
345,14048,7059,6989,2017,92014
346,43116,21645,21471,2017,92019
347,58862,29580,29282,2017,92020
348,71127,36090,35037,2017,92021
349,51309,25783,25526,2017,92024
350,53470,27172,26298,2017,92025
351,48757,23909,24848,2017,92026
352,57746,29351,28395,2017,92027
353,48015,23689,24326,2017,92028
354,18615,8993,9622,2017,92029
355,2201,1167,1034,2017,92036
356,39893,19188,20705,2017,92037
357,44243,22332,21911,2017,92040
358,43554,22215,21339,2017,92054
359,11959,11110,849,2017,92055
360,54181,26783,27398,2017,92056
361,57276,28468,28808,2017,92057
362,46569,25205,21364,2017,92058
363,1271,618,653,2017,92059
364,101,45,56,2017,92060
365,2259,1257,1002,2017,92061
366,49981,24299,25682,2017,92064
367,37826,19242,18584,2017,92065
368,580,258,322,2017,92066
369,9028,4343,4685,2017,92067
370,49638,24616,25022,2017,92069
371,919,459,460,2017,92070
372,57245,27250,29995,2017,92071
373,12754,5984,6770,2017,92075
374,49261,24231,25030,2017,92078
375,29039,14609,14430,2017,92081
376,19263,9637,9626,2017,92082
377,38107,20036,18071,2017,92083
378,51334,25409,25925,2017,92084
379,1675,837,838,2017,92086
380,1458,735,723,2017,92091
381,38023,21316,16707,2017,92101
382,44644,23094,21550,2017,92102
383,34671,17228,17443,2017,92103
384,44398,22371,22027,2017,92104
385,73379,36699,36680,2017,92105
386,19250,9998,9252,2017,92106
387,29796,15097,14699,2017,92107
388,21973,11313,10660,2017,92108
389,49024,25861,23163,2017,92109
390,28373,13818,14555,2017,92110
391,49467,25284,24183,2017,92111
392,56478,29951,26527,2017,92113
393,69635,34861,34774,2017,92114
394,65704,32839,32865,2017,92115
395,34295,17591,16704,2017,92116
396,55978,28458,27520,2017,92117
397,22623,11377,11246,2017,92118
398,23910,11387,12523,2017,92119
399,29392,14849,14543,2017,92120
400,4807,2623,2184,2017,92121
401,47331,23732,23599,2017,92122
402,31028,15874,15154,2017,92123
403,32126,15367,16759,2017,92124
404,81883,41974,39909,2017,92126
405,45980,22424,23556,2017,92127
406,50473,23822,26651,2017,92128
407,54577,26747,27830,2017,92129
408,54495,27282,27213,2017,92130
409,34414,16325,18089,2017,92131
410,0,0,0,2017,92132
411,258,188,70,2017,92134
412,944,814,130,2017,92135
413,36836,17666,19170,2017,92139
414,3348,3232,116,2017,92140
415,2159,1052,1107,2017,92145
416,562,493,69,2017,92147
417,87218,44516,42702,2017,92154
418,486,465,21,2017,92155
419,31728,15517,16211,2017,92173
420,64283,31534,32749,2017,92201
421,30945,15270,15675,2017,92203
422,5060,2571,2489,2017,92210
423,25015,11634,13381,2017,92211
424,33016,16129,16887,2017,92220
425,0,0,0,2017,92222
426,52129,25231,26898,2017,92223
427,21966,14048,7918,2017,92225
428,27358,13044,14314,2017,92227
429,3962,1719,2243,2017,92230
430,40054,18717,21337,2017,92231
431,7653,5990,1663,2017,92233
432,53717,28150,25567,2017,92234
433,44523,21874,22649,2017,92236
434,164,90,74,2017,92239
435,35434,17912,17522,2017,92240
436,7936,4045,3891,2017,92241
437,1209,604,605,2017,92242
438,49915,25060,24855,2017,92243
439,8166,3933,4233,2017,92249
440,8689,4449,4240,2017,92250
441,22813,12941,9872,2017,92251
442,9232,4711,4521,2017,92252
443,39955,19423,20532,2017,92253
444,11550,5835,5715,2017,92254
445,3250,1656,1594,2017,92256
446,1610,817,793,2017,92257
447,685,414,271,2017,92258
448,181,77,104,2017,92259
449,34091,15907,18184,2017,92260
450,28377,15861,12516,2017,92262
451,19664,11496,8168,2017,92264
452,103,74,29,2017,92266
453,5,5,0,2017,92267
454,539,299,240,2017,92268
455,17975,9041,8934,2017,92270
456,1665,722,943,2017,92273
457,17298,9380,7918,2017,92274
458,2139,1050,1089,2017,92275
459,7278,3710,3568,2017,92276
460,23978,11786,12192,2017,92277
461,4154,3774,380,2017,92278
462,17,17,0,2017,92280
463,2576,1289,1287,2017,92281
464,1498,770,728,2017,92282
465,1970,1012,958,2017,92283
466,26000,12434,13566,2017,92284
467,2597,1231,1366,2017,92285
468,33347,17080,16267,2017,92301
469,23,23,0,2017,92304
470,507,245,262,2017,92305
471,38304,18428,19876,2017,92307
472,41442,20149,21293,2017,92308
473,656,328,328,2017,92309
474,9053,5229,3824,2017,92310
475,33938,16016,17922,2017,92311
476,12478,5985,6493,2017,92313
477,11309,5744,5565,2017,92314
478,5255,2518,2737,2017,92315
479,29304,14716,14588,2017,92316
480,8457,4291,4166,2017,92320
481,1210,656,554,2017,92321
482,719,338,381,2017,92322
483,58650,28474,30176,2017,92324
484,8789,4379,4410,2017,92325
485,718,400,318,2017,92327
486,320,185,135,2017,92328
487,11,8,3,2017,92332
488,300,137,163,2017,92333
489,99791,49626,50165,2017,92335
490,94327,46791,47536,2017,92336
491,38938,19437,19501,2017,92337
492,0,0,0,2017,92338
493,1295,610,685,2017,92339
494,232,105,127,2017,92341
495,7096,3720,3376,2017,92342
496,23275,11641,11634,2017,92344
497,80910,39579,41331,2017,92345
498,60424,31233,29191,2017,92346
499,917,456,461,2017,92347
500,6237,2887,3350,2017,92352
501,21341,10229,11112,2017,92354
502,6239,3298,2941,2017,92356
503,954,519,435,2017,92358
504,8913,4100,4813,2017,92359
505,5384,2730,2654,2017,92363
506,0,0,0,2017,92364
507,2763,1516,1247,2017,92365
508,941,471,470,2017,92368
509,17799,9094,8705,2017,92371
510,6228,3139,3089,2017,92372
511,34063,15632,18431,2017,92373
512,42579,20706,21873,2017,92374
513,86937,43101,43836,2017,92376
514,19490,9450,10040,2017,92377
515,211,102,109,2017,92378
516,4822,2284,2538,2017,92382
517,17,15,2,2017,92384
518,289,150,139,2017,92385
519,2004,981,1023,2017,92386
520,153,83,70,2017,92389
521,2738,1546,1192,2017,92391
522,57678,27615,30063,2017,92392
523,35528,18664,16864,2017,92394
524,41785,20114,21671,2017,92395
525,4457,2134,2323,2017,92397
526,2058,1079,979,2017,92398
527,54027,26459,27568,2017,92399
528,2030,895,1135,2017,92401
529,60850,29592,31258,2017,92404
530,30366,14789,15577,2017,92405
531,67302,34720,32582,2017,92407
532,15466,8102,7364,2017,92408
533,46063,21898,24165,2017,92410
534,26239,11983,14256,2017,92411
535,21707,11081,10626,2017,92501
536,94523,47070,47453,2017,92503
537,57955,29104,28851,2017,92504
538,50110,25128,24982,2017,92505
539,45831,22370,23461,2017,92506
540,58017,28809,29208,2017,92507
541,39121,19463,19658,2017,92508
542,81093,40591,40502,2017,92509
543,1065,593,472,2017,92518
544,57204,28499,28705,2017,92530
545,22770,11040,11730,2017,92532
546,3013,1582,1431,2017,92536
547,4726,2386,2340,2017,92539
548,37825,17469,20356,2017,92543
549,47880,23449,24431,2017,92544
550,41738,20009,21729,2017,92545
551,8256,4401,3855,2017,92548
552,2689,1314,1375,2017,92549
553,33980,15977,18003,2017,92551
554,74918,36829,38089,2017,92553
555,43436,21091,22345,2017,92555
556,51789,25128,26661,2017,92557
557,1812,923,889,2017,92561
558,63032,29868,33164,2017,92562
559,64686,31899,32787,2017,92563
560,10003,4992,5011,2017,92567
561,60349,31122,29227,2017,92570
562,55814,28554,27260,2017,92571
563,16437,7863,8574,2017,92582
564,32682,15816,16866,2017,92583
565,51523,25663,25860,2017,92584
566,21077,10425,10652,2017,92585
567,20186,8864,11322,2017,92586
568,17095,8993,8102,2017,92587
569,4090,2041,2049,2017,92590
570,40601,19262,21339,2017,92591
571,82551,41290,41261,2017,92592
572,32647,16227,16420,2017,92595
573,28039,14722,13317,2017,92596
574,26351,12829,13522,2017,92602
575,20741,10086,10655,2017,92603
576,28656,13740,14916,2017,92604
577,23895,11717,12178,2017,92606
578,12025,5772,6253,2017,92610
579,32083,16155,15928,2017,92612
580,25271,12289,12982,2017,92614
581,17232,7125,10107,2017,92617
582,34704,18310,16394,2017,92618
583,48752,22945,25807,2017,92620
584,6314,3162,3152,2017,92624
585,12323,5650,6673,2017,92625
586,51251,25511,25740,2017,92626
587,62184,32325,29859,2017,92627
588,27063,13019,14044,2017,92629
589,62230,31088,31142,2017,92630
590,16314,5762,10552,2017,92637
591,55869,27010,28859,2017,92646
592,62141,31402,30739,2017,92647
593,47424,24187,23237,2017,92648
594,34276,17121,17155,2017,92649
595,24828,12257,12571,2017,92651
596,29554,14518,15036,2017,92653
597,8846,4344,4502,2017,92655
598,52372,24402,27970,2017,92656
599,9947,4957,4990,2017,92657
600,36406,17443,18963,2017,92660
601,3426,1787,1639,2017,92661
602,2799,1272,1527,2017,92662
603,21657,11126,10531,2017,92663
604,34671,17426,17245,2017,92672
605,30537,15381,15156,2017,92673
606,36686,17603,19083,2017,92675
607,2088,1127,961,2017,92676
608,66077,32004,34073,2017,92677
609,518,267,251,2017,92678
610,32738,16088,16650,2017,92679
611,91758,45208,46550,2017,92683
612,45062,22345,22717,2017,92688
613,50287,24811,25476,2017,92691
614,48485,23964,24521,2017,92692
615,27582,13312,14270,2017,92694
616,51732,26483,25249,2017,92701
617,71963,36950,35013,2017,92703
618,90525,45332,45193,2017,92704
619,46833,23015,23818,2017,92705
620,35276,17527,17749,2017,92706
621,62408,31616,30792,2017,92707
622,57779,28205,29574,2017,92708
623,61615,30016,31599,2017,92780
624,23956,11795,12161,2017,92782
625,67094,32493,34601,2017,92801
626,42476,21324,21152,2017,92802
627,88065,43295,44770,2017,92804
628,73140,37206,35934,2017,92805
629,40174,20454,19720,2017,92806
630,35980,17590,18390,2017,92807
631,20726,9962,10764,2017,92808
632,37840,18307,19533,2017,92821
633,4104,2136,1968,2017,92823
634,37686,18712,18974,2017,92831
635,25182,12512,12670,2017,92832
636,52950,26435,26515,2017,92833
637,23513,11437,12076,2017,92835
638,55928,29150,26778,2017,92840
639,34228,16810,17418,2017,92841
640,45198,22549,22649,2017,92843
641,24050,11504,12546,2017,92844
642,16917,8390,8527,2017,92845
643,26613,14348,12265,2017,92860
644,5893,2911,2982,2017,92861
645,20993,10256,10737,2017,92865
646,15388,7207,8181,2017,92866
647,44545,21812,22733,2017,92867
648,28148,15335,12813,2017,92868
649,36598,18058,18540,2017,92869
650,53642,26379,27263,2017,92870
651,45767,22965,22802,2017,92879
652,68915,33432,35483,2017,92880
653,34039,17065,16974,2017,92881
654,71188,35384,35804,2017,92882
655,33982,16837,17145,2017,92883
656,50543,24856,25687,2017,92886
657,20143,9973,10170,2017,92887
658,33354,16802,16552,2017,93001
659,51956,25464,26492,2017,93003
660,30494,14773,15721,2017,93004
661,44122,22052,22070,2017,93010
662,36234,16918,19316,2017,93012
663,16735,8248,8487,2017,93013
664,17713,8746,8967,2017,93015
665,37989,18386,19603,2017,93021
666,7147,3738,3409,2017,93022
667,20272,9838,10434,2017,93023
668,60191,30279,29912,2017,93030
669,83572,42285,41287,2017,93033
670,28795,14567,14228,2017,93035
671,47234,23486,23748,2017,93036
672,1832,855,977,2017,93040
673,24487,12389,12098,2017,93041
674,99,94,5,2017,93042
675,363,133,230,2017,93043
676,34226,17690,16536,2017,93060
677,56457,27709,28748,2017,93063
678,0,0,0,2017,93064
679,72763,35387,37376,2017,93065
680,3208,1719,1489,2017,93066
681,579,292,287,2017,93067
682,32101,16222,15879,2017,93101
683,20698,10796,9902,2017,93103
684,26177,12592,13585,2017,93105
685,11178,5228,5950,2017,93108
686,12066,6123,5943,2017,93109
687,16838,8638,8200,2017,93110
688,18334,8956,9378,2017,93111
689,57913,28785,29128,2017,93117
690,1315,691,624,2017,93201
691,3684,1961,1723,2017,93202
692,22471,11589,10882,2017,93203
693,13119,8770,4349,2017,93204
694,1593,813,780,2017,93205
695,2044,1093,951,2017,93206
696,269,129,140,2017,93207
697,48,2,46,2017,93208
698,18163,10859,7304,2017,93210
699,24384,16772,7612,2017,93212
700,55845,31880,23965,2017,93215
701,889,452,437,2017,93218
702,10375,5430,4945,2017,93219
703,313,248,65,2017,93220
704,15036,7395,7641,2017,93221
705,1420,733,687,2017,93222
706,10738,5160,5578,2017,93223
707,402,201,201,2017,93224
708,5319,2568,2751,2017,93225
709,195,96,99,2017,93226
710,66235,33489,32746,2017,93230
711,7028,3583,3445,2017,93234
712,3804,1952,1852,2017,93235
713,1408,775,633,2017,93238
714,1688,846,842,2017,93239
715,6960,3197,3763,2017,93240
716,16969,8732,8237,2017,93241
717,3352,1439,1913,2017,93242
718,1709,748,961,2017,93243
719,402,219,183,2017,93244
720,37907,19455,18452,2017,93245
721,18487,9959,8528,2017,93247
722,2264,1180,1084,2017,93249
723,15523,8552,6971,2017,93250
724,243,138,105,2017,93251
725,3188,2439,749,2017,93252
726,626,289,337,2017,93254
727,707,256,451,2017,93255
728,6113,3023,3090,2017,93256
729,76676,38383,38293,2017,93257
730,2254,1200,1054,2017,93258
731,193,106,87,2017,93260
732,3014,1594,1420,2017,93261
733,75,47,28,2017,93262
734,20710,10145,10565,2017,93263
735,3388,1723,1665,2017,93265
736,1440,619,821,2017,93266
737,7045,3506,3539,2017,93267
738,17620,8882,8738,2017,93268
739,5605,2868,2737,2017,93270
740,2268,1115,1153,2017,93271
741,4186,2272,1914,2017,93272
742,72918,36214,36704,2017,93274
743,159,88,71,2017,93276
744,52785,25218,27567,2017,93277
745,27552,16232,11320,2017,93280
746,2086,1099,987,2017,93283
747,1723,856,867,2017,93285
748,9916,5065,4851,2017,93286
749,74,44,30,2017,93287
750,56627,27871,28756,2017,93291
751,40512,20155,20357,2017,93292
752,12345,5947,6398,2017,93301
753,50787,25510,25277,2017,93304
754,39114,19821,19293,2017,93305
755,70208,34741,35467,2017,93306
756,84948,41271,43677,2017,93307
757,54042,27688,26354,2017,93308
758,60893,29769,31124,2017,93309
759,44862,22650,22212,2017,93311
760,59359,29282,30077,2017,93312
761,51245,25315,25930,2017,93313
762,26992,13648,13344,2017,93314
763,29108,14907,14201,2017,93401
764,15730,7878,7852,2017,93402
765,35534,20710,14824,2017,93405
766,0,0,0,2017,93410
767,29940,14372,15568,2017,93420
768,33221,16693,16528,2017,93422
769,684,292,392,2017,93424
770,1839,1068,771,2017,93426
771,5757,2590,3167,2017,93427
772,6155,2907,3248,2017,93428
773,147,67,80,2017,93429
774,3101,1556,1545,2017,93430
775,990,445,545,2017,93432
776,13524,6687,6837,2017,93433
777,7313,3683,3630,2017,93434
778,56606,30066,26540,2017,93436
779,3450,2064,1386,2017,93437
780,1601,823,778,2017,93440
781,996,485,511,2017,93441
782,11084,5491,5593,2017,93442
783,20049,10038,10011,2017,93444
784,7714,4105,3609,2017,93445
785,44911,22137,22774,2017,93446
786,8060,3705,4355,2017,93449
787,853,453,400,2017,93450
788,4189,2223,1966,2017,93451
789,728,486,242,2017,93452
790,3345,1736,1609,2017,93453
791,40333,20106,20227,2017,93454
792,44490,20919,23571,2017,93455
793,56702,28675,28027,2017,93458
794,4886,2454,2432,2017,93460
795,1545,845,700,2017,93461
796,8011,4014,3997,2017,93463
797,8905,4170,4735,2017,93465
798,5063,2782,2281,2017,93501
799,13445,7732,5713,2017,93505
800,7836,4075,3761,2017,93510
801,293,109,184,2017,93512
802,1715,866,849,2017,93513
803,14574,7297,7277,2017,93514
804,2425,1140,1285,2017,93516
805,658,417,241,2017,93517
806,995,465,530,2017,93518
807,28,28,0,2017,93519
808,34,11,23,2017,93522
809,3312,1692,1620,2017,93523
810,168,160,8,2017,93524
811,640,346,294,2017,93526
812,1852,877,975,2017,93527
813,124,53,71,2017,93528
814,383,261,122,2017,93529
815,10,6,4,2017,93530
816,422,215,207,2017,93531
817,2857,1418,1439,2017,93532
818,39166,18221,20945,2017,93534
819,73728,35644,38084,2017,93535
820,71303,38051,33252,2017,93536
821,506,225,281,2017,93541
822,14748,7101,7647,2017,93543
823,1099,572,527,2017,93544
824,1818,953,865,2017,93545
825,9346,4910,4436,2017,93546
826,250,166,84,2017,93549
827,75774,36970,38804,2017,93550
828,51896,25677,26219,2017,93551
829,41320,21553,19767,2017,93552
830,1893,874,1019,2017,93553
831,143,62,81,2017,93554
832,34075,17513,16562,2017,93555
833,221,82,139,2017,93558
834,20797,10973,9824,2017,93560
835,34271,19317,14954,2017,93561
836,1639,822,817,2017,93562
837,417,248,169,2017,93563
838,6809,3320,3489,2017,93591
839,81,32,49,2017,93592
840,1855,1091,764,2017,93601
841,4284,2184,2100,2017,93602
842,137,79,58,2017,93603
843,707,267,440,2017,93604
844,170,68,102,2017,93605
845,774,324,450,2017,93606
846,973,531,442,2017,93608
847,5668,2896,2772,2017,93609
848,23587,10570,13017,2017,93610
849,48759,23294,25465,2017,93611
850,35625,18026,17599,2017,93612
851,11134,5238,5896,2017,93614
852,6277,3350,2927,2017,93615
853,2726,1447,1279,2017,93616
854,30754,15795,14959,2017,93618
855,34587,17015,17572,2017,93619
856,9388,4785,4603,2017,93620
857,155,93,62,2017,93621
858,10298,5450,4848,2017,93622
859,108,59,49,2017,93623
860,1170,678,492,2017,93624
861,7715,4032,3683,2017,93625
862,1995,936,1059,2017,93626
863,198,89,109,2017,93627
864,220,69,151,2017,93628
865,20133,10312,9821,2017,93630
866,16206,8358,7848,2017,93631
867,0,0,0,2017,93633
868,24,17,7,2017,93634
869,40550,20127,20423,2017,93635
870,12191,5909,6282,2017,93636
871,40986,19314,21672,2017,93637
872,50453,25511,24942,2017,93638
873,12645,6684,5961,2017,93640
874,171,160,11,2017,93641
875,2915,1488,1427,2017,93643
876,8252,4153,4099,2017,93644
877,239,94,145,2017,93645
878,10959,5332,5627,2017,93646
879,11387,5953,5434,2017,93647
880,16018,8124,7894,2017,93648
881,3863,1969,1894,2017,93650
882,1743,942,801,2017,93651
883,373,197,176,2017,93652
884,1324,627,697,2017,93653
885,31093,16127,14966,2017,93654
886,7345,3764,3581,2017,93656
887,35093,17745,17348,2017,93657
888,4360,2030,2330,2017,93660
889,30454,15372,15082,2017,93662
890,486,275,211,2017,93664
891,882,454,428,2017,93665
892,1117,501,616,2017,93666
893,2877,1453,1424,2017,93667
894,1018,575,443,2017,93668
895,160,78,82,2017,93669
896,834,390,444,2017,93673
897,3248,1785,1463,2017,93675
898,10011,4922,5089,2017,93701
899,44650,22821,21829,2017,93702
900,33143,16473,16670,2017,93703
901,28491,13903,14588,2017,93704
902,38315,18417,19898,2017,93705
903,40471,20111,20360,2017,93706
904,32410,15277,17133,2017,93710
905,37173,18250,18923,2017,93711
906,46813,21729,25084,2017,93720
907,7182,5022,2160,2017,93721
908,84481,41573,42908,2017,93722
909,12246,6095,6151,2017,93723
910,27239,13199,14040,2017,93725
911,42610,20126,22484,2017,93726
912,81118,41075,40043,2017,93727
913,15945,7997,7948,2017,93728
914,11693,5667,6026,2017,93730
915,27624,13671,13953,2017,93901
916,61251,31539,29712,2017,93905
917,65464,31961,33503,2017,93906
918,22171,11234,10937,2017,93907
919,11490,5772,5718,2017,93908
920,1271,703,568,2017,93920
921,3485,1533,1952,2017,93921
922,12787,5785,7002,2017,93923
923,6013,2831,3182,2017,93924
924,1913,961,952,2017,93925
925,9505,4952,4553,2017,93926
926,18612,9425,9187,2017,93927
927,401,177,224,2017,93928
928,16914,8853,8061,2017,93930
929,782,319,463,2017,93932
930,24388,11917,12471,2017,93933
931,32554,16964,15590,2017,93940
932,0,0,0,2017,93943
933,15650,7314,8336,2017,93950
934,4490,2122,2368,2017,93953
935,346,159,187,2017,93954
936,34614,17042,17572,2017,93955
937,26788,17923,8865,2017,93960
938,562,357,205,2017,93962
939,27213,13347,13866,2017,94002
940,4642,1972,2670,2017,94005
941,42889,20447,22442,2017,94010
942,49354,24736,24618,2017,94014
943,64580,31777,32803,2017,94015
944,20521,9725,10796,2017,94019
945,1492,740,752,2017,94020
946,212,96,116,2017,94021
947,19568,9490,10078,2017,94022
948,23690,11174,12516,2017,94024
949,42016,20462,21554,2017,94025
950,7371,3699,3672,2017,94027
951,7051,3351,3700,2017,94028
952,22763,11237,11526,2017,94030
953,2909,1491,1418,2017,94037
954,3805,2026,1779,2017,94038
955,35470,18336,17134,2017,94040
956,14471,7607,6864,2017,94041
957,30667,16309,14358,2017,94043
958,39141,18614,20527,2017,94044
959,1544,861,683,2017,94060
960,39473,19688,19785,2017,94061
961,27350,13132,14218,2017,94062
962,33999,18088,15911,2017,94063
963,12794,5807,6987,2017,94065
964,43097,21522,21575,2017,94066
965,30745,14755,15990,2017,94070
966,215,111,104,2017,94074
967,67423,33545,33878,2017,94080
968,23395,12406,10989,2017,94085
969,49235,25155,24080,2017,94086
970,57178,28732,28446,2017,94087
971,22135,11851,10284,2017,94089
972,30140,17262,12878,2017,94102
973,26990,15574,11416,2017,94103
974,436,301,135,2017,94104
975,7675,4192,3483,2017,94105
976,29920,15423,14497,2017,94107
977,14856,7027,7829,2017,94108
978,56587,29831,26756,2017,94109
979,73737,40192,33545,2017,94110
980,3356,1742,1614,2017,94111
981,85373,42857,42516,2017,94112
982,34561,20191,14370,2017,94114
983,35751,17531,18220,2017,94115
984,47708,22385,25323,2017,94116
985,43610,22559,21051,2017,94117
986,41417,19006,22411,2017,94118
987,43638,21044,22594,2017,94121
988,62516,30208,32308,2017,94122
989,25461,12338,13123,2017,94123
990,35492,17310,18182,2017,94124
991,21093,10504,10589,2017,94127
992,126,61,65,2017,94128
993,4019,2018,2001,2017,94129
994,3129,1796,1333,2017,94130
995,29056,15885,13171,2017,94131
996,31155,15065,16090,2017,94132
997,26942,13567,13375,2017,94133
998,43074,21365,21709,2017,94134
999,6547,3460,3087,2017,94158
1000,17137,8529,8608,2017,94301
1001,47850,23955,23895,2017,94303
1002,3829,1862,1967,2017,94304
1003,15343,8605,6738,2017,94305
1004,27902,13789,14113,2017,94306
1005,36145,17763,18382,2017,94401
1006,25163,12640,12523,2017,94402
1007,43393,21425,21968,2017,94403
1008,36573,18102,18471,2017,94404
1009,63762,31164,32598,2017,94501
1010,14484,6830,7654,2017,94502
1011,20371,10103,10268,2017,94503
1012,15780,7570,8210,2017,94505
1013,24895,11915,12980,2017,94506
1014,15829,8261,7568,2017,94507
1015,4176,2157,2019,2017,94508
1016,66741,32380,34361,2017,94509
1017,28043,13611,14432,2017,94510
1018,2379,1324,1055,2017,94511
1019,94,31,63,2017,94512
1020,61300,30117,31183,2017,94513
1021,1593,875,718,2017,94514
1022,7785,4074,3711,2017,94515
1023,128,65,63,2017,94516
1024,13244,6279,6965,2017,94517
1025,27967,13617,14350,2017,94518
1026,19101,9476,9625,2017,94519
1027,39027,20214,18813,2017,94520
1028,43850,20952,22898,2017,94521
1029,34905,16679,18226,2017,94523
1030,3142,1364,1778,2017,94525
1031,32850,16252,16598,2017,94526
1032,552,298,254,2017,94528
1033,25289,12077,13212,2017,94530
1034,43285,21010,22275,2017,94531
1035,74833,36981,37852,2017,94533
1036,37409,18244,19165,2017,94534
1037,4130,2144,1986,2017,94535
1038,73876,36680,37196,2017,94536
1039,67133,33241,33892,2017,94538
1040,52354,25264,27090,2017,94539
1041,65690,32586,33104,2017,94541
1042,13706,6226,7480,2017,94542
1043,78717,39093,39624,2017,94544
1044,32495,16097,16398,2017,94545
1045,44285,21180,23105,2017,94546
1046,25260,12122,13138,2017,94547
1047,418,217,201,2017,94548
1048,29547,14132,15415,2017,94549
1049,50646,24556,26090,2017,94550
1050,44285,22069,22216,2017,94551
1051,14887,7581,7306,2017,94552
1052,49748,24349,25399,2017,94553
1053,37657,18707,18950,2017,94555
1054,16249,7822,8427,2017,94556
1055,68617,34265,34352,2017,94558
1056,28089,14318,13771,2017,94559
1057,45554,22965,22589,2017,94560
1058,40905,20563,20342,2017,94561
1059,19179,9310,9869,2017,94563
1060,19162,8985,10177,2017,94564
1061,93549,46095,47454,2017,94565
1062,45001,22418,22583,2017,94566
1063,642,307,335,2017,94567
1064,52599,26246,26353,2017,94568
1065,194,135,59,2017,94569
1066,9480,4603,4877,2017,94571
1067,10174,4897,5277,2017,94572
1068,20,10,10,2017,94573
1069,9100,4244,4856,2017,94574
1070,1174,445,729,2017,94575
1071,107,53,54,2017,94576
1072,47822,22870,24952,2017,94577
1073,40897,19342,21555,2017,94578
1074,22452,11722,10730,2017,94579
1075,30326,15025,15301,2017,94580
1076,41073,20803,20270,2017,94582
1077,35244,17338,17906,2017,94583
1078,29605,14511,15094,2017,94585
1079,936,536,400,2017,94586
1080,74354,37552,36802,2017,94587
1081,35707,17062,18645,2017,94588
1082,30833,14717,16116,2017,94589
1083,37036,18025,19011,2017,94590
1084,55232,27032,28200,2017,94591
1085,996,474,522,2017,94592
1086,17632,7546,10086,2017,94595
1087,20881,10059,10822,2017,94596
1088,23030,11506,11524,2017,94597
1089,27398,12997,14401,2017,94598
1090,3117,1331,1786,2017,94599
1091,50763,25970,24793,2017,94601
1092,30098,14740,15358,2017,94602
1093,33952,16819,17133,2017,94603
1094,44260,21191,23069,2017,94605
1095,38441,18736,19705,2017,94606
1096,26904,13305,13599,2017,94607
1097,30041,14552,15489,2017,94608
1098,22339,10911,11428,2017,94609
1099,31354,14963,16391,2017,94610
1100,38684,18348,20336,2017,94611
1101,16027,8649,7378,2017,94612
1102,864,35,829,2017,94613
1103,16566,7822,8744,2017,94618
1104,24536,11492,13044,2017,94619
1105,33557,16399,17158,2017,94621
1106,17534,8436,9098,2017,94702
1107,21886,11061,10825,2017,94703
1108,27961,13434,14527,2017,94704
1109,13235,6112,7123,2017,94705
1110,21050,10275,10775,2017,94706
1111,12024,5857,6167,2017,94707
1112,11533,5502,6031,2017,94708
1113,11736,5872,5864,2017,94709
1114,7341,3533,3808,2017,94710
1115,3061,1404,1657,2017,94720
1116,29974,14980,14994,2017,94801
1117,25798,12796,13002,2017,94803
1118,40640,19485,21155,2017,94804
1119,15076,7246,7830,2017,94805
1120,63660,31289,32371,2017,94806
1121,0,0,0,2017,94850
1122,42398,21411,20987,2017,94901
1123,30872,14900,15972,2017,94903
1124,12633,5834,6799,2017,94904
1125,12851,5898,6953,2017,94920
1126,555,281,274,2017,94922
1127,751,369,382,2017,94923
1128,1247,600,647,2017,94924
1129,9811,4250,5561,2017,94925
1130,43663,20291,23372,2017,94928
1131,156,65,91,2017,94929
1132,8784,3980,4804,2017,94930
1133,8462,3871,4591,2017,94931
1134,763,385,378,2017,94933
1135,766,356,410,2017,94937
1136,1033,486,547,2017,94938
1137,7079,3270,3809,2017,94939
1138,248,118,130,2017,94940
1139,31389,15435,15954,2017,94941
1140,19487,9522,9965,2017,94945
1141,812,372,440,2017,94946
1142,26020,12786,13234,2017,94947
1143,17153,8709,8444,2017,94949
1144,122,77,45,2017,94950
1145,4489,2262,2227,2017,94951
1146,35423,17323,18100,2017,94952
1147,38316,18757,19559,2017,94954
1148,1329,547,782,2017,94956
1149,1326,693,633,2017,94957
1150,15812,7317,8495,2017,94960
1151,522,240,282,2017,94963
1152,3447,3252,195,2017,94964
1153,11217,5149,6068,2017,94965
1154,717,308,409,2017,94970
1155,398,156,242,2017,94971
1156,22,11,11,2017,94972
1157,1599,867,732,2017,94973
1158,2032,1081,951,2017,95002
1159,25195,11922,13273,2017,95003
1160,3978,2127,1851,2017,95004
1161,7327,3614,3713,2017,95005
1162,9032,4727,4305,2017,95006
1163,762,361,401,2017,95007
1164,46251,22565,23686,2017,95008
1165,9288,4451,4837,2017,95010
1166,10639,5331,5308,2017,95012
1167,79,27,52,2017,95013
1168,62682,30486,32196,2017,95014
1169,612,317,295,2017,95017
1170,7078,3581,3497,2017,95018
1171,6915,3578,3337,2017,95019
1172,63251,31168,32083,2017,95020
1173,51846,25815,26031,2017,95023
1174,13075,6425,6650,2017,95030
1175,26437,13253,13184,2017,95032
1176,9805,5088,4717,2017,95033
1177,75614,37805,37809,2017,95035
1178,50210,24754,25456,2017,95037
1179,1063,526,537,2017,95039
1180,427,276,151,2017,95041
1181,663,322,341,2017,95043
1182,4274,2074,2200,2017,95045
1183,6282,3208,3074,2017,95046
1184,38479,19910,18569,2017,95050
1185,57087,29384,27703,2017,95051
1186,3532,1691,1841,2017,95053
1187,24835,12967,11868,2017,95054
1188,47369,23507,23862,2017,95060
1189,37728,18468,19260,2017,95062
1190,9993,4499,5494,2017,95064
1191,8461,4053,4408,2017,95065
1192,15429,7713,7716,2017,95066
1193,31420,15509,15911,2017,95070
1194,11491,5686,5805,2017,95073
1195,425,197,228,2017,95075
1196,87781,44672,43109,2017,95076
1197,19451,10848,8603,2017,95110
1198,64891,32418,32473,2017,95111
1199,62039,33151,28888,2017,95112
1200,1759,1000,759,2017,95113
1201,56243,28922,27321,2017,95116
1202,29338,14475,14863,2017,95117
1203,31799,15519,16280,2017,95118
1204,10754,5148,5606,2017,95119
1205,37937,18954,18983,2017,95120
1206,38909,19423,19486,2017,95121
1207,58057,29044,29013,2017,95122
1208,66858,32825,34033,2017,95123
1209,50055,25101,24954,2017,95124
1210,54802,26404,28398,2017,95125
1211,35758,18327,17431,2017,95126
1212,66686,34699,31987,2017,95127
1213,37301,19194,18107,2017,95128
1214,40231,20017,20214,2017,95129
1215,14293,7102,7191,2017,95130
1216,30540,15878,14662,2017,95131
1217,40854,20397,20457,2017,95132
1218,28905,14678,14227,2017,95133
1219,23984,12903,11081,2017,95134
1220,22415,10604,11811,2017,95135
1221,45754,22683,23071,2017,95136
1222,20146,10121,10025,2017,95138
1223,7108,3611,3497,2017,95139
1224,70,40,30,2017,95140
1225,49780,24239,25541,2017,95148
1226,6295,3125,3170,2017,95202
1227,15779,7883,7896,2017,95203
1228,28486,13632,14854,2017,95204
1229,36773,19131,17642,2017,95205
1230,64836,32981,31855,2017,95206
1231,50653,23898,26755,2017,95207
1232,43768,21431,22337,2017,95209
1233,41724,19865,21859,2017,95210
1234,1636,781,855,2017,95211
1235,27512,13221,14291,2017,95212
1236,24250,13101,11149,2017,95215
1237,29238,14189,15049,2017,95219
1238,7288,3578,3710,2017,95220
1239,5017,2349,2668,2017,95222
1240,3004,1602,1402,2017,95223
1241,184,85,99,2017,95224
1242,436,146,290,2017,95225
1243,15,15,0,2017,95226
1244,806,413,393,2017,95227
1245,4452,2269,2183,2017,95228
1246,564,256,308,2017,95230
1247,4863,3338,1525,2017,95231
1248,105,30,75,2017,95232
1249,539,207,332,2017,95233
1250,110,50,60,2017,95234
1251,4447,2251,2196,2017,95236
1252,3189,1816,1373,2017,95237
1253,48282,23880,24402,2017,95240
1254,26349,12659,13690,2017,95242
1255,2005,966,1039,2017,95245
1256,1001,522,479,2017,95246
1257,4546,2095,2451,2017,95247
1258,148,70,78,2017,95248
1259,4918,2665,2253,2017,95249
1260,0,0,0,2017,95250
1261,604,316,288,2017,95251
1262,14981,7442,7539,2017,95252
1263,1093,606,487,2017,95254
1264,1593,784,809,2017,95255
1265,441,139,302,2017,95257
1266,3993,2023,1970,2017,95258
1267,38675,19973,18702,2017,95301
1268,778,445,333,2017,95303
1269,14592,8558,6034,2017,95304
1270,52,30,22,2017,95305
1271,852,476,376,2017,95306
1272,43888,22128,21760,2017,95307
1273,1924,1098,826,2017,95310
1274,1764,835,929,2017,95311
1275,270,159,111,2017,95312
1276,1296,726,570,2017,95313
1277,0,0,0,2017,95314
1278,13707,7058,6649,2017,95315
1279,6748,3475,3273,2017,95316
1280,904,483,421,2017,95317
1281,378,210,168,2017,95318
1282,1687,945,742,2017,95319
1283,13018,6344,6674,2017,95320
1284,3118,1556,1562,2017,95321
1285,9367,4605,4762,2017,95322
1286,1141,605,536,2017,95323
1287,7551,3551,4000,2017,95324
1288,19,10,9,2017,95325
1289,9827,4482,5345,2017,95326
1290,7655,5245,2410,2017,95327
1291,4586,2183,2403,2017,95328
1292,2691,1238,1453,2017,95329
1293,20969,10651,10318,2017,95330
1294,2696,1383,1313,2017,95333
1295,16804,8364,8440,2017,95334
1296,198,131,67,2017,95335
1297,47166,23055,24111,2017,95336
1298,36700,17719,18981,2017,95337
1299,11015,5561,5454,2017,95338
1300,36543,18154,18389,2017,95340
1301,32537,16631,15906,2017,95341
1302,624,212,412,2017,95345
1303,1798,1008,790,2017,95346
1304,33888,16844,17044,2017,95348
1305,52951,25303,27648,2017,95350
1306,49836,24986,24850,2017,95351
1307,25090,12598,12492,2017,95354
1308,58279,28645,29634,2017,95355
1309,33032,16174,16858,2017,95356
1310,11701,5896,5805,2017,95357
1311,33350,17574,15776,2017,95358
1312,12645,6402,6243,2017,95360
1313,34140,16704,17436,2017,95361
1314,26726,13703,13023,2017,95363
1315,0,0,0,2017,95364
1316,4795,2598,2197,2017,95365
1317,17358,8385,8973,2017,95366
1318,24884,11870,13014,2017,95367
1319,14247,7028,7219,2017,95368
1320,1080,532,548,2017,95369
1321,27680,13131,14549,2017,95370
1322,2243,1206,1037,2017,95372
1323,1847,992,855,2017,95374
1324,5,5,0,2017,95375
1325,52371,26422,25949,2017,95376
1326,32637,16795,15842,2017,95377
1327,3616,1724,1892,2017,95379
1328,42398,20815,21583,2017,95380
1329,37490,17714,19776,2017,95382
1330,4227,2204,2023,2017,95383
1331,465,302,163,2017,95385
1332,10568,5212,5356,2017,95386
1333,564,310,254,2017,95387
1334,14114,7429,6685,2017,95388
1335,1397,846,551,2017,95389
1336,15738,7426,8312,2017,95391
1337,39229,18618,20611,2017,95401
1338,46288,23481,22807,2017,95403
1339,41536,20856,20680,2017,95404
1340,20994,9852,11142,2017,95405
1341,41797,21123,20674,2017,95407
1342,26905,12396,14509,2017,95409
1343,951,467,484,2017,95410
1344,431,221,210,2017,95412
1345,1342,784,558,2017,95415
1346,359,229,130,2017,95417
1347,752,380,372,2017,95420
1348,1739,845,894,2017,95421
1349,15360,7901,7459,2017,95422
1350,3818,2147,1671,2017,95423
1351,10571,4937,5634,2017,95425
1352,1531,864,667,2017,95426
1353,203,101,102,2017,95427
1354,2467,1347,1120,2017,95428
1355,90,51,39,2017,95429
1356,6,6,0,2017,95430
1357,238,149,89,2017,95431
1358,489,285,204,2017,95432
1359,179,59,120,2017,95435
1360,6227,3218,3009,2017,95436
1361,14489,7298,7191,2017,95437
1362,725,450,275,2017,95439
1363,1889,1119,770,2017,95441
1364,3366,1648,1718,2017,95442
1365,311,171,140,2017,95443
1366,769,304,465,2017,95444
1367,1930,914,1016,2017,95445
1368,4728,2554,2174,2017,95446
1369,17666,8774,8892,2017,95448
1370,1794,979,815,2017,95449
1371,285,169,116,2017,95450
1372,12016,5613,6403,2017,95451
1373,1276,516,760,2017,95452
1374,10717,4963,5754,2017,95453
1375,2190,1043,1147,2017,95454
1376,733,305,428,2017,95456
1377,3058,1553,1505,2017,95457
1378,3162,1665,1497,2017,95458
1379,587,295,292,2017,95459
1380,2314,1217,1097,2017,95460
1381,2497,1270,1227,2017,95461
1382,1151,654,497,2017,95462
1383,50,15,35,2017,95463
1384,2634,1340,1294,2017,95464
1385,2041,989,1052,2017,95465
1386,1087,652,435,2017,95466
1387,5735,2616,3119,2017,95467
1388,1561,753,808,2017,95468
1389,1970,890,1080,2017,95469
1390,6226,3083,3143,2017,95470
1391,630,351,279,2017,95471
1392,30723,15005,15718,2017,95472
1393,37187,18373,18814,2017,95476
1394,31993,15549,16444,2017,95482
1395,2728,1478,1250,2017,95485
1396,79,50,29,2017,95486
1397,227,106,121,2017,95488
1398,12655,6418,6237,2017,95490
1399,29590,15036,14554,2017,95492
1400,218,100,118,2017,95493
1401,196,81,115,2017,95494
1402,1137,433,704,2017,95497
1403,23624,12000,11624,2017,95501
1404,25215,12382,12833,2017,95503
1405,240,118,122,2017,95511
1406,169,98,71,2017,95514
1407,19328,9919,9409,2017,95519
1408,21311,10183,11128,2017,95521
1409,1735,868,867,2017,95524
1410,1497,826,671,2017,95525
1411,222,130,92,2017,95526
1412,565,302,263,2017,95527
1413,1254,592,662,2017,95528
1414,23092,12863,10229,2017,95531
1415,3112,1609,1503,2017,95536
1416,147,101,46,2017,95537
1417,14001,6693,7308,2017,95540
1418,1831,910,921,2017,95542
1419,989,440,549,2017,95543
1420,112,74,38,2017,95545
1421,3542,1646,1896,2017,95546
1422,1004,445,559,2017,95547
1423,1228,635,593,2017,95548
1424,880,445,435,2017,95549
1425,123,59,64,2017,95550
1426,1468,728,740,2017,95551
1427,750,389,361,2017,95552
1428,1030,512,518,2017,95553
1429,264,131,133,2017,95554
1430,340,160,180,2017,95555
1431,706,392,314,2017,95556
1432,436,225,211,2017,95558
1433,93,38,55,2017,95559
1434,1787,947,840,2017,95560
1435,3447,1645,1802,2017,95562
1436,681,254,427,2017,95563
1437,380,226,154,2017,95564
1438,946,532,414,2017,95565
1439,2133,1070,1063,2017,95567
1440,203,127,76,2017,95568
1441,308,190,118,2017,95569
1442,2253,1149,1104,2017,95570
1443,307,153,154,2017,95571
1444,1449,834,615,2017,95573
1445,575,319,256,2017,95585
1446,51,10,41,2017,95587
1447,1036,607,429,2017,95589
1448,147,94,53,2017,95595
1449,132,68,64,2017,95601
1450,18517,9121,9396,2017,95602
1451,29083,14393,14690,2017,95603
1452,106,47,59,2017,95604
1453,14677,7603,7074,2017,95605
1454,211,112,99,2017,95606
1455,415,270,145,2017,95607
1456,61365,28158,33207,2017,95608
1457,45429,22457,22972,2017,95610
1458,1062,596,466,2017,95612
1459,4360,2320,2040,2017,95614
1460,1015,518,497,2017,95615
1461,50068,22982,27086,2017,95616
1462,27721,13926,13795,2017,95618
1463,4966,2536,2430,2017,95619
1464,21588,10895,10693,2017,95620
1465,41893,19939,21954,2017,95621
1466,3734,1882,1852,2017,95623
1467,65447,32472,32975,2017,95624
1468,88,61,27,2017,95625
1469,6030,3267,2763,2017,95626
1470,3892,1897,1995,2017,95627
1471,40882,19960,20922,2017,95628
1472,898,363,535,2017,95629
1473,75864,39831,36033,2017,95630
1474,6638,3518,3120,2017,95631
1475,31523,15288,16235,2017,95632
1476,3760,1822,1938,2017,95633
1477,3027,1771,1256,2017,95634
1478,870,471,399,2017,95635
1479,954,443,511,2017,95636
1480,315,195,120,2017,95637
1481,2204,1198,1006,2017,95638
1482,309,132,177,2017,95639
1483,10609,7081,3528,2017,95640
1484,1657,813,844,2017,95641
1485,6615,2971,3644,2017,95642
1486,1810,892,918,2017,95645
1487,73,68,5,2017,95646
1488,51276,24444,26832,2017,95648
1489,13192,6426,6766,2017,95650
1490,778,441,337,2017,95651
1491,876,430,446,2017,95652
1492,727,414,313,2017,95653
1493,4091,2085,2006,2017,95655
1494,6811,3363,3448,2017,95658
1495,853,453,400,2017,95659
1496,35397,17162,18235,2017,95660
1497,31085,15235,15850,2017,95661
1498,31738,15936,15802,2017,95662
1499,2573,1072,1501,2017,95663
1500,1372,793,579,2017,95664
1501,5267,2642,2625,2017,95665
1502,4985,2547,2438,2017,95666
1503,36717,17448,19269,2017,95667
1504,839,432,407,2017,95668
1505,2373,1156,1217,2017,95669
1506,54348,26747,27601,2017,95670
1507,5225,2451,2774,2017,95672
1508,15604,7646,7958,2017,95673
1509,916,434,482,2017,95674
1510,452,249,203,2017,95675
1511,24571,12064,12507,2017,95677
1512,42096,20606,21490,2017,95678
1513,64,40,24,2017,95679
1514,116,27,89,2017,95680
1515,1304,793,511,2017,95681
1516,30304,15100,15204,2017,95682
1517,6173,2994,3179,2017,95683
1518,3260,1693,1567,2017,95684
1519,4573,2165,2408,2017,95685
1520,1021,518,503,2017,95686
1521,67504,35420,32084,2017,95687
1522,36745,18589,18156,2017,95688
1523,1288,640,648,2017,95689
1524,2346,1175,1171,2017,95690
1525,37743,18236,19507,2017,95691
1526,5256,2709,2547,2017,95692
1527,6408,2998,3410,2017,95693
1528,10310,5145,5165,2017,95694
1529,40121,19501,20620,2017,95695
1530,392,219,173,2017,95697
1531,215,121,94,2017,95698
1532,201,147,54,2017,95699
1533,769,373,396,2017,95701
1534,1033,488,545,2017,95703
1535,5001,2567,2434,2017,95709
1536,9944,5005,4939,2017,95713
1537,325,150,175,2017,95714
1538,71,39,32,2017,95715
1539,121,70,51,2017,95717
1540,42,22,20,2017,95720
1541,14,14,0,2017,95721
1542,4791,2335,2456,2017,95722
1543,18,18,0,2017,95724
1544,9152,4281,4871,2017,95726
1545,251,162,89,2017,95728
1546,2,2,0,2017,95735
1547,209,123,86,2017,95736
1548,11119,5668,5451,2017,95742
1549,23641,11838,11803,2017,95746
1550,64320,30315,34005,2017,95747
1551,48242,24190,24052,2017,95757
1552,63977,29863,34114,2017,95758
1553,41709,20962,20747,2017,95762
1554,37134,17825,19309,2017,95765
1555,23169,11677,11492,2017,95776
1556,5874,3106,2768,2017,95811
1557,11023,6580,4443,2017,95814
1558,25606,13027,12579,2017,95815
1559,17143,8520,8623,2017,95816
1560,13277,6223,7054,2017,95817
1561,20946,10103,10843,2017,95818
1562,19134,8566,10568,2017,95819
1563,36624,18211,18413,2017,95820
1564,35734,16890,18844,2017,95821
1565,45349,22002,23347,2017,95822
1566,78398,37761,40637,2017,95823
1567,30935,15649,15286,2017,95824
1568,34201,16280,17921,2017,95825
1569,37701,18225,19476,2017,95826
1570,21005,10417,10588,2017,95827
1571,60988,30355,30633,2017,95828
1572,27417,13330,14087,2017,95829
1573,963,576,387,2017,95830
1574,42218,19595,22623,2017,95831
1575,11389,5797,5592,2017,95832
1576,40569,19965,20604,2017,95833
1577,27089,13271,13818,2017,95834
1578,38607,18563,20044,2017,95835
1579,237,121,116,2017,95837
1580,38051,18688,19363,2017,95838
1581,20551,9825,10726,2017,95841
1582,31971,15284,16687,2017,95842
1583,47088,22554,24534,2017,95843
1584,23458,11363,12095,2017,95864
1585,33150,16386,16764,2017,95901
1586,1530,908,622,2017,95903
1587,130,25,105,2017,95910
1588,4830,2408,2422,2017,95912
1589,666,304,362,2017,95914
1590,0,0,0,2017,95915
1591,1136,640,496,2017,95916
1592,3599,1965,1634,2017,95917
1593,2738,1694,1044,2017,95918
1594,1209,767,442,2017,95919
1595,350,146,204,2017,95920
1596,526,300,226,2017,95922
1597,16,8,8,2017,95923
1598,203,98,105,2017,95925
1599,39032,18743,20289,2017,95926
1600,36696,18511,18185,2017,95928
1601,182,90,92,2017,95930
1602,7669,4001,3668,2017,95932
1603,381,279,102,2017,95934
1604,680,263,417,2017,95935
1605,90,56,34,2017,95936
1606,1569,769,800,2017,95937
1607,4290,1990,2300,2017,95938
1608,695,345,350,2017,95939
1609,644,245,399,2017,95941
1610,672,372,300,2017,95942
1611,834,505,329,2017,95943
1612,33,25,8,2017,95944
1613,25462,11871,13591,2017,95945
1614,9812,4727,5085,2017,95946
1615,1856,931,925,2017,95947
1616,10796,5279,5517,2017,95948
1617,19828,9629,10199,2017,95949
1618,461,189,272,2017,95950
1619,3063,1607,1456,2017,95951
1620,10553,5227,5326,2017,95953
1621,13062,6220,6842,2017,95954
1622,1354,707,647,2017,95955
1623,324,158,166,2017,95956
1624,901,467,434,2017,95957
1625,17595,9064,8531,2017,95959
1626,726,401,325,2017,95960
1627,27203,13774,13429,2017,95961
1628,1157,622,535,2017,95962
1629,14720,7540,7180,2017,95963
1630,20637,10608,10029,2017,95965
1631,29583,14808,14775,2017,95966
1632,1215,610,605,2017,95968
1633,27919,13479,14440,2017,95969
1634,572,281,291,2017,95970
1635,5913,2925,2988,2017,95971
1636,35574,17964,17610,2017,95973
1637,65,49,16,2017,95974
1638,1352,835,517,2017,95975
1639,2138,1258,880,2017,95977
1640,132,79,53,2017,95978
1641,729,329,400,2017,95979
1642,33,23,10,2017,95981
1643,3258,1740,1518,2017,95982
1644,401,157,244,2017,95983
1645,41,10,31,2017,95984
1646,78,43,35,2017,95986
1647,6050,3317,2733,2017,95987
1648,8655,4253,4402,2017,95988
1649,40959,20160,20799,2017,95991
1650,36712,18388,18324,2017,95993
1651,33986,16532,17454,2017,96001
1652,33697,16038,17659,2017,96002
1653,44406,21914,22492,2017,96003
1654,359,165,194,2017,96006
1655,23528,11795,11733,2017,96007
1656,1357,553,804,2017,96008
1657,366,186,180,2017,96009
1658,207,133,74,2017,96010
1659,150,93,57,2017,96011
1660,4733,2307,2426,2017,96013
1661,157,90,67,2017,96014
1662,647,374,273,2017,96015
1663,539,237,302,2017,96016
1664,142,87,55,2017,96017
1665,10087,5133,4954,2017,96019
1666,2457,1366,1091,2017,96020
1667,16670,8204,8466,2017,96021
1668,16256,7917,8339,2017,96022
1669,1158,582,576,2017,96023
1670,852,445,407,2017,96024
1671,2008,1031,977,2017,96025
1672,2340,1235,1105,2017,96027
1673,1363,684,679,2017,96028
1674,186,104,82,2017,96029
1675,126,63,63,2017,96031
1676,2493,1373,1120,2017,96032
1677,536,261,275,2017,96033
1678,203,97,106,2017,96034
1679,3593,1828,1765,2017,96035
1680,249,121,128,2017,96037
1681,739,368,371,2017,96038
1682,941,477,464,2017,96039
1683,240,103,137,2017,96040
1684,2869,1358,1511,2017,96041
1685,927,483,444,2017,96044
1686,63,34,29,2017,96046
1687,702,356,346,2017,96047
1688,687,301,386,2017,96048
1689,46,22,24,2017,96049
1690,389,212,177,2017,96050
1691,1238,535,703,2017,96051
1692,1440,862,578,2017,96052
1693,269,138,131,2017,96054
1694,3793,1913,1880,2017,96055
1695,1668,895,773,2017,96056
1696,1345,699,646,2017,96057
1697,625,347,278,2017,96058
1698,684,339,345,2017,96059
1699,21,10,11,2017,96061
1700,1026,485,541,2017,96062
1701,310,191,119,2017,96063
1702,4832,2528,2304,2017,96064
1703,363,190,173,2017,96065
1704,6991,3311,3680,2017,96067
1705,158,131,27,2017,96068
1706,782,422,360,2017,96069
1707,47,24,23,2017,96071
1708,4009,2001,2008,2017,96073
1709,166,110,56,2017,96074
1710,282,179,103,2017,96075
1711,193,111,82,2017,96076
1712,28075,13783,14292,2017,96080
1713,444,182,262,2017,96084
1714,105,54,51,2017,96085
1715,265,149,116,2017,96086
1716,718,409,309,2017,96087
1717,4400,2315,2085,2017,96088
1718,392,188,204,2017,96090
1719,710,375,335,2017,96091
1720,227,147,80,2017,96092
1721,4011,2023,1988,2017,96093
1722,6579,3255,3324,2017,96094
1723,745,399,346,2017,96096
1724,9726,4522,5204,2017,96097
1725,5528,2860,2668,2017,96101
1726,1445,687,758,2017,96103
1727,520,264,256,2017,96104
1728,90,34,56,2017,96105
1729,165,87,78,2017,96106
1730,1122,512,610,2017,96107
1731,17,7,10,2017,96108
1732,678,396,282,2017,96109
1733,164,83,81,2017,96110
1734,59,42,17,2017,96111
1735,295,108,187,2017,96112
1736,2078,1609,469,2017,96113
1737,3266,1612,1654,2017,96114
1738,145,78,67,2017,96115
1739,138,64,74,2017,96116
1740,332,164,168,2017,96117
1741,1767,902,865,2017,96118
1742,76,33,43,2017,96119
1743,1097,590,507,2017,96120
1744,335,216,119,2017,96121
1745,3629,1759,1870,2017,96122
1746,40,20,20,2017,96123
1747,324,137,187,2017,96124
1748,187,98,89,2017,96125
1749,80,58,22,2017,96126
1750,811,469,342,2017,96128
1751,144,70,74,2017,96129
1752,20479,14517,5962,2017,96130
1753,122,64,58,2017,96132
1754,183,124,59,2017,96133
1755,1951,1075,876,2017,96134
1756,190,91,99,2017,96135
1757,38,6,32,2017,96136
1758,3601,1794,1807,2017,96137
1759,816,442,374,2017,96140
1760,348,174,174,2017,96141
1761,578,259,319,2017,96142
1762,3250,1764,1486,2017,96143
1763,2406,1258,1148,2017,96145
1764,1030,569,461,2017,96146
1765,853,514,339,2017,96148
1766,29103,14981,14122,2017,96150
1767,0,0,0,2017,96155
1768,18369,9512,8857,2017,96161
1769,214,113,101,2017,97635
0,Estimate!!SEX AND AGE!!Total population,Estimate!!SEX AND AGE!!Total population!!Male,Estimate!!SEX AND AGE!!Total population!!Female,2016,Geographic Area Name
1,458,189,269,2016,89010
2,1762,805,957,2016,89019
3,9411,4932,4479,2016,89060
4,5485,2541,2944,2016,89061
5,1484,705,779,2016,89439
6,57942,29520,28422,2016,90001
7,51826,24877,26949,2016,90002
8,70208,33953,36255,2016,90003
9,63095,31141,31954,2016,90004
10,39338,19592,19746,2016,90005
11,61230,30807,30423,2016,90006
12,41979,20802,21177,2016,90007
13,32060,14038,18022,2016,90008
14,3524,1773,1751,2016,90010
15,104762,52020,52742,2016,90011
16,32543,19922,12621,2016,90012
17,11668,7315,4353,2016,90013
18,7191,4447,2744,2016,90014
19,19378,9720,9658,2016,90015
20,47079,22515,24564,2016,90016
21,25772,13865,11907,2016,90017
22,51639,24769,26870,2016,90018
23,68530,33741,34789,2016,90019
24,40170,19672,20498,2016,90020
25,2954,1962,992,2016,90021
26,67191,32482,34709,2016,90022
27,46611,23348,23263,2016,90023
28,49737,23337,26400,2016,90024
29,46520,23487,23033,2016,90025
30,67557,34197,33360,2016,90026
31,46043,22574,23469,2016,90027
32,31122,17415,13707,2016,90028
33,40242,20548,19694,2016,90029
34,38940,19477,19463,2016,90031
35,47285,23061,24224,2016,90032
36,49156,24168,24988,2016,90033
37,57443,29239,28204,2016,90034
38,30582,14337,16245,2016,90035
39,37931,17751,20180,2016,90036
40,61451,30331,31120,2016,90037
41,28155,14811,13344,2016,90038
42,28436,14073,14363,2016,90039
43,12812,6338,6474,2016,90040
44,28405,13644,14761,2016,90041
45,63109,30523,32586,2016,90042
46,44328,20632,23696,2016,90043
47,90155,42399,47756,2016,90044
48,41145,19800,21345,2016,90045
49,50923,27476,23447,2016,90046
50,48306,21166,27140,2016,90047
51,22722,10540,12182,2016,90048
52,35581,16076,19505,2016,90049
53,8118,3619,4499,2016,90056
54,48302,26132,22170,2016,90057
55,2674,1227,1447,2016,90058
56,46027,22652,23375,2016,90059
57,27203,12497,14706,2016,90061
58,33690,16025,17665,2016,90062
59,54142,27041,27101,2016,90063
60,27032,12942,14090,2016,90064
61,46965,23756,23209,2016,90065
62,59258,29855,29403,2016,90066
63,2355,1207,1148,2016,90067
64,21450,11701,9749,2016,90068
65,20435,12613,7822,2016,90069
66,0,0,0,2016,90071
67,915,839,76,2016,90073
68,8912,4324,4588,2016,90077
69,0,0,0,2016,90079
70,3680,1729,1951,2016,90089
71,0,0,0,2016,90090
72,8072,3691,4381,2016,90094
73,0,0,0,2016,90095
74,102786,51765,51021,2016,90201
75,20957,9904,11053,2016,90210
76,8129,3777,4352,2016,90211
77,12915,5747,7168,2016,90212
78,51271,24361,26910,2016,90220
79,53922,26571,27351,2016,90221
80,32195,15562,16633,2016,90222
81,32692,15849,16843,2016,90230
82,14810,6899,7911,2016,90232
83,26426,12725,13701,2016,90240
84,44815,21967,22848,2016,90241
85,41982,20116,21866,2016,90242
86,16901,8367,8534,2016,90245
87,47706,22695,25011,2016,90247
88,10592,5260,5332,2016,90248
89,26795,12552,14243,2016,90249
90,96987,47895,49092,2016,90250
91,19726,9987,9739,2016,90254
92,75770,37535,38235,2016,90255
93,35569,18432,17137,2016,90260
94,71197,34705,36492,2016,90262
95,1887,792,1095,2016,90263
96,18394,9151,9243,2016,90265
97,35573,17362,18211,2016,90266
98,27575,13830,13745,2016,90270
99,23151,11038,12113,2016,90272
100,25503,12366,13137,2016,90274
101,42545,20133,22412,2016,90275
102,35204,17707,17497,2016,90277
103,40582,20323,20259,2016,90278
104,95219,46943,48276,2016,90280
105,5974,2839,3135,2016,90290
106,27277,14192,13085,2016,90291
107,22482,11179,11303,2016,90292
108,12649,6341,6308,2016,90293
109,36429,17871,18558,2016,90301
110,31064,14122,16942,2016,90302
111,25134,11735,13399,2016,90303
112,27008,13583,13425,2016,90304
113,15777,7179,8598,2016,90305
114,7621,3950,3671,2016,90401
115,11410,5650,5760,2016,90402
116,24539,11984,12555,2016,90403
117,22201,10470,11731,2016,90404
118,28861,14297,14564,2016,90405
119,43405,21453,21952,2016,90501
120,17855,8913,8942,2016,90502
121,44562,21623,22939,2016,90503
122,33609,16839,16770,2016,90504
123,37242,17933,19309,2016,90505
124,0,0,0,2016,90506
125,34169,17261,16908,2016,90601
126,26778,12637,14141,2016,90602
127,20325,10155,10170,2016,90603
128,41371,19778,21593,2016,90604
129,41305,20451,20854,2016,90605
130,32499,16270,16229,2016,90606
131,46550,22602,23948,2016,90620
132,35168,17990,17178,2016,90621
133,15886,7734,8152,2016,90623
134,49093,23835,25258,2016,90630
135,68971,33446,35525,2016,90631
136,49876,24399,25477,2016,90638
137,63461,30906,32555,2016,90640
138,106360,52846,53514,2016,90650
139,63684,31152,32532,2016,90660
140,16266,7805,8461,2016,90670
141,30373,15137,15236,2016,90680
142,16842,8298,8544,2016,90701
143,50442,24428,26014,2016,90703
144,3912,1821,2091,2016,90704
145,77687,37685,40002,2016,90706
146,27914,13551,14363,2016,90710
147,31722,15550,16172,2016,90712
148,28833,14299,14534,2016,90713
149,20064,9524,10540,2016,90715
150,14383,6973,7410,2016,90716
151,21658,10325,11333,2016,90717
152,22413,10824,11589,2016,90720
153,54941,27388,27553,2016,90723
154,61046,30750,30296,2016,90731
155,21763,10326,11437,2016,90732
156,24296,11267,13029,2016,90740
157,627,375,252,2016,90742
158,368,193,175,2016,90743
159,57432,28649,28783,2016,90744
160,57785,28122,29663,2016,90745
161,26584,12980,13604,2016,90746
162,0,0,0,2016,90747
163,11491,5646,5845,2016,90755
164,39873,21152,18721,2016,90802
165,31680,15416,16264,2016,90803
166,40751,19934,20817,2016,90804
167,95808,47186,48622,2016,90805
168,42312,20573,21739,2016,90806
169,33217,16029,17188,2016,90807
170,38637,18800,19837,2016,90808
171,37422,18572,18850,2016,90810
172,60997,30170,30827,2016,90813
173,18760,9141,9619,2016,90814
174,39822,19444,20378,2016,90815
175,148,137,11,2016,90822
176,0,0,0,2016,90831
177,37699,18740,18959,2016,91001
178,32106,15061,17045,2016,91006
179,34619,15963,18656,2016,91007
180,1203,555,648,2016,91008
181,26000,12046,13954,2016,91010
182,20679,10198,10481,2016,91011
183,41901,20711,21190,2016,91016
184,8448,3928,4520,2016,91020
185,11067,5468,5599,2016,91024
186,25905,12666,13239,2016,91030
187,19587,9840,9747,2016,91040
188,27164,13132,14032,2016,91042
189,125,28,97,2016,91046
190,20761,9401,11360,2016,91101
191,28124,14129,13995,2016,91103
192,38725,18505,20220,2016,91104
193,11728,5710,6018,2016,91105
194,24875,12493,12382,2016,91106
195,32027,15858,16169,2016,91107
196,13675,6890,6785,2016,91108
197,23510,11324,12186,2016,91201
198,23219,10510,12709,2016,91202
199,14051,7091,6960,2016,91203
200,17681,8337,9344,2016,91204
201,37664,18012,19652,2016,91205
202,34247,16452,17795,2016,91206
203,10071,4825,5246,2016,91207
204,17180,8523,8657,2016,91208
205,886,533,353,2016,91210
206,30935,14485,16450,2016,91214
207,26007,12560,13447,2016,91301
208,25906,12426,13480,2016,91302
209,29668,15094,14574,2016,91303
210,52846,25733,27113,2016,91304
211,49043,25134,23909,2016,91306
212,26703,12947,13756,2016,91307
213,38479,19105,19374,2016,91311
214,29485,13877,15608,2016,91316
215,45502,23125,22377,2016,91320
216,34664,17461,17203,2016,91321
217,29689,15037,14652,2016,91324
218,33558,17232,16326,2016,91325
219,36168,17651,18517,2016,91326
220,3328,1327,2001,2016,91330
221,101536,51008,50528,2016,91331
222,80161,39322,40839,2016,91335
223,35681,17945,17736,2016,91340
224,95222,46875,48347,2016,91342
225,64323,31710,32613,2016,91343
226,53290,26648,26642,2016,91344
227,18763,9427,9336,2016,91345
228,37400,18262,19138,2016,91350
229,33247,16694,16553,2016,91351
230,47079,22707,24372,2016,91352
231,30058,14985,15073,2016,91354
232,33129,16316,16813,2016,91355
233,29728,14395,15333,2016,91356
234,43222,20853,22369,2016,91360
235,20808,10091,10717,2016,91361
236,35862,17827,18035,2016,91362
237,27607,13574,14033,2016,91364
238,42319,20716,21603,2016,91367
239,0,0,0,2016,91371
240,14885,7182,7703,2016,91377
241,20790,10079,10711,2016,91381
242,29676,17679,11997,2016,91384
243,44106,21588,22518,2016,91387
244,20546,10745,9801,2016,91390
245,41019,20412,20607,2016,91401
246,71765,35130,36635,2016,91402
247,24579,11914,12665,2016,91403
248,54356,27145,27211,2016,91405
249,55385,28096,27289,2016,91406
250,25290,12523,12767,2016,91411
251,34140,16667,17473,2016,91423
252,14353,6820,7533,2016,91436
253,20110,9679,10431,2016,91501
254,12080,5830,6250,2016,91502
255,26833,12839,13994,2016,91504
256,30985,14929,16056,2016,91505
257,18125,8832,9293,2016,91506
258,39318,20679,18639,2016,91601
259,18615,9011,9604,2016,91602
260,30386,14671,15715,2016,91604
261,55377,27374,28003,2016,91605
262,45040,22772,22268,2016,91606
263,31405,15267,16138,2016,91607
264,0,0,0,2016,91608
265,40870,20361,20509,2016,91701
266,61968,30264,31704,2016,91702
267,77667,39651,38016,2016,91706
268,2893,635,2258,2016,91708
269,77266,38024,39242,2016,91709
270,87071,50654,36417,2016,91710
271,36957,17833,19124,2016,91711
272,35407,17189,18218,2016,91722
273,19258,9321,9937,2016,91723
274,26190,12935,13255,2016,91724
275,68807,33906,34901,2016,91730
276,30179,15214,14965,2016,91731
277,62855,30766,32089,2016,91732
278,44622,22349,22273,2016,91733
279,25508,12251,13257,2016,91737
280,38681,19804,18877,2016,91739
281,26555,12974,13581,2016,91740
282,25780,13014,12766,2016,91741
283,86638,42971,43667,2016,91744
284,54043,27021,27022,2016,91745
285,31319,15346,15973,2016,91746
286,46565,23156,23409,2016,91748
287,34156,16874,17282,2016,91750
288,29801,14745,15056,2016,91752
289,33514,15804,17710,2016,91754
290,27487,13493,13994,2016,91755
291,417,220,197,2016,91759
292,59933,29116,30817,2016,91761
293,58223,28831,29392,2016,91762
294,37786,18549,19237,2016,91763
295,54303,26670,27633,2016,91764
296,47493,22859,24634,2016,91765
297,72100,35725,36375,2016,91766
298,49483,24599,24884,2016,91767
299,36365,17854,18511,2016,91768
300,63552,31348,32204,2016,91770
301,34222,15983,18239,2016,91773
302,25389,12220,13169,2016,91775
303,37843,18155,19688,2016,91776
304,35674,16726,18948,2016,91780
305,25999,12548,13451,2016,91784
306,52951,25033,27918,2016,91786
307,43973,21589,22384,2016,91789
308,46374,22966,23408,2016,91790
309,33484,16241,17243,2016,91791
310,29493,14409,15084,2016,91792
311,55265,26693,28572,2016,91801
312,29502,14701,14801,2016,91803
313,18586,9034,9552,2016,91901
314,19429,9756,9673,2016,91902
315,1539,851,688,2016,91905
316,3565,2015,1550,2016,91906
317,76027,38304,37723,2016,91910
318,84241,41581,42660,2016,91911
319,47494,23937,23557,2016,91913
320,16865,8069,8796,2016,91914
321,30679,14562,16117,2016,91915
322,1542,803,739,2016,91916
323,937,470,467,2016,91917
324,474,234,240,2016,91931
325,26801,13242,13559,2016,91932
326,274,202,72,2016,91934
327,8347,4049,4298,2016,91935
328,33077,16004,17073,2016,91941
329,39795,19212,20583,2016,91942
330,26673,13318,13355,2016,91945
331,13,0,13,2016,91948
332,62078,31109,30969,2016,91950
333,2190,1107,1083,2016,91962
334,988,536,452,2016,91963
335,62065,30711,31354,2016,91977
336,9804,4743,5061,2016,91978
337,595,350,245,2016,91980
338,4905,2529,2376,2016,92003
339,2520,1375,1145,2016,92004
340,11929,5761,6168,2016,92007
341,26968,13630,13338,2016,92008
342,44330,21590,22740,2016,92009
343,15551,7437,8114,2016,92010
344,24899,12004,12895,2016,92011
345,13665,6906,6759,2016,92014
346,43200,21893,21307,2016,92019
347,58554,29655,28899,2016,92020
348,69552,35049,34503,2016,92021
349,50246,24608,25638,2016,92024
350,53742,26834,26908,2016,92025
351,49327,24316,25011,2016,92026
352,56899,28437,28462,2016,92027
353,48468,24351,24117,2016,92028
354,18758,9287,9471,2016,92029
355,2700,1381,1319,2016,92036
356,38659,18228,20431,2016,92037
357,43191,21451,21740,2016,92040
358,42523,21653,20870,2016,92054
359,12926,12155,771,2016,92055
360,53920,26836,27084,2016,92056
361,57125,28338,28787,2016,92057
362,46463,24986,21477,2016,92058
363,1177,572,605,2016,92059
364,79,30,49,2016,92060
365,2046,1163,883,2016,92061
366,49763,24324,25439,2016,92064
367,37633,19012,18621,2016,92065
368,530,220,310,2016,92066
369,9127,4346,4781,2016,92067
370,48682,24084,24598,2016,92069
371,1034,516,518,2016,92070
372,56682,27161,29521,2016,92071
373,12548,5805,6743,2016,92075
374,48009,23037,24972,2016,92078
375,28976,14558,14418,2016,92081
376,18722,9632,9090,2016,92082
377,37367,19550,17817,2016,92083
378,50915,24988,25927,2016,92084
379,1672,812,860,2016,92086
380,1473,791,682,2016,92091
381,36857,21590,15267,2016,92101
382,44778,23352,21426,2016,92102
383,33873,17189,16684,2016,92103
384,45788,23131,22657,2016,92104
385,72724,35594,37130,2016,92105
386,18864,9719,9145,2016,92106
387,29292,14585,14707,2016,92107
388,20899,10451,10448,2016,92108
389,48430,25307,23123,2016,92109
390,28508,13851,14657,2016,92110
391,48380,24629,23751,2016,92111
392,57887,30738,27149,2016,92113
393,69688,34940,34748,2016,92114
394,64410,32081,32329,2016,92115
395,32920,16852,16068,2016,92116
396,54489,27731,26758,2016,92117
397,23473,11821,11652,2016,92118
398,23456,10964,12492,2016,92119
399,28518,14712,13806,2016,92120
400,4588,2577,2011,2016,92121
401,47314,24284,23030,2016,92122
402,30202,15421,14781,2016,92123
403,31061,14844,16217,2016,92124
404,80685,41760,38925,2016,92126
405,43588,21002,22586,2016,92127
406,49522,23213,26309,2016,92128
407,55780,27176,28604,2016,92129
408,51757,25557,26200,2016,92130
409,34425,16319,18106,2016,92131
410,0,0,0,2016,92132
411,216,194,22,2016,92134
412,851,702,149,2016,92135
413,36720,17564,19156,2016,92139
414,3112,2982,130,2016,92140
415,2096,1018,1078,2016,92145
416,569,482,87,2016,92147
417,88016,44620,43396,2016,92154
418,528,509,19,2016,92155
419,32416,15193,17223,2016,92173
420,64436,32008,32428,2016,92201
421,29768,14835,14933,2016,92203
422,4987,2538,2449,2016,92210
423,24623,11546,13077,2016,92211
424,33101,16252,16849,2016,92220
425,0,0,0,2016,92222
426,49804,23945,25859,2016,92223
427,22242,14411,7831,2016,92225
428,27120,12860,14260,2016,92227
429,4088,1912,2176,2016,92230
430,40070,18839,21231,2016,92231
431,7770,5978,1792,2016,92233
432,53253,28180,25073,2016,92234
433,44124,22056,22068,2016,92236
434,196,100,96,2016,92239
435,35684,18142,17542,2016,92240
436,9212,4512,4700,2016,92241
437,1332,629,703,2016,92242
438,49425,24934,24491,2016,92243
439,7960,3815,4145,2016,92249
440,8645,4354,4291,2016,92250
441,22496,12872,9624,2016,92251
442,8874,4579,4295,2016,92252
443,39435,19236,20199,2016,92253
444,12491,6098,6393,2016,92254
445,3105,1600,1505,2016,92256
446,1770,896,874,2016,92257
447,435,261,174,2016,92258
448,197,96,101,2016,92259
449,33834,15702,18132,2016,92260
450,27561,15387,12174,2016,92262
451,19778,11611,8167,2016,92264
452,97,68,29,2016,92266
453,0,0,0,2016,92267
454,505,283,222,2016,92268
455,17876,8882,8994,2016,92270
456,1661,697,964,2016,92273
457,19326,10250,9076,2016,92274
458,2174,1053,1121,2016,92275
459,7803,3746,4057,2016,92276
460,24028,11974,12054,2016,92277
461,4162,3761,401,2016,92278
462,16,16,0,2016,92280
463,2249,1063,1186,2016,92281
464,1233,643,590,2016,92282
465,2287,1163,1124,2016,92283
466,25850,12522,13328,2016,92284
467,2556,1253,1303,2016,92285
468,32801,16618,16183,2016,92301
469,21,21,0,2016,92304
470,519,256,263,2016,92305
471,38583,18509,20074,2016,92307
472,40285,20022,20263,2016,92308
473,742,346,396,2016,92309
474,9337,5393,3944,2016,92310
475,33962,16076,17886,2016,92311
476,12432,5783,6649,2016,92313
477,11997,6054,5943,2016,92314
478,5282,2535,2747,2016,92315
479,30231,15257,14974,2016,92316
480,8364,4164,4200,2016,92320
481,1214,651,563,2016,92321
482,696,340,356,2016,92322
483,58854,29037,29817,2016,92324
484,8019,4030,3989,2016,92325
485,544,338,206,2016,92327
486,292,146,146,2016,92328
487,3,3,0,2016,92332
488,217,107,110,2016,92333
489,99079,49187,49892,2016,92335
490,92306,45314,46992,2016,92336
491,39074,19232,19842,2016,92337
492,0,0,0,2016,92338
493,1171,555,616,2016,92339
494,231,117,114,2016,92341
495,7058,3777,3281,2016,92342
496,22259,11016,11243,2016,92344
497,81094,40062,41032,2016,92345
498,60320,30983,29337,2016,92346
499,1372,632,740,2016,92347
500,6601,2979,3622,2016,92352
501,20963,9956,11007,2016,92354
502,5995,3135,2860,2016,92356
503,1069,546,523,2016,92358
504,8710,4130,4580,2016,92359
505,5356,2696,2660,2016,92363
506,0,0,0,2016,92364
507,2601,1388,1213,2016,92365
508,937,458,479,2016,92368
509,16721,8889,7832,2016,92371
510,5763,2962,2801,2016,92372
511,35149,16136,19013,2016,92373
512,41452,20064,21388,2016,92374
513,85857,43182,42675,2016,92376
514,20370,9786,10584,2016,92377
515,154,79,75,2016,92378
516,5006,2450,2556,2016,92382
517,24,17,7,2016,92384
518,296,172,124,2016,92385
519,1992,956,1036,2016,92386
520,133,81,52,2016,92389
521,3227,1861,1366,2016,92391
522,57648,27313,30335,2016,92392
523,36017,18999,17018,2016,92394
524,41384,19919,21465,2016,92395
525,4853,2335,2518,2016,92397
526,1588,839,749,2016,92398
527,54335,26719,27616,2016,92399
528,1885,880,1005,2016,92401
529,58738,28973,29765,2016,92404
530,29897,14624,15273,2016,92405
531,64225,32704,31521,2016,92407
532,15788,8290,7498,2016,92408
533,48660,23277,25383,2016,92410
534,26437,12345,14092,2016,92411
535,21975,11103,10872,2016,92501
536,94029,46851,47178,2016,92503
537,57004,28598,28406,2016,92504
538,49705,25156,24549,2016,92505
539,46172,22219,23953,2016,92506
540,57347,28326,29021,2016,92507
541,38360,18933,19427,2016,92508
542,80480,40499,39981,2016,92509
543,1145,706,439,2016,92518
544,54710,27187,27523,2016,92530
545,22248,10596,11652,2016,92532
546,2811,1476,1335,2016,92536
547,3775,1799,1976,2016,92539
548,36962,17278,19684,2016,92543
549,47275,23247,24028,2016,92544
550,40732,19587,21145,2016,92545
551,7577,4079,3498,2016,92548
552,2644,1255,1389,2016,92549
553,33670,15967,17703,2016,92551
554,74925,36825,38100,2016,92553
555,42264,20382,21882,2016,92555
556,51551,25027,26524,2016,92557
557,1577,818,759,2016,92561
558,64222,30642,33580,2016,92562
559,60651,30161,30490,2016,92563
560,10205,5309,4896,2016,92567
561,59324,29923,29401,2016,92570
562,54512,27304,27208,2016,92571
563,16695,8131,8564,2016,92582
564,32051,15830,16221,2016,92583
565,49317,24352,24965,2016,92584
566,21714,10674,11040,2016,92585
567,19351,8291,11060,2016,92586
568,17157,8872,8285,2016,92587
569,3951,1956,1995,2016,92590
570,40396,19532,20864,2016,92591
571,80135,39943,40192,2016,92592
572,31541,15650,15891,2016,92595
573,25363,13142,12221,2016,92596
574,24962,12218,12744,2016,92602
575,20206,9845,10361,2016,92603
576,28580,14250,14330,2016,92604
577,23129,11176,11953,2016,92606
578,11895,5896,5999,2016,92610
579,31166,15842,15324,2016,92612
580,25930,12167,13763,2016,92614
581,16942,7534,9408,2016,92617
582,29921,15801,14120,2016,92618
583,46966,22682,24284,2016,92620
584,6454,3169,3285,2016,92624
585,12187,5684,6503,2016,92625
586,51133,25668,25465,2016,92626
587,61996,32110,29886,2016,92627
588,26797,12776,14021,2016,92629
589,61081,30613,30468,2016,92630
590,16330,5694,10636,2016,92637
591,55598,26454,29144,2016,92646
592,61285,30534,30751,2016,92647
593,47701,24304,23397,2016,92648
594,33513,16911,16602,2016,92649
595,24612,11965,12647,2016,92651
596,29028,14184,14844,2016,92653
597,9257,4586,4671,2016,92655
598,52335,24491,27844,2016,92656
599,9768,5023,4745,2016,92657
600,35935,17378,18557,2016,92660
601,3419,1905,1514,2016,92661
602,2863,1321,1542,2016,92662
603,22408,11224,11184,2016,92663
604,34605,17068,17537,2016,92672
605,30553,15415,15138,2016,92673
606,36548,17719,18829,2016,92675
607,2156,1169,987,2016,92676
608,65645,31867,33778,2016,92677
609,532,250,282,2016,92678
610,32819,16009,16810,2016,92679
611,91613,45665,45948,2016,92683
612,45105,22377,22728,2016,92688
613,49471,24354,25117,2016,92691
614,48851,24290,24561,2016,92692
615,25906,12687,13219,2016,92694
616,51317,26024,25293,2016,92701
617,71245,36393,34852,2016,92703
618,89993,45197,44796,2016,92704
619,47515,23025,24490,2016,92705
620,36684,18178,18506,2016,92706
621,61667,31618,30049,2016,92707
622,57675,28205,29470,2016,92708
623,62017,30374,31643,2016,92780
624,23174,11621,11553,2016,92782
625,66657,32688,33969,2016,92801
626,42583,21430,21153,2016,92802
627,86220,41946,44274,2016,92804
628,73043,37244,35799,2016,92805
629,40296,20098,20198,2016,92806
630,35284,17113,18171,2016,92807
631,20427,9907,10520,2016,92808
632,37642,18151,19491,2016,92821
633,3769,1859,1910,2016,92823
634,36533,18017,18516,2016,92831
635,25601,12580,13021,2016,92832
636,53227,26348,26879,2016,92833
637,23464,11478,11986,2016,92835
638,56256,29246,27010,2016,92840
639,34031,16979,17052,2016,92841
640,45211,22534,22677,2016,92843
641,23585,11327,12258,2016,92844
642,17276,8501,8775,2016,92845
643,26822,14652,12170,2016,92860
644,5872,2838,3034,2016,92861
645,20643,9964,10679,2016,92865
646,15760,7706,8054,2016,92866
647,44868,21897,22971,2016,92867
648,27232,14675,12557,2016,92868
649,36298,17917,18381,2016,92869
650,53690,26245,27445,2016,92870
651,46487,22991,23496,2016,92879
652,66557,32694,33863,2016,92880
653,34466,17179,17287,2016,92881
654,71024,35356,35668,2016,92882
655,32549,16174,16375,2016,92883
656,49644,24474,25170,2016,92886
657,20529,10115,10414,2016,92887
658,33765,16872,16893,2016,93001
659,51041,24724,26317,2016,93003
660,30218,14839,15379,2016,93004
661,44761,22017,22744,2016,93010
662,35714,16846,18868,2016,93012
663,16603,7965,8638,2016,93013
664,17487,8432,9055,2016,93015
665,37093,17830,19263,2016,93021
666,7154,3673,3481,2016,93022
667,20168,9827,10341,2016,93023
668,60582,30982,29600,2016,93030
669,83103,42424,40679,2016,93033
670,28258,14394,13864,2016,93035
671,46328,22800,23528,2016,93036
672,1980,935,1045,2016,93040
673,24351,12058,12293,2016,93041
674,104,100,4,2016,93042
675,163,64,99,2016,93043
676,33837,17588,16249,2016,93060
677,56637,27906,28731,2016,93063
678,0,0,0,2016,93064
679,72211,34995,37216,2016,93065
680,3082,1628,1454,2016,93066
681,690,357,333,2016,93067
682,32157,16374,15783,2016,93101
683,20827,10702,10125,2016,93103
684,25808,12231,13577,2016,93105
685,11345,5264,6081,2016,93108
686,11583,6076,5507,2016,93109
687,16777,8762,8015,2016,93110
688,18441,9381,9060,2016,93111
689,57268,28030,29238,2016,93117
690,1314,700,614,2016,93201
691,3570,1869,1701,2016,93202
692,22106,11430,10676,2016,93203
693,13590,9464,4126,2016,93204
694,1630,783,847,2016,93205
695,1978,1114,864,2016,93206
696,252,121,131,2016,93207
697,74,38,36,2016,93208
698,18617,11400,7217,2016,93210
699,24861,17338,7523,2016,93212
700,55494,31661,23833,2016,93215
701,1068,539,529,2016,93218
702,10266,5144,5122,2016,93219
703,381,224,157,2016,93220
704,15109,7417,7692,2016,93221
705,1542,732,810,2016,93222
706,10699,5053,5646,2016,93223
707,432,209,223,2016,93224
708,4886,2539,2347,2016,93225
709,211,99,112,2016,93226
710,66109,33028,33081,2016,93230
711,6865,3516,3349,2016,93234
712,4014,2202,1812,2016,93235
713,1550,832,718,2016,93238
714,1704,852,852,2016,93239
715,6489,3096,3393,2016,93240
716,17233,8780,8453,2016,93241
717,3748,1724,2024,2016,93242
718,1736,881,855,2016,93243
719,396,209,187,2016,93244
720,37502,19077,18425,2016,93245
721,18676,9798,8878,2016,93247
722,2277,1198,1079,2016,93249
723,14824,8129,6695,2016,93250
724,236,135,101,2016,93251
725,3437,2725,712,2016,93252
726,685,303,382,2016,93254
727,675,253,422,2016,93255
728,6092,2935,3157,2016,93256
729,75715,37847,37868,2016,93257
730,2650,1403,1247,2016,93258
731,199,117,82,2016,93260
732,3221,1662,1559,2016,93261
733,74,46,28,2016,93262
734,20346,10307,10039,2016,93263
735,3290,1741,1549,2016,93265
736,1271,533,738,2016,93266
737,6817,3517,3300,2016,93267
738,17643,8872,8771,2016,93268
739,5654,2843,2811,2016,93270
740,2001,1039,962,2016,93271
741,4117,2218,1899,2016,93272
742,72264,35562,36702,2016,93274
743,216,126,90,2016,93276
744,52526,25121,27405,2016,93277
745,27572,16375,11197,2016,93280
746,2339,1259,1080,2016,93283
747,1700,877,823,2016,93285
748,10169,5039,5130,2016,93286
749,115,65,50,2016,93287
750,56298,28323,27975,2016,93291
751,39089,19694,19395,2016,93292
752,11555,5624,5931,2016,93301
753,51891,26581,25310,2016,93304
754,38793,19693,19100,2016,93305
755,69660,34232,35428,2016,93306
756,84667,41574,43093,2016,93307
757,54497,27779,26718,2016,93308
758,59492,28433,31059,2016,93309
759,45512,22529,22983,2016,93311
760,58102,28964,29138,2016,93312
761,49006,24323,24683,2016,93313
762,26197,13282,12915,2016,93314
763,28684,14839,13845,2016,93401
764,15636,7859,7777,2016,93402
765,35642,21026,14616,2016,93405
766,0,0,0,2016,93410
767,30022,14276,15746,2016,93420
768,33270,16695,16575,2016,93422
769,867,475,392,2016,93424
770,1988,1238,750,2016,93426
771,5662,2605,3057,2016,93427
772,6309,3010,3299,2016,93428
773,140,60,80,2016,93429
774,3214,1579,1635,2016,93430
775,953,492,461,2016,93432
776,13484,6634,6850,2016,93433
777,7252,3610,3642,2016,93434
778,55914,29071,26843,2016,93436
779,3483,2014,1469,2016,93437
780,1507,799,708,2016,93440
781,1099,584,515,2016,93441
782,11092,5314,5778,2016,93442
783,19317,9811,9506,2016,93444
784,8164,4177,3987,2016,93445
785,44515,21837,22678,2016,93446
786,7984,3779,4205,2016,93449
787,988,525,463,2016,93450
788,4184,2202,1982,2016,93451
789,552,340,212,2016,93452
790,3170,1565,1605,2016,93453
791,38980,19774,19206,2016,93454
792,43898,20758,23140,2016,93455
793,56722,29146,27576,2016,93458
794,4798,2428,2370,2016,93460
795,1447,787,660,2016,93461
796,7905,3884,4021,2016,93463
797,8995,4140,4855,2016,93465
798,5134,2825,2309,2016,93501
799,13324,7415,5909,2016,93505
800,7594,4005,3589,2016,93510
801,352,151,201,2016,93512
802,1803,944,859,2016,93513
803,13976,7017,6959,2016,93514
804,2314,991,1323,2016,93516
805,909,616,293,2016,93517
806,949,463,486,2016,93518
807,36,36,0,2016,93519
808,35,11,24,2016,93522
809,3366,1689,1677,2016,93523
810,171,166,5,2016,93524
811,703,368,335,2016,93526
812,2206,1060,1146,2016,93527
813,127,53,74,2016,93528
814,631,490,141,2016,93529
815,29,11,18,2016,93530
816,369,191,178,2016,93531
817,2681,1342,1339,2016,93532
818,38994,18750,20244,2016,93534
819,73948,35479,38469,2016,93535
820,70969,37931,33038,2016,93536
821,500,199,301,2016,93541
822,13780,6548,7232,2016,93543
823,1021,584,437,2016,93544
824,2005,1047,958,2016,93545
825,9252,4819,4433,2016,93546
826,250,153,97,2016,93549
827,75624,37018,38606,2016,93550
828,51023,25357,25666,2016,93551
829,41128,21036,20092,2016,93552
830,1882,888,994,2016,93553
831,156,75,81,2016,93554
832,34064,17372,16692,2016,93555
833,236,88,148,2016,93558
834,20263,10560,9703,2016,93560
835,34182,19311,14871,2016,93561
836,1620,860,760,2016,93562
837,413,239,174,2016,93563
838,6508,3302,3206,2016,93591
839,41,19,22,2016,93592
840,1944,1129,815,2016,93601
841,4151,2066,2085,2016,93602
842,138,87,51,2016,93603
843,708,262,446,2016,93604
844,211,90,121,2016,93605
845,849,364,485,2016,93606
846,993,575,418,2016,93608
847,5689,2894,2795,2016,93609
848,23757,10266,13491,2016,93610
849,47988,22737,25251,2016,93611
850,36062,18296,17766,2016,93612
851,11255,5466,5789,2016,93614
852,6263,3203,3060,2016,93615
853,2599,1346,1253,2016,93616
854,30465,15784,14681,2016,93618
855,32958,16104,16854,2016,93619
856,9591,4832,4759,2016,93620
857,194,74,120,2016,93621
858,10632,5684,4948,2016,93622
859,134,64,70,2016,93623
860,1326,794,532,2016,93624
861,7446,3858,3588,2016,93625
862,1760,789,971,2016,93626
863,77,41,36,2016,93627
864,221,67,154,2016,93628
865,19095,9599,9496,2016,93630
866,16268,8246,8022,2016,93631
867,0,0,0,2016,93633
868,23,16,7,2016,93634
869,39969,19856,20113,2016,93635
870,11885,5718,6167,2016,93636
871,39952,18982,20970,2016,93637
872,50626,25650,24976,2016,93638
873,12660,6826,5834,2016,93640
874,258,198,60,2016,93641
875,2935,1529,1406,2016,93643
876,7854,3913,3941,2016,93644
877,207,75,132,2016,93645
878,11195,5473,5722,2016,93646
879,11215,5748,5467,2016,93647
880,16228,8415,7813,2016,93648
881,4170,2244,1926,2016,93650
882,1662,910,752,2016,93651
883,280,137,143,2016,93652
884,1352,659,693,2016,93653
885,31460,16276,15184,2016,93654
886,7194,3772,3422,2016,93656
887,34349,17022,17327,2016,93657
888,4587,2185,2402,2016,93660
889,30169,15186,14983,2016,93662
890,494,289,205,2016,93664
891,943,499,444,2016,93665
892,968,407,561,2016,93666
893,2626,1331,1295,2016,93667
894,957,534,423,2016,93668
895,209,115,94,2016,93669
896,747,367,380,2016,93673
897,3358,1806,1552,2016,93675
898,10369,5002,5367,2016,93701
899,46021,23484,22537,2016,93702
900,34166,17358,16808,2016,93703
901,27870,13041,14829,2016,93704
902,38093,18696,19397,2016,93705
903,40583,20160,20423,2016,93706
904,32249,15026,17223,2016,93710
905,37095,18197,18898,2016,93711
906,46402,21697,24705,2016,93720
907,6898,4629,2269,2016,93721
908,81832,40234,41598,2016,93722
909,10874,5492,5382,2016,93723
910,26809,12967,13842,2016,93725
911,42950,21033,21917,2016,93726
912,79314,40071,39243,2016,93727
913,15670,7590,8080,2016,93728
914,11397,5558,5839,2016,93730
915,27387,13476,13911,2016,93901
916,61494,31940,29554,2016,93905
917,63821,30695,33126,2016,93906
918,22513,11360,11153,2016,93907
919,11986,5836,6150,2016,93908
920,1082,643,439,2016,93920
921,3407,1536,1871,2016,93921
922,12301,5574,6727,2016,93923
923,6457,3048,3409,2016,93924
924,1824,962,862,2016,93925
925,9506,4684,4822,2016,93926
926,18609,9243,9366,2016,93927
927,441,248,193,2016,93928
928,16536,9008,7528,2016,93930
929,618,254,364,2016,93932
930,23851,11797,12054,2016,93933
931,32727,16969,15758,2016,93940
932,0,0,0,2016,93943
933,15577,7388,8189,2016,93950
934,4435,2096,2339,2016,93953
935,362,155,207,2016,93954
936,34421,16789,17632,2016,93955
937,26831,17968,8863,2016,93960
938,745,469,276,2016,93962
939,27116,13409,13707,2016,94002
940,4568,1883,2685,2016,94005
941,42569,20352,22217,2016,94010
942,48387,24104,24283,2016,94014
943,64712,32017,32695,2016,94015
944,19874,9532,10342,2016,94019
945,1170,559,611,2016,94020
946,159,72,87,2016,94021
947,19705,9435,10270,2016,94022
948,23057,11126,11931,2016,94024
949,41491,19867,21624,2016,94025
950,7317,3669,3648,2016,94027
951,6830,3308,3522,2016,94028
952,22552,10987,11565,2016,94030
953,2895,1538,1357,2016,94037
954,3628,1910,1718,2016,94038
955,35200,18648,16552,2016,94040
956,14162,7425,6737,2016,94041
957,29689,15717,13972,2016,94043
958,38844,18719,20125,2016,94044
959,1697,831,866,2016,94060
960,38709,18796,19913,2016,94061
961,27099,13425,13674,2016,94062
962,33396,17740,15656,2016,94063
963,12626,5620,7006,2016,94065
964,42777,21365,21412,2016,94066
965,30370,14687,15683,2016,94070
966,309,181,128,2016,94074
967,66876,33329,33547,2016,94080
968,23177,12265,10912,2016,94085
969,49851,25552,24299,2016,94086
970,55987,27994,27993,2016,94087
971,21403,11297,10106,2016,94089
972,29319,16780,12539,2016,94102
973,25747,15133,10614,2016,94103
974,489,320,169,2016,94104
975,6793,3750,3043,2016,94105
976,29384,15242,14142,2016,94107
977,14704,7042,7662,2016,94108
978,56019,28879,27140,2016,94109
979,73511,39447,34064,2016,94110
980,3432,1727,1705,2016,94111
981,84001,42224,41777,2016,94112
982,33504,19739,13765,2016,94114
983,34681,16685,17996,2016,94115
984,45936,21890,24046,2016,94116
985,43323,22778,20545,2016,94117
986,41662,19137,22525,2016,94118
987,42720,20697,22023,2016,94121
988,62029,29938,32091,2016,94122
989,25238,12312,12926,2016,94123
990,35446,17389,18057,2016,94124
991,20664,10439,10225,2016,94127
992,119,54,65,2016,94128
993,3762,1914,1848,2016,94129
994,3090,1737,1353,2016,94130
995,28350,15517,12833,2016,94131
996,31289,14943,16346,2016,94132
997,27491,13859,13632,2016,94133
998,41677,20390,21287,2016,94134
999,5995,3318,2677,2016,94158
1000,17409,8459,8950,2016,94301
1001,47743,23968,23775,2016,94303
1002,3658,1826,1832,2016,94304
1003,14971,8507,6464,2016,94305
1004,27259,13372,13887,2016,94306
1005,36597,18071,18526,2016,94401
1006,24517,11936,12581,2016,94402
1007,42252,20703,21549,2016,94403
1008,36086,17906,18180,2016,94404
1009,63228,31107,32121,2016,94501
1010,14181,6601,7580,2016,94502
1011,20366,10130,10236,2016,94503
1012,14820,7192,7628,2016,94505
1013,24371,11626,12745,2016,94506
1014,16205,8435,7770,2016,94507
1015,4268,2131,2137,2016,94508
1016,64412,31053,33359,2016,94509
1017,27786,13536,14250,2016,94510
1018,2199,1213,986,2016,94511
1019,96,31,65,2016,94512
1020,59444,29279,30165,2016,94513
1021,1358,738,620,2016,94514
1022,7379,4124,3255,2016,94515
1023,157,81,76,2016,94516
1024,13139,6369,6770,2016,94517
1025,27549,13115,14434,2016,94518
1026,19594,9589,10005,2016,94519
1027,39535,20497,19038,2016,94520
1028,41854,20221,21633,2016,94521
1029,34742,16579,18163,2016,94523
1030,3103,1412,1691,2016,94525
1031,32284,15709,16575,2016,94526
1032,749,373,376,2016,94528
1033,24851,12096,12755,2016,94530
1034,44263,21848,22415,2016,94531
1035,72349,35590,36759,2016,94533
1036,37794,18545,19249,2016,94534
1037,4269,2289,1980,2016,94535
1038,72597,35973,36624,2016,94536
1039,66493,32868,33625,2016,94538
1040,52141,25465,26676,2016,94539
1041,65178,31928,33250,2016,94541
1042,13491,6278,7213,2016,94542
1043,78096,38830,39266,2016,94544
1044,32015,15658,16357,2016,94545
1045,43472,20857,22615,2016,94546
1046,25037,11798,13239,2016,94547
1047,379,183,196,2016,94548
1048,29005,13772,15233,2016,94549
1049,50122,24392,25730,2016,94550
1050,42508,20937,21571,2016,94551
1051,14852,7688,7164,2016,94552
1052,49638,24712,24926,2016,94553
1053,36750,18187,18563,2016,94555
1054,16039,7763,8276,2016,94556
1055,68366,33621,34745,2016,94558
1056,28355,14658,13697,2016,94559
1057,44677,22755,21922,2016,94560
1058,40274,20178,20096,2016,94561
1059,18803,9302,9501,2016,94563
1060,19007,8869,10138,2016,94564
1061,91323,44763,46560,2016,94565
1062,43784,21357,22427,2016,94566
1063,587,278,309,2016,94567
1064,51248,25630,25618,2016,94568
1065,243,162,81,2016,94569
1066,8802,4307,4495,2016,94571
1067,9798,4568,5230,2016,94572
1068,86,54,32,2016,94573
1069,8996,4167,4829,2016,94574
1070,1175,518,657,2016,94575
1071,102,29,73,2016,94576
1072,47053,22557,24496,2016,94577
1073,40603,19161,21442,2016,94578
1074,22431,11848,10583,2016,94579
1075,29167,14124,15043,2016,94580
1076,40460,20462,19998,2016,94582
1077,35174,17313,17861,2016,94583
1078,29501,14431,15070,2016,94585
1079,978,544,434,2016,94586
1080,73500,36758,36742,2016,94587
1081,34611,16716,17895,2016,94588
1082,30593,14560,16033,2016,94589
1083,36807,18112,18695,2016,94590
1084,54493,26570,27923,2016,94591
1085,880,414,466,2016,94592
1086,17675,7392,10283,2016,94595
1087,20794,9817,10977,2016,94596
1088,21923,11050,10873,2016,94597
1089,27175,12740,14435,2016,94598
1090,3148,1278,1870,2016,94599
1091,50369,26054,24315,2016,94601
1092,29628,14464,15164,2016,94602
1093,33823,16634,17189,2016,94603
1094,43116,20505,22611,2016,94605
1095,37912,18661,19251,2016,94606
1096,26089,12916,13173,2016,94607
1097,28864,14055,14809,2016,94608
1098,22331,10968,11363,2016,94609
1099,31486,14805,16681,2016,94610
1100,37900,18242,19658,2016,94611
1101,15200,8111,7089,2016,94612
1102,855,34,821,2016,94613
1103,16620,7721,8899,2016,94618
1104,24638,11457,13181,2016,94619
1105,33423,16267,17156,2016,94621
1106,17720,8533,9187,2016,94702
1107,21234,10615,10619,2016,94703
1108,27006,12847,14159,2016,94704
1109,13215,6212,7003,2016,94705
1110,20735,9930,10805,2016,94706
1111,12173,5788,6385,2016,94707
1112,11481,5543,5938,2016,94708
1113,11854,6034,5820,2016,94709
1114,7193,3470,3723,2016,94710
1115,3166,1573,1593,2016,94720
1116,29923,15106,14817,2016,94801
1117,25283,12640,12643,2016,94803
1118,41681,19966,21715,2016,94804
1119,14850,7055,7795,2016,94805
1120,61452,30107,31345,2016,94806
1121,0,0,0,2016,94850
1122,42212,21220,20992,2016,94901
1123,31219,15291,15928,2016,94903
1124,12459,5721,6738,2016,94904
1125,12725,5989,6736,2016,94920
1126,565,241,324,2016,94922
1127,737,359,378,2016,94923
1128,1307,651,656,2016,94924
1129,9694,4296,5398,2016,94925
1130,43370,19892,23478,2016,94928
1131,135,48,87,2016,94929
1132,8763,4083,4680,2016,94930
1133,8436,3888,4548,2016,94931
1134,658,324,334,2016,94933
1135,785,349,436,2016,94937
1136,840,395,445,2016,94938
1137,7130,3303,3827,2016,94939
1138,223,116,107,2016,94940
1139,31154,15095,16059,2016,94941
1140,19095,9213,9882,2016,94945
1141,749,342,407,2016,94946
1142,26180,12507,13673,2016,94947
1143,16905,8740,8165,2016,94949
1144,100,57,43,2016,94950
1145,4464,2107,2357,2016,94951
1146,34938,16686,18252,2016,94952
1147,37943,18817,19126,2016,94954
1148,1282,551,731,2016,94956
1149,1314,666,648,2016,94957
1150,15789,7344,8445,2016,94960
1151,713,336,377,2016,94963
1152,3322,3249,73,2016,94964
1153,11227,5212,6015,2016,94965
1154,675,304,371,2016,94970
1155,378,142,236,2016,94971
1156,20,10,10,2016,94972
1157,1542,775,767,2016,94973
1158,1727,864,863,2016,95002
1159,25187,12023,13164,2016,95003
1160,3846,2059,1787,2016,95004
1161,7116,3394,3722,2016,95005
1162,8649,4391,4258,2016,95006
1163,683,345,338,2016,95007
1164,46507,22912,23595,2016,95008
1165,9375,4760,4615,2016,95010
1166,11080,5738,5342,2016,95012
1167,66,29,37,2016,95013
1168,62632,30621,32011,2016,95014
1169,627,336,291,2016,95017
1170,6935,3412,3523,2016,95018
1171,6252,3230,3022,2016,95019
1172,61480,30339,31141,2016,95020
1173,51045,25578,25467,2016,95023
1174,13477,6580,6897,2016,95030
1175,26027,12944,13083,2016,95032
1176,10006,5207,4799,2016,95033
1177,73652,36777,36875,2016,95035
1178,48532,23768,24764,2016,95037
1179,1252,548,704,2016,95039
1180,410,262,148,2016,95041
1181,734,342,392,2016,95043
1182,4475,2243,2232,2016,95045
1183,6299,3248,3051,2016,95046
1184,38482,19892,18590,2016,95050
1185,55634,28335,27299,2016,95051
1186,3222,1537,1685,2016,95053
1187,24718,12744,11974,2016,95054
1188,47227,23389,23838,2016,95060
1189,37365,18523,18842,2016,95062
1190,9692,4619,5073,2016,95064
1191,8551,4238,4313,2016,95065
1192,15642,7721,7921,2016,95066
1193,31268,15248,16020,2016,95070
1194,11407,5647,5760,2016,95073
1195,390,182,208,2016,95075
1196,85678,43371,42307,2016,95076
1197,19270,10561,8709,2016,95110
1198,64247,32153,32094,2016,95111
1199,61583,32721,28862,2016,95112
1200,1332,710,622,2016,95113
1201,55249,28055,27194,2016,95116
1202,30686,15390,15296,2016,95117
1203,31869,15723,16146,2016,95118
1204,10617,5129,5488,2016,95119
1205,37784,18956,18828,2016,95120
1206,38445,19534,18911,2016,95121
1207,58437,28990,29447,2016,95122
1208,66500,32518,33982,2016,95123
1209,49156,24458,24698,2016,95124
1210,53896,25763,28133,2016,95125
1211,35330,18089,17241,2016,95126
1212,66282,34430,31852,2016,95127
1213,36807,18991,17816,2016,95128
1214,40325,20014,20311,2016,95129
1215,14206,7193,7013,2016,95130
1216,30027,15869,14158,2016,95131
1217,40414,20283,20131,2016,95132
1218,27431,13735,13696,2016,95133
1219,21010,11232,9778,2016,95134
1220,21957,10443,11514,2016,95135
1221,44386,21942,22444,2016,95136
1222,19503,9816,9687,2016,95138
1223,7085,3609,3476,2016,95139
1224,273,164,109,2016,95140
1225,48201,23710,24491,2016,95148
1226,6559,3286,3273,2016,95202
1227,15489,8063,7426,2016,95203
1228,28124,13567,14557,2016,95204
1229,37362,19265,18097,2016,95205
1230,65151,33076,32075,2016,95206
1231,49632,23263,26369,2016,95207
1232,43362,20999,22363,2016,95209
1233,40718,19481,21237,2016,95210
1234,1665,833,832,2016,95211
1235,26094,12603,13491,2016,95212
1236,23635,12402,11233,2016,95215
1237,29506,14380,15126,2016,95219
1238,7371,3706,3665,2016,95220
1239,4976,2283,2693,2016,95222
1240,2884,1540,1344,2016,95223
1241,228,124,104,2016,95224
1242,609,255,354,2016,95225
1243,14,14,0,2016,95226
1244,805,398,407,2016,95227
1245,4498,2321,2177,2016,95228
1246,869,295,574,2016,95230
1247,4806,3246,1560,2016,95231
1248,168,67,101,2016,95232
1249,583,204,379,2016,95233
1250,112,50,62,2016,95234
1251,4196,2052,2144,2016,95236
1252,3124,1773,1351,2016,95237
1253,48065,23761,24304,2016,95240
1254,25752,12513,13239,2016,95242
1255,1958,884,1074,2016,95245
1256,1071,491,580,2016,95246
1257,4709,2110,2599,2016,95247
1258,127,70,57,2016,95248
1259,4377,2426,1951,2016,95249
1260,0,0,0,2016,95250
1261,538,271,267,2016,95251
1262,15068,7622,7446,2016,95252
1263,897,522,375,2016,95254
1264,1655,785,870,2016,95255
1265,454,182,272,2016,95257
1266,3882,2024,1858,2016,95258
1267,38356,19864,18492,2016,95301
1268,678,392,286,2016,95303
1269,15718,9151,6567,2016,95304
1270,28,16,12,2016,95305
1271,823,457,366,2016,95306
1272,42844,21715,21129,2016,95307
1273,2163,1120,1043,2016,95310
1274,1831,873,958,2016,95311
1275,290,168,122,2016,95312
1276,1077,566,511,2016,95313
1277,0,0,0,2016,95314
1278,13108,6624,6484,2016,95315
1279,6416,3190,3226,2016,95316
1280,946,540,406,2016,95317
1281,403,237,166,2016,95318
1282,1593,931,662,2016,95319
1283,12759,6291,6468,2016,95320
1284,3263,1681,1582,2016,95321
1285,9025,4715,4310,2016,95322
1286,1083,571,512,2016,95323
1287,7610,3706,3904,2016,95324
1288,26,17,9,2016,95325
1289,9948,4578,5370,2016,95326
1290,7901,5255,2646,2016,95327
1291,6013,2912,3101,2016,95328
1292,2650,1285,1365,2016,95329
1293,20253,10120,10133,2016,95330
1294,2793,1443,1350,2016,95333
1295,16366,8069,8297,2016,95334
1296,171,108,63,2016,95335
1297,47808,23294,24514,2016,95336
1298,34391,16744,17647,2016,95337
1299,10784,5424,5360,2016,95338
1300,36541,18043,18498,2016,95340
1301,32787,17020,15767,2016,95341
1302,580,238,342,2016,95345
1303,1888,1036,852,2016,95346
1304,33555,16547,17008,2016,95348
1305,51441,24342,27099,2016,95350
1306,49243,24436,24807,2016,95351
1307,25485,12795,12690,2016,95354
1308,58872,28689,30183,2016,95355
1309,32827,16380,16447,2016,95356
1310,11717,5982,5735,2016,95357
1311,32758,17333,15425,2016,95358
1312,12243,6342,5901,2016,95360
1313,33741,16519,17222,2016,95361
1314,26291,13773,12518,2016,95363
1315,0,0,0,2016,95364
1316,4855,2528,2327,2016,95365
1317,17118,8147,8971,2016,95366
1318,24657,11958,12699,2016,95367
1319,13826,6774,7052,2016,95368
1320,1011,485,526,2016,95369
1321,28124,13796,14328,2016,95370
1322,2068,1107,961,2016,95372
1323,1702,896,806,2016,95374
1324,116,40,76,2016,95375
1325,51245,26319,24926,2016,95376
1326,32462,16400,16062,2016,95377
1327,3296,1539,1757,2016,95379
1328,41865,20271,21594,2016,95380
1329,37138,17516,19622,2016,95382
1330,3471,1713,1758,2016,95383
1331,396,251,145,2016,95385
1332,10324,4977,5347,2016,95386
1333,520,240,280,2016,95387
1334,13885,7083,6802,2016,95388
1335,1651,926,725,2016,95389
1336,14254,6801,7453,2016,95391
1337,39400,18505,20895,2016,95401
1338,46294,23578,22716,2016,95403
1339,40699,20476,20223,2016,95404
1340,21351,10000,11351,2016,95405
1341,41249,21436,19813,2016,95407
1342,26805,12271,14534,2016,95409
1343,890,420,470,2016,95410
1344,452,233,219,2016,95412
1345,1312,736,576,2016,95415
1346,237,100,137,2016,95417
1347,684,416,268,2016,95420
1348,1599,780,819,2016,95421
1349,15358,7824,7534,2016,95422
1350,3645,2029,1616,2016,95423
1351,10675,5048,5627,2016,95425
1352,1726,946,780,2016,95426
1353,203,108,95,2016,95427
1354,2540,1438,1102,2016,95428
1355,58,33,25,2016,95429
1356,0,0,0,2016,95430
1357,430,316,114,2016,95431
1358,445,269,176,2016,95432
1359,166,69,97,2016,95435
1360,5965,3126,2839,2016,95436
1361,14578,7380,7198,2016,95437
1362,825,483,342,2016,95439
1363,1909,1083,826,2016,95441
1364,3080,1450,1630,2016,95442
1365,312,174,138,2016,95443
1366,653,293,360,2016,95444
1367,1792,942,850,2016,95445
1368,4529,2413,2116,2016,95446
1369,17481,8652,8829,2016,95448
1370,1679,985,694,2016,95449
1371,283,157,126,2016,95450
1372,12230,5790,6440,2016,95451
1373,1409,714,695,2016,95452
1374,10362,4872,5490,2016,95453
1375,2029,943,1086,2016,95454
1376,721,306,415,2016,95456
1377,3076,1565,1511,2016,95457
1378,3176,1462,1714,2016,95458
1379,682,340,342,2016,95459
1380,2301,1155,1146,2016,95460
1381,2954,1497,1457,2016,95461
1382,1164,604,560,2016,95462
1383,49,14,35,2016,95463
1384,2412,1268,1144,2016,95464
1385,2140,1047,1093,2016,95465
1386,990,585,405,2016,95466
1387,5618,2822,2796,2016,95467
1388,1381,681,700,2016,95468
1389,1979,934,1045,2016,95469
1390,6514,3394,3120,2016,95470
1391,599,317,282,2016,95471
1392,30260,14795,15465,2016,95472
1393,37534,18653,18881,2016,95476
1394,31941,15227,16714,2016,95482
1395,2607,1506,1101,2016,95485
1396,41,27,14,2016,95486
1397,239,108,131,2016,95488
1398,13054,6537,6517,2016,95490
1399,29515,15047,14468,2016,95492
1400,321,131,190,2016,95493
1401,209,71,138,2016,95494
1402,1092,447,645,2016,95497
1403,23284,11817,11467,2016,95501
1404,25830,12688,13142,2016,95503
1405,331,225,106,2016,95511
1406,254,118,136,2016,95514
1407,19441,9801,9640,2016,95519
1408,20911,9994,10917,2016,95521
1409,1944,1085,859,2016,95524
1410,1569,870,699,2016,95525
1411,197,117,80,2016,95526
1412,586,315,271,2016,95527
1413,1191,551,640,2016,95528
1414,23500,13132,10368,2016,95531
1415,3140,1599,1541,2016,95536
1416,255,145,110,2016,95537
1417,13418,6463,6955,2016,95540
1418,2008,1048,960,2016,95542
1419,792,333,459,2016,95543
1420,76,51,25,2016,95545
1421,3260,1514,1746,2016,95546
1422,1158,547,611,2016,95547
1423,1288,717,571,2016,95548
1424,942,467,475,2016,95549
1425,164,98,66,2016,95550
1426,1453,708,745,2016,95551
1427,635,315,320,2016,95552
1428,1274,623,651,2016,95553
1429,336,167,169,2016,95554
1430,338,163,175,2016,95555
1431,643,381,262,2016,95556
1432,458,253,205,2016,95558
1433,108,33,75,2016,95559
1434,1351,689,662,2016,95560
1435,3437,1697,1740,2016,95562
1436,705,288,417,2016,95563
1437,402,229,173,2016,95564
1438,934,485,449,2016,95565
1439,2048,986,1062,2016,95567
1440,161,91,70,2016,95568
1441,340,221,119,2016,95569
1442,2079,1094,985,2016,95570
1443,228,116,112,2016,95571
1444,1523,846,677,2016,95573
1445,537,319,218,2016,95585
1446,146,61,85,2016,95587
1447,966,575,391,2016,95589
1448,156,97,59,2016,95595
1449,178,94,84,2016,95601
1450,18472,9154,9318,2016,95602
1451,28826,14354,14472,2016,95603
1452,104,46,58,2016,95604
1453,14595,7577,7018,2016,95605
1454,129,72,57,2016,95606
1455,499,293,206,2016,95607
1456,60199,28301,31898,2016,95608
1457,44711,21833,22878,2016,95610
1458,964,528,436,2016,95612
1459,4318,2266,2052,2016,95614
1460,970,541,429,2016,95615
1461,49093,23241,25852,2016,95616
1462,27926,13792,14134,2016,95618
1463,5075,2647,2428,2016,95619
1464,21685,10696,10989,2016,95620
1465,41908,19838,22070,2016,95621
1466,3911,1897,2014,2016,95623
1467,64429,32006,32423,2016,95624
1468,54,26,28,2016,95625
1469,5871,3044,2827,2016,95626
1470,3873,1932,1941,2016,95627
1471,41649,20340,21309,2016,95628
1472,676,305,371,2016,95629
1473,74905,40112,34793,2016,95630
1474,6375,3356,3019,2016,95631
1475,30594,14453,16141,2016,95632
1476,3610,1814,1796,2016,95633
1477,3206,1825,1381,2016,95634
1478,861,459,402,2016,95635
1479,846,395,451,2016,95636
1480,349,217,132,2016,95637
1481,2238,1172,1066,2016,95638
1482,333,142,191,2016,95639
1483,10509,7220,3289,2016,95640
1484,1843,908,935,2016,95641
1485,6912,3137,3775,2016,95642
1486,2091,1091,1000,2016,95645
1487,64,57,7,2016,95646
1488,50341,24359,25982,2016,95648
1489,13157,6548,6609,2016,95650
1490,614,319,295,2016,95651
1491,966,460,506,2016,95652
1492,657,363,294,2016,95653
1493,4205,2078,2127,2016,95655
1494,6709,3394,3315,2016,95658
1495,788,417,371,2016,95659
1496,34303,17016,17287,2016,95660
1497,31034,14940,16094,2016,95661
1498,32441,15862,16579,2016,95662
1499,2443,1004,1439,2016,95663
1500,1357,806,551,2016,95664
1501,4901,2408,2493,2016,95665
1502,5170,2551,2619,2016,95666
1503,36859,17559,19300,2016,95667
1504,794,412,382,2016,95668
1505,2493,1202,1291,2016,95669
1506,54277,26666,27611,2016,95670
1507,5010,2239,2771,2016,95672
1508,15140,7515,7625,2016,95673
1509,891,424,467,2016,95674
1510,574,257,317,2016,95675
1511,23906,11581,12325,2016,95677
1512,41953,20243,21710,2016,95678
1513,20,10,10,2016,95679
1514,278,147,131,2016,95680
1515,1471,910,561,2016,95681
1516,30033,15141,14892,2016,95682
1517,6233,3137,3096,2016,95683
1518,3004,1589,1415,2016,95684
1519,4356,2018,2338,2016,95685
1520,1079,558,521,2016,95686
1521,66476,35010,31466,2016,95687
1522,36763,18738,18025,2016,95688
1523,1131,572,559,2016,95689
1524,2289,1099,1190,2016,95690
1525,36932,17731,19201,2016,95691
1526,5129,2590,2539,2016,95692
1527,6153,2839,3314,2016,95693
1528,9828,4920,4908,2016,95694
1529,39144,18858,20286,2016,95695
1530,430,227,203,2016,95697
1531,232,110,122,2016,95698
1532,143,102,41,2016,95699
1533,782,359,423,2016,95701
1534,829,399,430,2016,95703
1535,5096,2630,2466,2016,95709
1536,10296,5168,5128,2016,95713
1537,368,175,193,2016,95714
1538,89,51,38,2016,95715
1539,166,96,70,2016,95717
1540,49,27,22,2016,95720
1541,13,13,0,2016,95721
1542,4636,2197,2439,2016,95722
1543,0,0,0,2016,95724
1544,8816,4096,4720,2016,95726
1545,366,238,128,2016,95728
1546,27,15,12,2016,95735
1547,165,104,61,2016,95736
1548,10494,5453,5041,2016,95742
1549,23638,12090,11548,2016,95746
1550,61869,28935,32934,2016,95747
1551,46703,23433,23270,2016,95757
1552,63778,30313,33465,2016,95758
1553,40493,20228,20265,2016,95762
1554,36980,17760,19220,2016,95765
1555,23260,11604,11656,2016,95776
1556,6711,3424,3287,2016,95811
1557,10487,6247,4240,2016,95814
1558,25206,12767,12439,2016,95815
1559,17178,8851,8327,2016,95816
1560,13918,6789,7129,2016,95817
1561,20629,9898,10731,2016,95818
1562,18846,8561,10285,2016,95819
1563,35869,17400,18469,2016,95820
1564,35530,16785,18745,2016,95821
1565,44724,21213,23511,2016,95822
1566,76478,36711,39767,2016,95823
1567,30225,15347,14878,2016,95824
1568,33385,15253,18132,2016,95825
1569,36992,17885,19107,2016,95826
1570,20382,9896,10486,2016,95827
1571,60884,30235,30649,2016,95828
1572,26588,12889,13699,2016,95829
1573,953,558,395,2016,95830
1574,41859,19624,22235,2016,95831
1575,11313,5514,5799,2016,95832
1576,40029,19411,20618,2016,95833
1577,26560,13069,13491,2016,95834
1578,38847,19080,19767,2016,95835
1579,340,178,162,2016,95837
1580,37286,18338,18948,2016,95838
1581,19890,9413,10477,2016,95841
1582,32184,15387,16797,2016,95842
1583,47666,23224,24442,2016,95843
1584,23527,11470,12057,2016,95864
1585,32804,16227,16577,2016,95901
1586,1622,959,663,2016,95903
1587,134,28,106,2016,95910
1588,4693,2337,2356,2016,95912
1589,649,319,330,2016,95914
1590,9,9,0,2016,95915
1591,1102,617,485,2016,95916
1592,3313,1669,1644,2016,95917
1593,2468,1479,989,2016,95918
1594,1184,753,431,2016,95919
1595,320,115,205,2016,95920
1596,539,291,248,2016,95922
1597,9,4,5,2016,95923
1598,143,85,58,2016,95925
1599,38465,19046,19419,2016,95926
1600,36374,17918,18456,2016,95928
1601,155,65,90,2016,95930
1602,7651,3916,3735,2016,95932
1603,367,283,84,2016,95934
1604,654,287,367,2016,95935
1605,234,141,93,2016,95936
1606,1400,692,708,2016,95937
1607,4229,1986,2243,2016,95938
1608,578,307,271,2016,95939
1609,586,230,356,2016,95941
1610,782,421,361,2016,95942
1611,886,487,399,2016,95943
1612,41,31,10,2016,95944
1613,25712,11976,13736,2016,95945
1614,9694,4723,4971,2016,95946
1615,1770,887,883,2016,95947
1616,10751,5235,5516,2016,95948
1617,19575,9293,10282,2016,95949
1618,519,218,301,2016,95950
1619,3073,1561,1512,2016,95951
1620,10476,5108,5368,2016,95953
1621,12509,5959,6550,2016,95954
1622,1325,663,662,2016,95955
1623,419,228,191,2016,95956
1624,837,447,390,2016,95957
1625,17534,9053,8481,2016,95959
1626,752,384,368,2016,95960
1627,27141,13645,13496,2016,95961
1628,1235,662,573,2016,95962
1629,14943,7576,7367,2016,95963
1630,20473,10440,10033,2016,95965
1631,30557,15288,15269,2016,95966
1632,1250,583,667,2016,95968
1633,27850,13651,14199,2016,95969
1634,500,274,226,2016,95970
1635,5952,3067,2885,2016,95971
1636,35297,17723,17574,2016,95973
1637,65,50,15,2016,95974
1638,1811,1115,696,2016,95975
1639,1730,1035,695,2016,95977
1640,115,76,39,2016,95978
1641,750,378,372,2016,95979
1642,96,45,51,2016,95981
1643,3487,1831,1656,2016,95982
1644,500,219,281,2016,95983
1645,39,9,30,2016,95984
1646,79,44,35,2016,95986
1647,6142,3387,2755,2016,95987
1648,8663,4385,4278,2016,95988
1649,40683,20284,20399,2016,95991
1650,36617,18066,18551,2016,95993
1651,34260,16939,17321,2016,96001
1652,32943,15871,17072,2016,96002
1653,44929,21760,23169,2016,96003
1654,389,180,209,2016,96006
1655,23354,11873,11481,2016,96007
1656,1483,707,776,2016,96008
1657,288,146,142,2016,96009
1658,194,135,59,2016,96010
1659,116,69,47,2016,96011
1660,4538,2090,2448,2016,96013
1661,146,90,56,2016,96014
1662,587,321,266,2016,96015
1663,497,196,301,2016,96016
1664,160,99,61,2016,96017
1665,10121,5038,5083,2016,96019
1666,2438,1313,1125,2016,96020
1667,16322,8096,8226,2016,96021
1668,16904,8218,8686,2016,96022
1669,1096,568,528,2016,96023
1670,962,479,483,2016,96024
1671,2121,1157,964,2016,96025
1672,2390,1228,1162,2016,96027
1673,1403,732,671,2016,96028
1674,200,117,83,2016,96029
1675,175,85,90,2016,96031
1676,2518,1401,1117,2016,96032
1677,561,297,264,2016,96033
1678,220,104,116,2016,96034
1679,3398,1768,1630,2016,96035
1680,216,100,116,2016,96037
1681,602,319,283,2016,96038
1682,1044,532,512,2016,96039
1683,275,123,152,2016,96040
1684,3061,1611,1450,2016,96041
1685,937,491,446,2016,96044
1686,134,80,54,2016,96046
1687,799,419,380,2016,96047
1688,701,306,395,2016,96048
1689,28,14,14,2016,96049
1690,387,211,176,2016,96050
1691,1264,551,713,2016,96051
1692,1417,809,608,2016,96052
1693,260,153,107,2016,96054
1694,4002,1950,2052,2016,96055
1695,1693,827,866,2016,96056
1696,1305,692,613,2016,96057
1697,779,472,307,2016,96058
1698,604,327,277,2016,96059
1699,27,12,15,2016,96061
1700,1180,556,624,2016,96062
1701,188,98,90,2016,96063
1702,4881,2570,2311,2016,96064
1703,360,196,164,2016,96065
1704,6828,3192,3636,2016,96067
1705,131,99,32,2016,96068
1706,792,437,355,2016,96069
1707,180,61,119,2016,96071
1708,4174,2046,2128,2016,96073
1709,196,140,56,2016,96074
1710,304,208,96,2016,96075
1711,139,93,46,2016,96076
1712,27564,13507,14057,2016,96080
1713,416,197,219,2016,96084
1714,91,44,47,2016,96085
1715,304,170,134,2016,96086
1716,600,347,253,2016,96087
1717,4410,2297,2113,2016,96088
1718,467,215,252,2016,96090
1719,561,298,263,2016,96091
1720,300,175,125,2016,96092
1721,4031,1997,2034,2016,96093
1722,6446,3087,3359,2016,96094
1723,733,395,338,2016,96096
1724,9744,4537,5207,2016,96097
1725,5378,2786,2592,2016,96101
1726,1369,627,742,2016,96103
1727,576,308,268,2016,96104
1728,70,15,55,2016,96105
1729,223,103,120,2016,96106
1730,1129,507,622,2016,96107
1731,7,4,3,2016,96108
1732,741,442,299,2016,96109
1733,167,90,77,2016,96110
1734,30,23,7,2016,96111
1735,332,124,208,2016,96112
1736,2100,1731,369,2016,96113
1737,3387,1734,1653,2016,96114
1738,179,98,81,2016,96115
1739,127,64,63,2016,96116
1740,300,152,148,2016,96117
1741,1629,799,830,2016,96118
1742,100,41,59,2016,96119
1743,1079,626,453,2016,96120
1744,302,176,126,2016,96121
1745,3532,1648,1884,2016,96122
1746,46,23,23,2016,96123
1747,385,177,208,2016,96124
1748,227,115,112,2016,96125
1749,39,20,19,2016,96126
1750,840,497,343,2016,96128
1751,132,61,71,2016,96129
1752,20812,14626,6186,2016,96130
1753,119,62,57,2016,96132
1754,202,132,70,2016,96133
1755,2203,1065,1138,2016,96134
1756,172,78,94,2016,96135
1757,47,11,36,2016,96136
1758,3707,1934,1773,2016,96137
1759,805,400,405,2016,96140
1760,464,246,218,2016,96141
1761,766,344,422,2016,96142
1762,3737,2186,1551,2016,96143
1763,2399,1188,1211,2016,96145
1764,968,553,415,2016,96146
1765,776,431,345,2016,96148
1766,29001,15024,13977,2016,96150
1767,0,0,0,2016,96155
1768,18255,9580,8675,2016,96161
1769,196,100,96,2016,97635
0,Estimate!!SEX AND AGE!!Total population,Estimate!!SEX AND AGE!!Total population!!Male,Estimate!!SEX AND AGE!!Total population!!Female,2015,Geographic Area Name
1,549,220,329,2015,89010
2,1804,868,936,2015,89019
3,9587,4824,4763,2015,89060
4,5337,2583,2754,2015,89061
5,1609,787,822,2015,89439
6,57227,28570,28657,2015,90001
7,50626,24522,26104,2015,90002
8,69502,33509,35993,2015,90003
9,64008,32208,31800,2015,90004
10,38979,19545,19434,2015,90005
11,61625,31224,30401,2015,90006
12,43426,21668,21758,2015,90007
13,31837,14197,17640,2015,90008
14,3740,1753,1987,2015,90010
15,104058,51724,52334,2015,90011
16,30860,18900,11960,2015,90012
17,11299,6981,4318,2015,90013
18,7006,4397,2609,2015,90014
19,18767,9687,9080,2015,90015
20,47590,22542,25048,2015,90016
21,24336,13236,11100,2015,90017
22,49824,23705,26119,2015,90018
23,67553,33335,34218,2015,90019
24,39866,19686,20180,2015,90020
25,2970,1995,975,2015,90021
26,68136,33080,35056,2015,90022
27,46288,23370,22918,2015,90023
28,50693,23817,26876,2015,90024
29,46107,23518,22589,2015,90025
30,68520,34274,34246,2015,90026
31,46646,23152,23494,2015,90027
32,30380,16643,13737,2015,90028
33,40472,20604,19868,2015,90029
34,39422,19778,19644,2015,90031
35,47099,23149,23950,2015,90032
36,48277,23707,24570,2015,90033
37,58069,29346,28723,2015,90034
38,30852,14732,16120,2015,90035
39,37640,18131,19509,2015,90036
40,62872,30895,31977,2015,90037
41,28577,14910,13667,2015,90038
42,28149,14157,13992,2015,90039
43,12699,6167,6532,2015,90040
44,28796,13797,14999,2015,90041
45,62650,30340,32310,2015,90042
46,43129,19643,23486,2015,90043
47,88975,42199,46776,2015,90044
48,41922,20039,21883,2015,90045
49,51651,27648,24003,2015,90046
50,48678,21803,26875,2015,90047
51,22498,10203,12295,2015,90048
52,35427,15897,19530,2015,90049
53,8537,3763,4774,2015,90056
54,46509,25010,21499,2015,90057
55,2680,1350,1330,2015,90058
56,44648,21719,22929,2015,90059
57,28135,12968,15167,2015,90061
58,33353,15859,17494,2015,90062
59,53813,26696,27117,2015,90063
60,26384,12487,13897,2015,90064
61,46904,24012,22892,2015,90065
62,59124,29864,29260,2015,90066
63,2330,1061,1269,2015,90067
64,21233,11821,9412,2015,90068
65,20132,12241,7891,2015,90069
66,0,0,0,2015,90071
67,862,748,114,2015,90073
68,8844,4269,4575,2015,90077
69,0,0,0,2015,90079
70,3334,1492,1842,2015,90089
71,0,0,0,2015,90090
72,6858,3105,3753,2015,90094
73,0,0,0,2015,90095
74,102946,51444,51502,2015,90201
75,22052,10112,11940,2015,90210
76,7530,3468,4062,2015,90211
77,12577,5619,6958,2015,90212
78,50715,24395,26320,2015,90220
79,54236,26606,27630,2015,90221
80,31875,15132,16743,2015,90222
81,31978,15500,16478,2015,90230
82,15708,7679,8029,2015,90232
83,26655,12887,13768,2015,90240
84,43592,21578,22014,2015,90241
85,43160,20987,22173,2015,90242
86,16929,8527,8402,2015,90245
87,48032,22990,25042,2015,90247
88,10166,5112,5054,2015,90248
89,26627,12703,13924,2015,90249
90,95939,46992,48947,2015,90250
91,19747,10164,9583,2015,90254
92,76180,38265,37915,2015,90255
93,35866,18491,17375,2015,90260
94,71163,34498,36665,2015,90262
95,1832,764,1068,2015,90263
96,18258,9037,9221,2015,90265
97,35603,17529,18074,2015,90266
98,27700,14007,13693,2015,90270
99,23934,11647,12287,2015,90272
100,25778,12671,13107,2015,90274
101,42593,20313,22280,2015,90275
102,35178,17363,17815,2015,90277
103,40485,19817,20668,2015,90278
104,95350,47028,48322,2015,90280
105,6478,3109,3369,2015,90290
106,27167,14124,13043,2015,90291
107,21679,10400,11279,2015,90292
108,12458,6425,6033,2015,90293
109,36360,17664,18696,2015,90301
110,30482,13901,16581,2015,90302
111,26408,12503,13905,2015,90303
112,26854,13426,13428,2015,90304
113,15665,7013,8652,2015,90305
114,7297,3939,3358,2015,90401
115,11661,5661,6000,2015,90402
116,24416,11548,12868,2015,90403
117,22081,10543,11538,2015,90404
118,28915,13908,15007,2015,90405
119,43145,21049,22096,2015,90501
120,17585,8713,8872,2015,90502
121,45986,22376,23610,2015,90503
122,33279,16937,16342,2015,90504
123,36904,17575,19329,2015,90505
124,0,0,0,2015,90506
125,34203,17305,16898,2015,90601
126,27421,13236,14185,2015,90602
127,20221,9797,10424,2015,90603
128,40977,19742,21235,2015,90604
129,41643,20323,21320,2015,90605
130,32697,16308,16389,2015,90606
131,46639,22758,23881,2015,90620
132,35245,17713,17532,2015,90621
133,15839,7757,8082,2015,90623
134,49145,23784,25361,2015,90630
135,69151,33328,35823,2015,90631
136,49819,24300,25519,2015,90638
137,63521,30980,32541,2015,90640
138,106659,53410,53249,2015,90650
139,63815,31088,32727,2015,90660
140,15998,7460,8538,2015,90670
141,30795,15310,15485,2015,90680
142,16785,8574,8211,2015,90701
143,50276,24020,26256,2015,90703
144,3906,1787,2119,2015,90704
145,77756,37596,40160,2015,90706
146,27457,13166,14291,2015,90710
147,32451,15624,16827,2015,90712
148,28699,14372,14327,2015,90713
149,19753,9520,10233,2015,90715
150,14382,6938,7444,2015,90716
151,21816,10364,11452,2015,90717
152,22029,10646,11383,2015,90720
153,55023,27088,27935,2015,90723
154,62028,31759,30269,2015,90731
155,21417,9782,11635,2015,90732
156,24330,11148,13182,2015,90740
157,689,393,296,2015,90742
158,358,190,168,2015,90743
159,57963,28625,29338,2015,90744
160,58186,28046,30140,2015,90745
161,26523,12958,13565,2015,90746
162,0,0,0,2015,90747
163,11440,5692,5748,2015,90755
164,39155,20598,18557,2015,90802
165,31709,15357,16352,2015,90803
166,41007,20268,20739,2015,90804
167,95127,46624,48503,2015,90805
168,42498,21155,21343,2015,90806
169,33763,16382,17381,2015,90807
170,39428,19092,20336,2015,90808
171,36936,18162,18774,2015,90810
172,60078,29790,30288,2015,90813
173,19264,9746,9518,2015,90814
174,40462,19532,20930,2015,90815
175,152,132,20,2015,90822
176,0,0,0,2015,90831
177,37163,18324,18839,2015,91001
178,31728,14715,17013,2015,91006
179,34598,15721,18877,2015,91007
180,1132,491,641,2015,91008
181,25840,12071,13769,2015,91010
182,20721,10140,10581,2015,91011
183,42090,21006,21084,2015,91016
184,8438,4075,4363,2015,91020
185,11084,5435,5649,2015,91024
186,25967,12648,13319,2015,91030
187,19969,10205,9764,2015,91040
188,27298,13359,13939,2015,91042
189,175,39,136,2015,91046
190,20936,9593,11343,2015,91101
191,27819,13918,13901,2015,91103
192,38976,18927,20049,2015,91104
193,11413,5621,5792,2015,91105
194,25243,12716,12527,2015,91106
195,31722,15937,15785,2015,91107
196,13654,6758,6896,2015,91108
197,23092,10996,12096,2015,91201
198,23148,10723,12425,2015,91202
199,13680,6769,6911,2015,91203
200,17053,8174,8879,2015,91204
201,38322,18453,19869,2015,91205
202,34038,16275,17763,2015,91206
203,10359,5076,5283,2015,91207
204,17164,8198,8966,2015,91208
205,727,451,276,2015,91210
206,30965,14577,16388,2015,91214
207,26293,12976,13317,2015,91301
208,25431,12287,13144,2015,91302
209,29471,15040,14431,2015,91303
210,53853,26085,27768,2015,91304
211,49532,25842,23690,2015,91306
212,26219,13041,13178,2015,91307
213,38505,19128,19377,2015,91311
214,28837,13582,15255,2015,91316
215,44952,22514,22438,2015,91320
216,34178,17065,17113,2015,91321
217,28497,14268,14229,2015,91324
218,33197,17218,15979,2015,91325
219,36921,18049,18872,2015,91326
220,3231,1314,1917,2015,91330
221,102266,51771,50495,2015,91331
222,78230,37954,40276,2015,91335
223,35481,17916,17565,2015,91340
224,93466,46292,47174,2015,91342
225,64149,32560,31589,2015,91343
226,54566,27111,27455,2015,91344
227,18276,8705,9571,2015,91345
228,36520,17904,18616,2015,91350
229,33071,16453,16618,2015,91351
230,47543,22815,24728,2015,91352
231,29340,14726,14614,2015,91354
232,34188,16922,17266,2015,91355
233,29467,14245,15222,2015,91356
234,43948,20691,23257,2015,91360
235,20831,10323,10508,2015,91361
236,35546,17619,17927,2015,91362
237,27100,13387,13713,2015,91364
238,42578,20868,21710,2015,91367
239,0,0,0,2015,91371
240,15087,7240,7847,2015,91377
241,20405,9988,10417,2015,91381
242,29788,17919,11869,2015,91384
243,43502,21363,22139,2015,91387
244,20473,10501,9972,2015,91390
245,41217,20544,20673,2015,91401
246,71894,35511,36383,2015,91402
247,24613,12004,12609,2015,91403
248,53347,26612,26735,2015,91405
249,54364,27317,27047,2015,91406
250,25370,12659,12711,2015,91411
251,33347,16374,16973,2015,91423
252,13970,6730,7240,2015,91436
253,20855,9833,11022,2015,91501
254,12011,5483,6528,2015,91502
255,25469,12115,13354,2015,91504
256,31273,14803,16470,2015,91505
257,18272,8931,9341,2015,91506
258,38754,20274,18480,2015,91601
259,18304,8750,9554,2015,91602
260,30269,14530,15739,2015,91604
261,55665,27629,28036,2015,91605
262,44773,22697,22076,2015,91606
263,30231,14735,15496,2015,91607
264,0,0,0,2015,91608
265,40546,20626,19920,2015,91701
266,61170,29618,31552,2015,91702
267,77877,39091,38786,2015,91706
268,3445,1043,2402,2015,91708
269,76796,38452,38344,2015,91709
270,84812,47855,36957,2015,91710
271,36651,17583,19068,2015,91711
272,35798,17195,18603,2015,91722
273,19428,9593,9835,2015,91723
274,26479,13084,13395,2015,91724
275,67613,33854,33759,2015,91730
276,30418,15344,15074,2015,91731
277,62872,30917,31955,2015,91732
278,44313,22132,22181,2015,91733
279,25619,12375,13244,2015,91737
280,38490,19743,18747,2015,91739
281,26745,13103,13642,2015,91740
282,25693,12762,12931,2015,91741
283,87337,43213,44124,2015,91744
284,55184,26959,28225,2015,91745
285,30034,14868,15166,2015,91746
286,46732,23626,23106,2015,91748
287,34052,17000,17052,2015,91750
288,29525,14901,14624,2015,91752
289,34009,16287,17722,2015,91754
290,27076,13172,13904,2015,91755
291,389,188,201,2015,91759
292,60103,28616,31487,2015,91761
293,57402,28130,29272,2015,91762
294,37784,18570,19214,2015,91763
295,53820,26533,27287,2015,91764
296,47598,23023,24575,2015,91765
297,72026,35514,36512,2015,91766
298,49099,24043,25056,2015,91767
299,36444,18206,18238,2015,91768
300,63758,31304,32454,2015,91770
301,34107,15889,18218,2015,91773
302,25486,12330,13156,2015,91775
303,38127,18342,19785,2015,91776
304,35280,16783,18497,2015,91780
305,26140,12455,13685,2015,91784
306,52365,24382,27983,2015,91786
307,43805,21535,22270,2015,91789
308,46566,22566,24000,2015,91790
309,33247,16009,17238,2015,91791
310,30063,14635,15428,2015,91792
311,54565,26458,28107,2015,91801
312,30118,14934,15184,2015,91803
313,18507,8979,9528,2015,91901
314,18813,9452,9361,2015,91902
315,1139,644,495,2015,91905
316,3466,1966,1500,2015,91906
317,77302,38757,38545,2015,91910
318,84122,41252,42870,2015,91911
319,45430,22766,22664,2015,91913
320,17406,8057,9349,2015,91914
321,28209,13323,14886,2015,91915
322,1611,818,793,2015,91916
323,932,450,482,2015,91917
324,486,248,238,2015,91931
325,26555,12920,13635,2015,91932
326,267,197,70,2015,91934
327,8335,4107,4228,2015,91935
328,33111,16086,17025,2015,91941
329,39804,18918,20886,2015,91942
330,26486,13231,13255,2015,91945
331,44,14,30,2015,91948
332,61774,31072,30702,2015,91950
333,1998,1022,976,2015,91962
334,1256,688,568,2015,91963
335,62072,31423,30649,2015,91977
336,9793,4627,5166,2015,91978
337,709,400,309,2015,91980
338,4267,2171,2096,2015,92003
339,2709,1546,1163,2015,92004
340,12131,5937,6194,2015,92007
341,26896,13804,13092,2015,92008
342,43837,21517,22320,2015,92009
343,15598,7679,7919,2015,92010
344,24476,11939,12537,2015,92011
345,13708,7068,6640,2015,92014
346,43873,22122,21751,2015,92019
347,58940,29915,29025,2015,92020
348,67608,33879,33729,2015,92021
349,49566,24434,25132,2015,92024
350,51859,26095,25764,2015,92025
351,50412,24958,25454,2015,92026
352,56875,28440,28435,2015,92027
353,47807,23733,24074,2015,92028
354,18717,9240,9477,2015,92029
355,3173,1517,1656,2015,92036
356,37718,17739,19979,2015,92037
357,43269,21365,21904,2015,92040
358,42195,22138,20057,2015,92054
359,13091,12002,1089,2015,92055
360,54069,27177,26892,2015,92056
361,56764,28653,28111,2015,92057
362,44825,23961,20864,2015,92058
363,1310,668,642,2015,92059
364,68,30,38,2015,92060
365,1642,916,726,2015,92061
366,49587,24378,25209,2015,92064
367,36637,18134,18503,2015,92065
368,516,213,303,2015,92066
369,9147,4332,4815,2015,92067
370,49135,23983,25152,2015,92069
371,1151,575,576,2015,92070
372,56158,27167,28991,2015,92071
373,12491,5955,6536,2015,92075
374,45984,21878,24106,2015,92078
375,29038,14363,14675,2015,92081
376,19541,9838,9703,2015,92082
377,36431,18808,17623,2015,92083
378,50377,24644,25733,2015,92084
379,1538,774,764,2015,92086
380,1428,697,731,2015,92091
381,36295,21256,15039,2015,92101
382,45461,23302,22159,2015,92102
383,33241,17326,15915,2015,92103
384,44756,22500,22256,2015,92104
385,71832,35183,36649,2015,92105
386,18415,9425,8990,2015,92106
387,28360,14158,14202,2015,92107
388,20548,10417,10131,2015,92108
389,46797,24864,21933,2015,92109
390,28789,14430,14359,2015,92110
391,49375,24919,24456,2015,92111
392,57737,30142,27595,2015,92113
393,69798,34794,35004,2015,92114
394,62308,31146,31162,2015,92115
395,33110,16951,16159,2015,92116
396,53477,27565,25912,2015,92117
397,22939,11872,11067,2015,92118
398,24265,11317,12948,2015,92119
399,27135,13983,13152,2015,92120
400,4503,2486,2017,2015,92121
401,46104,22844,23260,2015,92122
402,29955,15112,14843,2015,92123
403,30135,14625,15510,2015,92124
404,79589,40782,38807,2015,92126
405,43033,20390,22643,2015,92127
406,48906,22527,26379,2015,92128
407,54735,27117,27618,2015,92129
408,51262,25368,25894,2015,92130
409,34039,16103,17936,2015,92131
410,0,0,0,2015,92132
411,199,177,22,2015,92134
412,953,790,163,2015,92135
413,36934,17709,19225,2015,92139
414,2977,2856,121,2015,92140
415,2145,1023,1122,2015,92145
416,567,446,121,2015,92147
417,88292,44748,43544,2015,92154
418,555,538,17,2015,92155
419,32355,15186,17169,2015,92173
420,64238,31979,32259,2015,92201
421,29131,14494,14637,2015,92203
422,4946,2599,2347,2015,92210
423,24558,11824,12734,2015,92211
424,32461,15489,16972,2015,92220
425,0,0,0,2015,92222
426,47970,23406,24564,2015,92223
427,22763,15004,7759,2015,92225
428,27013,12813,14200,2015,92227
429,3669,1640,2029,2015,92230
430,40027,18719,21308,2015,92231
431,7869,6086,1783,2015,92233
432,53005,27705,25300,2015,92234
433,43654,22088,21566,2015,92236
434,207,105,102,2015,92239
435,36206,18466,17740,2015,92240
436,10209,5096,5113,2015,92241
437,1247,590,657,2015,92242
438,49514,24791,24723,2015,92243
439,7686,3701,3985,2015,92249
440,8557,4403,4154,2015,92250
441,22827,13306,9521,2015,92251
442,8833,4538,4295,2015,92252
443,38958,18962,19996,2015,92253
444,13626,6704,6922,2015,92254
445,3266,1686,1580,2015,92256
446,1666,808,858,2015,92257
447,473,261,212,2015,92258
448,326,170,156,2015,92259
449,33275,15300,17975,2015,92260
450,27102,15105,11997,2015,92262
451,19836,11525,8311,2015,92264
452,100,74,26,2015,92266
453,0,0,0,2015,92267
454,470,259,211,2015,92268
455,17770,8915,8855,2015,92270
456,1356,600,756,2015,92273
457,19918,10473,9445,2015,92274
458,1738,874,864,2015,92275
459,8180,3632,4548,2015,92276
460,24363,11620,12743,2015,92277
461,4079,3747,332,2015,92278
462,14,14,0,2015,92280
463,1985,929,1056,2015,92281
464,910,393,517,2015,92282
465,2406,1217,1189,2015,92283
466,25680,12636,13044,2015,92284
467,2579,1361,1218,2015,92285
468,32639,16586,16053,2015,92301
469,23,23,0,2015,92304
470,391,210,181,2015,92305
471,38379,18601,19778,2015,92307
472,40180,19237,20943,2015,92308
473,835,418,417,2015,92309
474,9238,5501,3737,2015,92310
475,33676,16628,17048,2015,92311
476,12371,5972,6399,2015,92313
477,11469,5575,5894,2015,92314
478,5269,2412,2857,2015,92315
479,31789,16119,15670,2015,92316
480,8211,4052,4159,2015,92320
481,1157,650,507,2015,92321
482,888,415,473,2015,92322
483,58684,28875,29809,2015,92324
484,8211,4192,4019,2015,92325
485,886,432,454,2015,92327
486,288,137,151,2015,92328
487,8,8,0,2015,92332
488,462,243,219,2015,92333
489,98442,49007,49435,2015,92335
490,92781,45882,46899,2015,92336
491,38547,18970,19577,2015,92337
492,0,0,0,2015,92338
493,1028,525,503,2015,92339
494,287,129,158,2015,92341
495,6593,3474,3119,2015,92342
496,21386,10709,10677,2015,92344
497,80709,40015,40694,2015,92345
498,59501,30631,28870,2015,92346
499,1672,735,937,2015,92347
500,6800,3053,3747,2015,92352
501,20829,9764,11065,2015,92354
502,6211,3228,2983,2015,92356
503,1111,562,549,2015,92358
504,8718,4045,4673,2015,92359
505,5355,2471,2884,2015,92363
506,32,24,8,2015,92364
507,2024,1080,944,2015,92365
508,970,474,496,2015,92368
509,15846,8704,7142,2015,92371
510,5987,3073,2914,2015,92372
511,34766,16650,18116,2015,92373
512,41276,20262,21014,2015,92374
513,86021,42768,43253,2015,92376
514,20016,9603,10413,2015,92377
515,192,98,94,2015,92378
516,5247,2610,2637,2015,92382
517,33,19,14,2015,92384
518,202,107,95,2015,92385
519,2105,957,1148,2015,92386
520,128,69,59,2015,92389
521,3123,1687,1436,2015,92391
522,56178,26876,29302,2015,92392
523,36141,19317,16824,2015,92394
524,42007,19803,22204,2015,92395
525,4753,2302,2451,2015,92397
526,1515,738,777,2015,92398
527,54227,27012,27215,2015,92399
528,2015,882,1133,2015,92401
529,59577,29379,30198,2015,92404
530,28831,14203,14628,2015,92405
531,62439,31784,30655,2015,92407
532,15661,8047,7614,2015,92408
533,48011,23028,24983,2015,92410
534,27282,12709,14573,2015,92411
535,22114,11308,10806,2015,92501
536,94431,46975,47456,2015,92503
537,53772,26776,26996,2015,92504
538,49319,24764,24555,2015,92505
539,46048,22115,23933,2015,92506
540,56231,28179,28052,2015,92507
541,38443,18912,19531,2015,92508
542,78446,39454,38992,2015,92509
543,1004,601,403,2015,92518
544,53606,27178,26428,2015,92530
545,22213,10623,11590,2015,92532
546,2842,1532,1310,2015,92536
547,4220,1881,2339,2015,92539
548,36603,16937,19666,2015,92543
549,47507,23527,23980,2015,92544
550,40386,19003,21383,2015,92545
551,6939,3635,3304,2015,92548
552,2702,1403,1299,2015,92549
553,33573,16163,17410,2015,92551
554,74320,36853,37467,2015,92553
555,41438,19727,21711,2015,92555
556,51810,25124,26686,2015,92557
557,1475,720,755,2015,92561
558,62912,30155,32757,2015,92562
559,59463,29014,30449,2015,92563
560,10442,5348,5094,2015,92567
561,56738,28786,27952,2015,92570
562,54366,27375,26991,2015,92571
563,16446,8057,8389,2015,92582
564,31818,15439,16379,2015,92583
565,47887,23199,24688,2015,92584
566,20623,10297,10326,2015,92585
567,19150,8549,10601,2015,92586
568,17514,8800,8714,2015,92587
569,4207,2076,2131,2015,92590
570,39753,19216,20537,2015,92591
571,77420,38481,38939,2015,92592
572,31426,16138,15288,2015,92595
573,26219,13542,12677,2015,92596
574,24234,11649,12585,2015,92602
575,20083,9646,10437,2015,92603
576,29039,14450,14589,2015,92604
577,23378,11277,12101,2015,92606
578,11862,5923,5939,2015,92610
579,30314,15443,14871,2015,92612
580,26046,12047,13999,2015,92614
581,16565,7664,8901,2015,92617
582,25043,13345,11698,2015,92618
583,44763,21756,23007,2015,92620
584,6830,3666,3164,2015,92624
585,12098,5641,6457,2015,92625
586,51818,26296,25522,2015,92626
587,61314,31408,29906,2015,92627
588,26680,12592,14088,2015,92629
589,60449,29867,30582,2015,92630
590,16342,5951,10391,2015,92637
591,55584,26366,29218,2015,92646
592,60898,30063,30835,2015,92647
593,47415,23794,23621,2015,92648
594,33166,16956,16210,2015,92649
595,24291,11943,12348,2015,92651
596,29037,14089,14948,2015,92653
597,9485,4671,4814,2015,92655
598,51826,24635,27191,2015,92656
599,10238,5317,4921,2015,92657
600,35677,17775,17902,2015,92660
601,3128,1622,1506,2015,92661
602,2894,1269,1625,2015,92662
603,22629,11692,10937,2015,92663
604,35344,17657,17687,2015,92672
605,29803,15136,14667,2015,92673
606,35970,17527,18443,2015,92675
607,1993,1106,887,2015,92676
608,65238,31489,33749,2015,92677
609,495,254,241,2015,92678
610,32885,16007,16878,2015,92679
611,91734,45376,46358,2015,92683
612,45226,22714,22512,2015,92688
613,48944,24152,24792,2015,92691
614,48785,24265,24520,2015,92692
615,25464,12393,13071,2015,92694
616,51520,25743,25777,2015,92701
617,70116,35664,34452,2015,92703
618,89304,45029,44275,2015,92704
619,46713,22697,24016,2015,92705
620,37180,18538,18642,2015,92706
621,63082,31991,31091,2015,92707
622,57508,28412,29096,2015,92708
623,61209,29920,31289,2015,92780
624,23182,11522,11660,2015,92782
625,65595,32346,33249,2015,92801
626,43250,21996,21254,2015,92802
627,84504,41273,43231,2015,92804
628,72637,37706,34931,2015,92805
629,40989,20478,20511,2015,92806
630,35285,17347,17938,2015,92807
631,20449,9725,10724,2015,92808
632,37615,18410,19205,2015,92821
633,3400,1693,1707,2015,92823
634,36249,17424,18825,2015,92831
635,25166,12450,12716,2015,92832
636,53271,26260,27011,2015,92833
637,23567,11328,12239,2015,92835
638,56917,29136,27781,2015,92840
639,33717,16861,16856,2015,92841
640,43928,22005,21923,2015,92843
641,24804,11888,12916,2015,92844
642,17221,8399,8822,2015,92845
643,27091,14884,12207,2015,92860
644,5901,2983,2918,2015,92861
645,20554,10210,10344,2015,92865
646,15490,7523,7967,2015,92866
647,44991,21817,23174,2015,92867
648,26817,14593,12224,2015,92868
649,37124,18160,18964,2015,92869
650,53772,26620,27152,2015,92870
651,47452,23363,24089,2015,92879
652,63696,31423,32273,2015,92880
653,33490,16762,16728,2015,92881
654,70676,35097,35579,2015,92882
655,32167,15709,16458,2015,92883
656,49565,24501,25064,2015,92886
657,20292,10080,10212,2015,92887
658,33899,16737,17162,2015,93001
659,50701,24719,25982,2015,93003
660,30268,14810,15458,2015,93004
661,44422,21869,22553,2015,93010
662,35272,16841,18431,2015,93012
663,16259,7805,8454,2015,93013
664,17253,8608,8645,2015,93015
665,36873,17776,19097,2015,93021
666,7122,3695,3427,2015,93022
667,20313,9993,10320,2015,93023
668,61102,31390,29712,2015,93030
669,83057,41987,41070,2015,93033
670,27626,14091,13535,2015,93035
671,44716,21914,22802,2015,93036
672,2044,1046,998,2015,93040
673,24197,12165,12032,2015,93041
674,110,105,5,2015,93042
675,305,112,193,2015,93043
676,34060,17608,16452,2015,93060
677,56500,27903,28597,2015,93063
678,0,0,0,2015,93064
679,72676,35553,37123,2015,93065
680,3222,1693,1529,2015,93066
681,735,323,412,2015,93067
682,32458,16247,16211,2015,93101
683,20448,10673,9775,2015,93103
684,25632,11892,13740,2015,93105
685,11761,5522,6239,2015,93108
686,11089,5586,5503,2015,93109
687,17382,8997,8385,2015,93110
688,18440,9231,9209,2015,93111
689,56386,28171,28215,2015,93117
690,1317,681,636,2015,93201
691,3744,1873,1871,2015,93202
692,22079,11480,10599,2015,93203
693,14154,10142,4012,2015,93204
694,2066,884,1182,2015,93205
695,2211,1249,962,2015,93206
696,284,141,143,2015,93207
697,130,65,65,2015,93208
698,19101,12127,6974,2015,93210
699,24920,17559,7361,2015,93212
700,56046,31928,24118,2015,93215
701,1037,505,532,2015,93218
702,10667,5269,5398,2015,93219
703,381,212,169,2015,93220
704,15000,7408,7592,2015,93221
705,1604,766,838,2015,93222
706,10704,5118,5586,2015,93223
707,412,207,205,2015,93224
708,5391,2730,2661,2015,93225
709,317,158,159,2015,93226
710,66108,32798,33310,2015,93230
711,6863,3306,3557,2015,93234
712,3837,2052,1785,2015,93235
713,1664,842,822,2015,93238
714,1840,928,912,2015,93239
715,5797,2873,2924,2015,93240
716,17765,8925,8840,2015,93241
717,3372,1658,1714,2015,93242
718,1565,687,878,2015,93243
719,376,202,174,2015,93244
720,37520,19157,18363,2015,93245
721,18916,9765,9151,2015,93247
722,2373,1258,1115,2015,93249
723,14056,7710,6346,2015,93250
724,229,138,91,2015,93251
725,3587,2815,772,2015,93252
726,813,375,438,2015,93254
727,639,244,395,2015,93255
728,5670,2632,3038,2015,93256
729,75959,37614,38345,2015,93257
730,2277,1236,1041,2015,93258
731,135,83,52,2015,93260
732,3150,1608,1542,2015,93261
733,73,30,43,2015,93262
734,20098,10329,9769,2015,93263
735,3137,1686,1451,2015,93265
736,1171,479,692,2015,93266
737,6585,3344,3241,2015,93267
738,17387,8749,8638,2015,93268
739,5336,2684,2652,2015,93270
740,2185,1156,1029,2015,93271
741,3816,2066,1750,2015,93272
742,71853,35412,36441,2015,93274
743,206,108,98,2015,93276
744,51377,24863,26514,2015,93277
745,27375,16496,10879,2015,93280
746,2353,1304,1049,2015,93283
747,1709,863,846,2015,93285
748,9931,4874,5057,2015,93286
749,115,66,49,2015,93287
750,55990,28288,27702,2015,93291
751,39767,20699,19068,2015,93292
752,11557,5493,6064,2015,93301
753,52172,26172,26000,2015,93304
754,38291,19659,18632,2015,93305
755,69242,33702,35540,2015,93306
756,85957,42443,43514,2015,93307
757,54128,26743,27385,2015,93308
758,60380,29493,30887,2015,93309
759,44874,22168,22706,2015,93311
760,57579,29226,28353,2015,93312
761,45862,22929,22933,2015,93313
762,24537,12568,11969,2015,93314
763,28431,14357,14074,2015,93401
764,15424,7571,7853,2015,93402
765,35021,21538,13483,2015,93405
766,0,0,0,2015,93410
767,30444,14716,15728,2015,93420
768,32191,16548,15643,2015,93422
769,956,501,455,2015,93424
770,1549,1007,542,2015,93426
771,5410,2490,2920,2015,93427
772,6396,2996,3400,2015,93428
773,116,53,63,2015,93429
774,2933,1433,1500,2015,93430
775,880,456,424,2015,93432
776,13409,6370,7039,2015,93433
777,7243,3571,3672,2015,93434
778,55329,28724,26605,2015,93436
779,3317,1901,1416,2015,93437
780,1813,937,876,2015,93440
781,1251,682,569,2015,93441
782,11035,5238,5797,2015,93442
783,19173,9538,9635,2015,93444
784,7659,3697,3962,2015,93445
785,44844,22126,22718,2015,93446
786,7890,3598,4292,2015,93449
787,929,506,423,2015,93450
788,4112,2170,1942,2015,93451
789,500,315,185,2015,93452
790,3701,1785,1916,2015,93453
791,37651,19015,18636,2015,93454
792,42780,20401,22379,2015,93455
793,57081,29412,27669,2015,93458
794,4802,2504,2298,2015,93460
795,1572,885,687,2015,93461
796,7911,4063,3848,2015,93463
797,8827,4094,4733,2015,93465
798,5125,2972,2153,2015,93501
799,13165,7235,5930,2015,93505
800,7462,3982,3480,2015,93510
801,333,146,187,2015,93512
802,1732,886,846,2015,93513
803,14254,7104,7150,2015,93514
804,2326,1014,1312,2015,93516
805,929,558,371,2015,93517
806,954,513,441,2015,93518
807,67,36,31,2015,93519
808,24,11,13,2015,93522
809,3469,1714,1755,2015,93523
810,177,151,26,2015,93524
811,726,380,346,2015,93526
812,1876,948,928,2015,93527
813,118,55,63,2015,93528
814,512,441,71,2015,93529
815,34,12,22,2015,93530
816,363,182,181,2015,93531
817,2557,1239,1318,2015,93532
818,38431,18698,19733,2015,93534
819,73979,35667,38312,2015,93535
820,71254,38333,32921,2015,93536
821,519,174,345,2015,93541
822,13720,6939,6781,2015,93543
823,1145,642,503,2015,93544
824,2006,1029,977,2015,93545
825,9147,4616,4531,2015,93546
826,215,124,91,2015,93549
827,75088,36829,38259,2015,93550
828,50100,24584,25516,2015,93551
829,42630,21523,21107,2015,93552
830,1784,857,927,2015,93553
831,140,84,56,2015,93554
832,33580,17209,16371,2015,93555
833,284,104,180,2015,93558
834,20209,10366,9843,2015,93560
835,33823,19250,14573,2015,93561
836,1712,930,782,2015,93562
837,387,235,152,2015,93563
838,6781,3435,3346,2015,93591
839,8,0,8,2015,93592
840,1917,1077,840,2015,93601
841,4264,2219,2045,2015,93602
842,195,110,85,2015,93603
843,951,416,535,2015,93604
844,248,127,121,2015,93605
845,676,281,395,2015,93606
846,998,563,435,2015,93608
847,5781,2872,2909,2015,93609
848,23912,9393,14519,2015,93610
849,48736,23406,25330,2015,93611
850,36237,17874,18363,2015,93612
851,10785,5566,5219,2015,93614
852,6027,3123,2904,2015,93615
853,2146,1095,1051,2015,93616
854,30379,15843,14536,2015,93618
855,30602,14684,15918,2015,93619
856,9789,5095,4694,2015,93620
857,212,112,100,2015,93621
858,10350,5566,4784,2015,93622
859,89,38,51,2015,93623
860,1339,815,524,2015,93624
861,7346,3781,3565,2015,93625
862,1153,560,593,2015,93626
863,81,44,37,2015,93627
864,196,58,138,2015,93628
865,18898,9536,9362,2015,93630
866,16618,8460,8158,2015,93631
867,0,0,0,2015,93633
868,17,12,5,2015,93634
869,39927,19844,20083,2015,93635
870,12367,6013,6354,2015,93636
871,39596,18744,20852,2015,93637
872,50851,26383,24468,2015,93638
873,12375,6559,5816,2015,93640
874,230,160,70,2015,93641
875,2617,1313,1304,2015,93643
876,7702,3843,3859,2015,93644
877,194,71,123,2015,93645
878,11001,5303,5698,2015,93646
879,12371,6231,6140,2015,93647
880,16120,8293,7827,2015,93648
881,3987,2136,1851,2015,93650
882,1526,752,774,2015,93651
883,237,122,115,2015,93652
884,1602,778,824,2015,93653
885,31259,15846,15413,2015,93654
886,7358,3754,3604,2015,93656
887,35129,17187,17942,2015,93657
888,4797,2417,2380,2015,93660
889,30774,15380,15394,2015,93662
890,688,420,268,2015,93664
891,759,411,348,2015,93665
892,761,282,479,2015,93666
893,2556,1254,1302,2015,93667
894,941,477,464,2015,93668
895,242,120,122,2015,93669
896,711,344,367,2015,93673
897,3097,1660,1437,2015,93675
898,10555,5193,5362,2015,93701
899,47013,23907,23106,2015,93702
900,33417,17193,16224,2015,93703
901,27009,12944,14065,2015,93704
902,38379,18534,19845,2015,93705
903,39929,20212,19717,2015,93706
904,32434,15063,17371,2015,93710
905,37317,17998,19319,2015,93711
906,46411,22159,24252,2015,93720
907,6811,4421,2390,2015,93721
908,82683,40932,41751,2015,93722
909,10214,5349,4865,2015,93723
910,26632,13156,13476,2015,93725
911,43115,21042,22073,2015,93726
912,76619,38512,38107,2015,93727
913,15496,7413,8083,2015,93728
914,10286,4914,5372,2015,93730
915,26800,13174,13626,2015,93901
916,61343,32330,29013,2015,93905
917,63897,30715,33182,2015,93906
918,21901,10954,10947,2015,93907
919,11953,5891,6062,2015,93908
920,941,611,330,2015,93920
921,3355,1488,1867,2015,93921
922,13043,6068,6975,2015,93923
923,6231,2860,3371,2015,93924
924,1853,966,887,2015,93925
925,9402,4558,4844,2015,93926
926,18222,9013,9209,2015,93927
927,431,237,194,2015,93928
928,16691,9154,7537,2015,93930
929,626,305,321,2015,93932
930,23451,11597,11854,2015,93933
931,32785,16956,15829,2015,93940
932,0,0,0,2015,93943
933,15570,7305,8265,2015,93950
934,4554,2196,2358,2015,93953
935,387,177,210,2015,93954
936,34311,16281,18030,2015,93955
937,26946,18565,8381,2015,93960
938,761,472,289,2015,93962
939,26961,13404,13557,2015,94002
940,4496,1832,2664,2015,94005
941,42452,20529,21923,2015,94010
942,48691,24560,24131,2015,94014
943,64258,31416,32842,2015,94015
944,19050,9015,10035,2015,94019
945,1206,620,586,2015,94020
946,149,70,79,2015,94021
947,19578,9502,10076,2015,94022
948,23050,11282,11768,2015,94024
949,41234,19850,21384,2015,94025
950,7244,3638,3606,2015,94027
951,6686,3291,3395,2015,94028
952,22447,10832,11615,2015,94030
953,2903,1427,1476,2015,94037
954,3607,1883,1724,2015,94038
955,34792,18174,16618,2015,94040
956,13916,7362,6554,2015,94041
957,29458,15507,13951,2015,94043
958,38735,18711,20024,2015,94044
959,1758,930,828,2015,94060
960,37809,18669,19140,2015,94061
961,27567,13606,13961,2015,94062
962,32549,17077,15472,2015,94063
963,12241,5620,6621,2015,94065
964,42569,21111,21458,2015,94066
965,30287,14755,15532,2015,94070
966,263,171,92,2015,94074
967,66431,32940,33491,2015,94080
968,23683,12438,11245,2015,94085
969,48258,24613,23645,2015,94086
970,56411,28340,28071,2015,94087
971,20747,10833,9914,2015,94089
972,28926,16672,12254,2015,94102
973,24309,14570,9739,2015,94103
974,304,194,110,2015,94104
975,6108,3347,2761,2015,94105
976,28641,14716,13925,2015,94107
977,14252,7209,7043,2015,94108
978,56293,29439,26854,2015,94109
979,72528,38384,34144,2015,94110
980,3527,1779,1748,2015,94111
981,84145,41913,42232,2015,94112
982,32598,19096,13502,2015,94114
983,35154,16815,18339,2015,94115
984,45559,21530,24029,2015,94116
985,42462,22754,19708,2015,94117
986,41391,19489,21902,2015,94118
987,42622,20522,22100,2015,94121
988,60929,29065,31864,2015,94122
989,25273,11798,13475,2015,94123
990,35010,17130,17880,2015,94124
991,19446,9852,9594,2015,94127
992,99,20,79,2015,94128
993,3639,1854,1785,2015,94129
994,3187,1716,1471,2015,94130
995,28472,15355,13117,2015,94131
996,32031,15555,16476,2015,94132
997,27485,14121,13364,2015,94133
998,40701,19688,21013,2015,94134
999,5747,3346,2401,2015,94158
1000,16876,8361,8515,2015,94301
1001,47550,23382,24168,2015,94303
1002,3655,1832,1823,2015,94304
1003,14228,7931,6297,2015,94305
1004,27583,13586,13997,2015,94306
1005,37298,18821,18477,2015,94401
1006,24591,12054,12537,2015,94402
1007,40548,19842,20706,2015,94403
1008,35492,17452,18040,2015,94404
1009,63118,30842,32276,2015,94501
1010,13615,6366,7249,2015,94502
1011,20285,10005,10280,2015,94503
1012,14687,7668,7019,2015,94505
1013,22622,10826,11796,2015,94506
1014,16653,8431,8222,2015,94507
1015,4255,2171,2084,2015,94508
1016,64406,30960,33446,2015,94509
1017,27723,13429,14294,2015,94510
1018,2172,1248,924,2015,94511
1019,207,15,192,2015,94512
1020,58399,29233,29166,2015,94513
1021,1209,654,555,2015,94514
1022,7404,3985,3419,2015,94515
1023,186,96,90,2015,94516
1024,12913,6410,6503,2015,94517
1025,26966,12711,14255,2015,94518
1026,19819,9720,10099,2015,94519
1027,39484,20692,18792,2015,94520
1028,41575,20228,21347,2015,94521
1029,34707,16288,18419,2015,94523
1030,3044,1382,1662,2015,94525
1031,32340,15774,16566,2015,94526
1032,767,383,384,2015,94528
1033,24482,12006,12476,2015,94530
1034,43095,21674,21421,2015,94531
1035,71487,35085,36402,2015,94533
1036,37253,18235,19018,2015,94534
1037,4254,2203,2051,2015,94535
1038,71765,35004,36761,2015,94536
1039,64696,32623,32073,2015,94538
1040,52096,25506,26590,2015,94539
1041,64282,31502,32780,2015,94541
1042,13262,6167,7095,2015,94542
1043,77213,38468,38745,2015,94544
1044,32236,15786,16450,2015,94545
1045,42754,20140,22614,2015,94546
1046,24860,11548,13312,2015,94547
1047,373,172,201,2015,94548
1048,28719,13754,14965,2015,94549
1049,48663,23909,24754,2015,94550
1050,41250,20729,20521,2015,94551
1051,15226,7985,7241,2015,94552
1052,49256,24055,25201,2015,94553
1053,36693,18276,18417,2015,94555
1054,15861,7554,8307,2015,94556
1055,68227,33913,34314,2015,94558
1056,27900,14150,13750,2015,94559
1057,44207,22280,21927,2015,94560
1058,39435,19576,19859,2015,94561
1059,18580,9313,9267,2015,94563
1060,18887,8899,9988,2015,94564
1061,89712,43441,46271,2015,94565
1062,43413,21209,22204,2015,94566
1063,552,290,262,2015,94567
1064,49864,24753,25111,2015,94568
1065,327,215,112,2015,94569
1066,8418,4130,4288,2015,94571
1067,9724,4335,5389,2015,94572
1068,192,112,80,2015,94573
1069,9062,4284,4778,2015,94574
1070,1146,587,559,2015,94575
1071,91,18,73,2015,94576
1072,46494,22525,23969,2015,94577
1073,39642,18960,20682,2015,94578
1074,22056,11570,10486,2015,94579
1075,29445,14365,15080,2015,94580
1076,40215,19921,20294,2015,94582
1077,35631,17752,17879,2015,94583
1078,29260,14620,14640,2015,94585
1079,976,530,446,2015,94586
1080,72690,36057,36633,2015,94587
1081,32979,16272,16707,2015,94588
1082,31289,14773,16516,2015,94589
1083,35543,17288,18255,2015,94590
1084,54126,26549,27577,2015,94591
1085,776,331,445,2015,94592
1086,16732,7062,9670,2015,94595
1087,20524,9715,10809,2015,94596
1088,21271,10730,10541,2015,94597
1089,27328,12642,14686,2015,94598
1090,3185,1336,1849,2015,94599
1091,50024,25676,24348,2015,94601
1092,29829,14348,15481,2015,94602
1093,33116,15884,17232,2015,94603
1094,42079,19395,22684,2015,94605
1095,38055,18759,19296,2015,94606
1096,26172,12823,13349,2015,94607
1097,28125,13881,14244,2015,94608
1098,21981,10792,11189,2015,94609
1099,30537,14490,16047,2015,94610
1100,38023,18148,19875,2015,94611
1101,14782,7686,7096,2015,94612
1102,871,118,753,2015,94613
1103,16884,7814,9070,2015,94618
1104,24005,11061,12944,2015,94619
1105,33369,16494,16875,2015,94621
1106,17016,8338,8678,2015,94702
1107,21561,10858,10703,2015,94703
1108,26573,12778,13795,2015,94704
1109,13224,6347,6877,2015,94705
1110,20652,9918,10734,2015,94706
1111,12555,5894,6661,2015,94707
1112,11071,5289,5782,2015,94708
1113,11866,5937,5929,2015,94709
1114,6802,3457,3345,2015,94710
1115,3087,1521,1566,2015,94720
1116,30462,15240,15222,2015,94801
1117,25252,12454,12798,2015,94803
1118,40907,19499,21408,2015,94804
1119,14701,7161,7540,2015,94805
1120,60627,29712,30915,2015,94806
1121,0,0,0,2015,94850
1122,42488,21461,21027,2015,94901
1123,30555,14589,15966,2015,94903
1124,12458,5716,6742,2015,94904
1125,12711,5846,6865,2015,94920
1126,458,195,263,2015,94922
1127,781,339,442,2015,94923
1128,1387,709,678,2015,94924
1129,9595,4418,5177,2015,94925
1130,43028,19715,23313,2015,94928
1131,139,51,88,2015,94929
1132,8796,4105,4691,2015,94930
1133,8442,3970,4472,2015,94931
1134,812,406,406,2015,94933
1135,782,340,442,2015,94937
1136,636,287,349,2015,94938
1137,6936,3212,3724,2015,94939
1138,235,124,111,2015,94940
1139,31168,15071,16097,2015,94941
1140,18602,9007,9595,2015,94945
1141,747,347,400,2015,94946
1142,26252,12486,13766,2015,94947
1143,16366,8520,7846,2015,94949
1144,72,39,33,2015,94950
1145,4152,1971,2181,2015,94951
1146,35011,16584,18427,2015,94952
1147,37273,18397,18876,2015,94954
1148,1351,572,779,2015,94956
1149,1316,618,698,2015,94957
1150,15777,7383,8394,2015,94960
1151,701,327,374,2015,94963
1152,3884,3717,167,2015,94964
1153,11294,5513,5781,2015,94965
1154,573,261,312,2015,94970
1155,339,120,219,2015,94971
1156,0,0,0,2015,94972
1157,1653,821,832,2015,94973
1158,1764,900,864,2015,95002
1159,24546,11747,12799,2015,95003
1160,4109,1998,2111,2015,95004
1161,6733,3348,3385,2015,95005
1162,8555,4392,4163,2015,95006
1163,715,360,355,2015,95007
1164,46054,22829,23225,2015,95008
1165,9335,4666,4669,2015,95010
1166,10748,5393,5355,2015,95012
1167,57,26,31,2015,95013
1168,62346,30517,31829,2015,95014
1169,658,342,316,2015,95017
1170,7632,3763,3869,2015,95018
1171,7159,3440,3719,2015,95019
1172,60203,30190,30013,2015,95020
1173,50759,25399,25360,2015,95023
1174,13389,6651,6738,2015,95030
1175,26360,13132,13228,2015,95032
1176,9772,5078,4694,2015,95033
1177,71767,35910,35857,2015,95035
1178,47560,23093,24467,2015,95037
1179,1558,737,821,2015,95039
1180,222,159,63,2015,95041
1181,721,336,385,2015,95043
1182,4334,2223,2111,2015,95045
1183,6413,3109,3304,2015,95046
1184,38024,19634,18390,2015,95050
1185,55470,27777,27693,2015,95051
1186,2911,1407,1504,2015,95053
1187,23989,12235,11754,2015,95054
1188,46695,23392,23303,2015,95060
1189,37132,18714,18418,2015,95062
1190,9385,4227,5158,2015,95064
1191,8804,4458,4346,2015,95065
1192,15670,7614,8056,2015,95066
1193,31223,15231,15992,2015,95070
1194,11265,5614,5651,2015,95073
1195,339,171,168,2015,95075
1196,84779,42888,41891,2015,95076
1197,19682,10720,8962,2015,95110
1198,62157,31125,31032,2015,95111
1199,60130,31642,28488,2015,95112
1200,1169,643,526,2015,95113
1201,54217,27490,26727,2015,95116
1202,31613,16016,15597,2015,95117
1203,31871,15515,16356,2015,95118
1204,10781,5158,5623,2015,95119
1205,37644,18723,18921,2015,95120
1206,38958,19972,18986,2015,95121
1207,58350,29185,29165,2015,95122
1208,65276,31497,33779,2015,95123
1209,49402,24400,25002,2015,95124
1210,54563,26237,28326,2015,95125
1211,33842,17131,16711,2015,95126
1212,65812,34067,31745,2015,95127
1213,37870,19974,17896,2015,95128
1214,40471,20077,20394,2015,95129
1215,14413,7255,7158,2015,95130
1216,29995,15299,14696,2015,95131
1217,40518,20351,20167,2015,95132
1218,28392,14362,14030,2015,95133
1219,18743,9818,8925,2015,95134
1220,21766,10162,11604,2015,95135
1221,42725,21142,21583,2015,95136
1222,19297,9458,9839,2015,95138
1223,6784,3475,3309,2015,95139
1224,209,117,92,2015,95140
1225,48225,23898,24327,2015,95148
1226,6067,2999,3068,2015,95202
1227,15971,8138,7833,2015,95203
1228,28625,13797,14828,2015,95204
1229,37299,19025,18274,2015,95205
1230,65448,33381,32067,2015,95206
1231,48446,22673,25773,2015,95207
1232,42154,20113,22041,2015,95209
1233,40686,19656,21030,2015,95210
1234,1730,717,1013,2015,95211
1235,26433,12790,13643,2015,95212
1236,23824,12347,11477,2015,95215
1237,28479,13778,14701,2015,95219
1238,7015,3635,3380,2015,95220
1239,4981,2321,2660,2015,95222
1240,2780,1531,1249,2015,95223
1241,193,112,81,2015,95224
1242,749,280,469,2015,95225
1243,14,14,0,2015,95226
1244,814,363,451,2015,95227
1245,4723,2484,2239,2015,95228
1246,776,267,509,2015,95230
1247,4823,3236,1587,2015,95231
1248,266,107,159,2015,95232
1249,627,263,364,2015,95233
1250,109,49,60,2015,95234
1251,3929,1950,1979,2015,95236
1252,3097,1737,1360,2015,95237
1253,47250,23458,23792,2015,95240
1254,26343,12928,13415,2015,95242
1255,2290,1085,1205,2015,95245
1256,1256,562,694,2015,95246
1257,4981,2187,2794,2015,95247
1258,121,58,63,2015,95248
1259,3865,2138,1727,2015,95249
1260,66,31,35,2015,95250
1261,872,458,414,2015,95251
1262,13874,7044,6830,2015,95252
1263,955,521,434,2015,95254
1264,1774,823,951,2015,95255
1265,374,118,256,2015,95257
1266,3705,1987,1718,2015,95258
1267,38022,19457,18565,2015,95301
1268,754,405,349,2015,95303
1269,17442,10165,7277,2015,95304
1270,40,24,16,2015,95305
1271,822,451,371,2015,95306
1272,42208,21706,20502,2015,95307
1273,2132,1061,1071,2015,95310
1274,1912,893,1019,2015,95311
1275,267,153,114,2015,95312
1276,1053,514,539,2015,95313
1277,0,0,0,2015,95314
1278,12363,6357,6006,2015,95315
1279,6961,3325,3636,2015,95316
1280,990,570,420,2015,95317
1281,467,256,211,2015,95318
1282,1591,833,758,2015,95319
1283,13018,6730,6288,2015,95320
1284,3432,1764,1668,2015,95321
1285,8763,4786,3977,2015,95322
1286,1077,562,515,2015,95323
1287,7522,3707,3815,2015,95324
1288,73,51,22,2015,95325
1289,9790,4473,5317,2015,95326
1290,8202,5554,2648,2015,95327
1291,5048,2573,2475,2015,95328
1292,2846,1377,1469,2015,95329
1293,19596,9798,9798,2015,95330
1294,2988,1596,1392,2015,95333
1295,16444,8066,8378,2015,95334
1296,364,160,204,2015,95335
1297,47343,23431,23912,2015,95336
1298,33432,16034,17398,2015,95337
1299,10928,5342,5586,2015,95338
1300,35309,16839,18470,2015,95340
1301,33464,17414,16050,2015,95341
1302,422,200,222,2015,95345
1303,1842,1033,809,2015,95346
1304,33442,16574,16868,2015,95348
1305,50908,23695,27213,2015,95350
1306,49163,24306,24857,2015,95351
1307,24838,12336,12502,2015,95354
1308,59210,28374,30836,2015,95355
1309,33370,16665,16705,2015,95356
1310,11955,5924,6031,2015,95357
1311,33194,17531,15663,2015,95358
1312,12139,6170,5969,2015,95360
1313,33163,16546,16617,2015,95361
1314,25866,13497,12369,2015,95363
1315,0,0,0,2015,95364
1316,4666,2526,2140,2015,95365
1317,16848,7949,8899,2015,95366
1318,24173,11692,12481,2015,95367
1319,13439,7046,6393,2015,95368
1320,956,472,484,2015,95369
1321,27043,13296,13747,2015,95370
1322,1891,932,959,2015,95372
1323,1851,996,855,2015,95374
1324,246,85,161,2015,95375
1325,49582,25324,24258,2015,95376
1326,32723,16741,15982,2015,95377
1327,3895,1795,2100,2015,95379
1328,41254,19918,21336,2015,95380
1329,37497,18589,18908,2015,95382
1330,3456,1700,1756,2015,95383
1331,508,289,219,2015,95385
1332,10265,5154,5111,2015,95386
1333,609,311,298,2015,95387
1334,14371,7300,7071,2015,95388
1335,1592,1029,563,2015,95389
1336,13185,6033,7152,2015,95391
1337,38048,18237,19811,2015,95401
1338,45596,23277,22319,2015,95403
1339,41268,20736,20532,2015,95404
1340,21695,10605,11090,2015,95405
1341,40959,21503,19456,2015,95407
1342,26586,12319,14267,2015,95409
1343,946,487,459,2015,95410
1344,382,203,179,2015,95412
1345,1245,721,524,2015,95415
1346,219,101,118,2015,95417
1347,611,334,277,2015,95420
1348,1474,742,732,2015,95421
1349,15476,7954,7522,2015,95422
1350,3260,1805,1455,2015,95423
1351,10597,4968,5629,2015,95425
1352,1544,872,672,2015,95426
1353,256,156,100,2015,95427
1354,2365,1186,1179,2015,95428
1355,74,45,29,2015,95429
1356,0,0,0,2015,95430
1357,621,379,242,2015,95431
1358,421,221,200,2015,95432
1359,334,208,126,2015,95435
1360,6052,3145,2907,2015,95436
1361,14492,7396,7096,2015,95437
1362,779,441,338,2015,95439
1363,1970,1081,889,2015,95441
1364,3118,1544,1574,2015,95442
1365,284,150,134,2015,95443
1366,710,318,392,2015,95444
1367,1728,926,802,2015,95445
1368,4281,2360,1921,2015,95446
1369,17631,8678,8953,2015,95448
1370,1708,959,749,2015,95449
1371,262,149,113,2015,95450
1372,12212,5966,6246,2015,95451
1373,1364,704,660,2015,95452
1374,10244,4846,5398,2015,95453
1375,2075,1050,1025,2015,95454
1376,731,273,458,2015,95456
1377,3162,1587,1575,2015,95457
1378,3176,1539,1637,2015,95458
1379,581,276,305,2015,95459
1380,2364,1094,1270,2015,95460
1381,3298,1607,1691,2015,95461
1382,1216,615,601,2015,95462
1383,29,13,16,2015,95463
1384,2295,1094,1201,2015,95464
1385,2237,1087,1150,2015,95465
1386,864,540,324,2015,95466
1387,5986,2956,3030,2015,95467
1388,1156,561,595,2015,95468
1389,1963,977,986,2015,95469
1390,7009,3766,3243,2015,95470
1391,536,289,247,2015,95471
1392,30281,14724,15557,2015,95472
1393,37646,18245,19401,2015,95476
1394,32892,15742,17150,2015,95482
1395,2492,1414,1078,2015,95485
1396,40,26,14,2015,95486
1397,357,176,181,2015,95488
1398,12661,6364,6297,2015,95490
1399,29486,14823,14663,2015,95492
1400,288,117,171,2015,95493
1401,112,43,69,2015,95494
1402,1068,447,621,2015,95497
1403,23689,12016,11673,2015,95501
1404,25438,12336,13102,2015,95503
1405,430,288,142,2015,95511
1406,215,85,130,2015,95514
1407,18538,9395,9143,2015,95519
1408,20930,10046,10884,2015,95521
1409,1956,1096,860,2015,95524
1410,1745,934,811,2015,95525
1411,213,111,102,2015,95526
1412,600,317,283,2015,95527
1413,1044,496,548,2015,95528
1414,23801,13378,10423,2015,95531
1415,2984,1567,1417,2015,95536
1416,229,148,81,2015,95537
1417,13190,6345,6845,2015,95540
1418,2360,1209,1151,2015,95542
1419,636,284,352,2015,95543
1420,100,60,40,2015,95545
1421,3286,1549,1737,2015,95546
1422,1265,651,614,2015,95547
1423,1486,874,612,2015,95548
1424,824,411,413,2015,95549
1425,247,165,82,2015,95550
1426,1782,936,846,2015,95551
1427,635,350,285,2015,95552
1428,1090,496,594,2015,95553
1429,392,182,210,2015,95554
1430,326,161,165,2015,95555
1431,652,400,252,2015,95556
1432,398,222,176,2015,95558
1433,95,24,71,2015,95559
1434,1310,688,622,2015,95560
1435,3438,1765,1673,2015,95562
1436,720,312,408,2015,95563
1437,492,283,209,2015,95564
1438,1044,519,525,2015,95565
1439,1865,882,983,2015,95567
1440,126,55,71,2015,95568
1441,344,224,120,2015,95569
1442,2106,1092,1014,2015,95570
1443,237,122,115,2015,95571
1444,1557,880,677,2015,95573
1445,451,270,181,2015,95585
1446,157,70,87,2015,95587
1447,1163,666,497,2015,95589
1448,153,90,63,2015,95595
1449,137,73,64,2015,95601
1450,17955,8759,9196,2015,95602
1451,29182,14986,14196,2015,95603
1452,64,33,31,2015,95604
1453,14924,7631,7293,2015,95605
1454,18,8,10,2015,95606
1455,431,264,167,2015,95607
1456,61344,28933,32411,2015,95608
1457,44085,21355,22730,2015,95610
1458,1070,506,564,2015,95612
1459,4284,2177,2107,2015,95614
1460,861,475,386,2015,95615
1461,48822,22762,26060,2015,95616
1462,27651,14181,13470,2015,95618
1463,5073,2677,2396,2015,95619
1464,21267,10757,10510,2015,95620
1465,42063,19729,22334,2015,95621
1466,4215,2084,2131,2015,95623
1467,64225,32010,32215,2015,95624
1468,180,80,100,2015,95625
1469,6308,3113,3195,2015,95626
1470,3618,1763,1855,2015,95627
1471,41043,19776,21267,2015,95628
1472,820,313,507,2015,95629
1473,74180,40083,34097,2015,95630
1474,6017,3027,2990,2015,95631
1475,30208,14494,15714,2015,95632
1476,2933,1366,1567,2015,95633
1477,3216,1736,1480,2015,95634
1478,905,501,404,2015,95635
1479,880,404,476,2015,95636
1480,837,352,485,2015,95637
1481,2095,1077,1018,2015,95638
1482,293,137,156,2015,95639
1483,13097,8754,4343,2015,95640
1484,1776,876,900,2015,95641
1485,6581,3032,3549,2015,95642
1486,2110,1056,1054,2015,95645
1487,75,53,22,2015,95646
1488,49990,24070,25920,2015,95648
1489,12696,6200,6496,2015,95650
1490,737,316,421,2015,95651
1491,953,482,471,2015,95652
1492,599,342,257,2015,95653
1493,4190,2071,2119,2015,95655
1494,6266,3092,3174,2015,95658
1495,777,380,397,2015,95659
1496,34464,17172,17292,2015,95660
1497,30321,14744,15577,2015,95661
1498,32293,15633,16660,2015,95662
1499,2516,1122,1394,2015,95663
1500,1334,771,563,2015,95664
1501,4536,2262,2274,2015,95665
1502,4498,2226,2272,2015,95666
1503,36684,17804,18880,2015,95667
1504,780,436,344,2015,95668
1505,2043,893,1150,2015,95669
1506,53662,25830,27832,2015,95670
1507,5432,2559,2873,2015,95672
1508,14895,7483,7412,2015,95673
1509,1010,460,550,2015,95674
1510,284,94,190,2015,95675
1511,23196,11147,12049,2015,95677
1512,42153,20194,21959,2015,95678
1513,54,19,35,2015,95679
1514,291,155,136,2015,95680
1515,1596,957,639,2015,95681
1516,30013,14759,15254,2015,95682
1517,6411,3208,3203,2015,95683
1518,3102,1649,1453,2015,95684
1519,3827,1705,2122,2015,95685
1520,1007,475,532,2015,95686
1521,66350,35452,30898,2015,95687
1522,36385,18324,18061,2015,95688
1523,1022,528,494,2015,95689
1524,2122,1028,1094,2015,95690
1525,35951,17290,18661,2015,95691
1526,4867,2489,2378,2015,95692
1527,6322,2971,3351,2015,95693
1528,9428,4600,4828,2015,95694
1529,38998,18923,20075,2015,95695
1530,569,305,264,2015,95697
1531,221,101,120,2015,95698
1532,217,156,61,2015,95699
1533,792,373,419,2015,95701
1534,998,510,488,2015,95703
1535,4857,2450,2407,2015,95709
1536,10009,4989,5020,2015,95713
1537,311,153,158,2015,95714
1538,92,56,36,2015,95715
1539,166,82,84,2015,95717
1540,55,27,28,2015,95720
1541,13,13,0,2015,95721
1542,4478,2096,2382,2015,95722
1543,0,0,0,2015,95724
1544,8712,4053,4659,2015,95726
1545,481,262,219,2015,95728
1546,26,12,14,2015,95735
1547,255,146,109,2015,95736
1548,10145,5337,4808,2015,95742
1549,23516,11966,11550,2015,95746
1550,58938,27406,31532,2015,95747
1551,45259,23134,22125,2015,95757
1552,62411,29575,32836,2015,95758
1553,40039,20251,19788,2015,95762
1554,36700,17788,18912,2015,95765
1555,22559,11233,11326,2015,95776
1556,7072,3684,3388,2015,95811
1557,9706,6001,3705,2015,95814
1558,25394,12591,12803,2015,95815
1559,17203,8771,8432,2015,95816
1560,13818,6409,7409,2015,95817
1561,20542,9971,10571,2015,95818
1562,18571,8385,10186,2015,95819
1563,35425,16853,18572,2015,95820
1564,34053,16683,17370,2015,95821
1565,43427,20828,22599,2015,95822
1566,76079,36164,39915,2015,95823
1567,30053,15513,14540,2015,95824
1568,31846,14702,17144,2015,95825
1569,38256,18727,19529,2015,95826
1570,20509,9839,10670,2015,95827
1571,62016,31081,30935,2015,95828
1572,26533,12794,13739,2015,95829
1573,792,475,317,2015,95830
1574,41233,19053,22180,2015,95831
1575,11283,5586,5697,2015,95832
1576,40129,18906,21223,2015,95833
1577,24832,12385,12447,2015,95834
1578,38942,19583,19359,2015,95835
1579,341,171,170,2015,95837
1580,37133,18432,18701,2015,95838
1581,19730,9381,10349,2015,95841
1582,31299,15142,16157,2015,95842
1583,46972,22608,24364,2015,95843
1584,23007,11369,11638,2015,95864
1585,32586,16331,16255,2015,95901
1586,1690,1103,587,2015,95903
1587,116,17,99,2015,95910
1588,4755,2376,2379,2015,95912
1589,625,279,346,2015,95914
1590,10,10,0,2015,95915
1591,1300,729,571,2015,95916
1592,3320,1751,1569,2015,95917
1593,1905,1057,848,2015,95918
1594,1255,653,602,2015,95919
1595,243,71,172,2015,95920
1596,571,312,259,2015,95922
1597,10,5,5,2015,95923
1598,95,58,37,2015,95925
1599,38315,18946,19369,2015,95926
1600,36029,17412,18617,2015,95928
1601,155,66,89,2015,95930
1602,7671,4100,3571,2015,95932
1603,394,275,119,2015,95934
1604,592,298,294,2015,95935
1605,224,137,87,2015,95936
1606,1266,602,664,2015,95937
1607,3888,1873,2015,2015,95938
1608,543,301,242,2015,95939
1609,398,169,229,2015,95941
1610,892,469,423,2015,95942
1611,886,471,415,2015,95943
1612,14,14,0,2015,95944
1613,25510,11699,13811,2015,95945
1614,10339,4940,5399,2015,95946
1615,1760,780,980,2015,95947
1616,10645,5184,5461,2015,95948
1617,19575,9312,10263,2015,95949
1618,615,275,340,2015,95950
1619,3013,1567,1446,2015,95951
1620,10241,4991,5250,2015,95953
1621,11976,5975,6001,2015,95954
1622,1399,618,781,2015,95955
1623,431,238,193,2015,95956
1624,929,485,444,2015,95957
1625,17341,9011,8330,2015,95959
1626,915,433,482,2015,95960
1627,27745,13862,13883,2015,95961
1628,1214,653,561,2015,95962
1629,15093,7535,7558,2015,95963
1630,20630,10438,10192,2015,95965
1631,31069,15338,15731,2015,95966
1632,1605,738,867,2015,95968
1633,27538,13531,14007,2015,95969
1634,458,245,213,2015,95970
1635,5968,2996,2972,2015,95971
1636,34569,17374,17195,2015,95973
1637,63,48,15,2015,95974
1638,2034,1177,857,2015,95975
1639,1656,995,661,2015,95977
1640,110,74,36,2015,95978
1641,646,343,303,2015,95979
1642,83,45,38,2015,95981
1643,3475,1751,1724,2015,95982
1644,541,272,269,2015,95983
1645,31,0,31,2015,95984
1646,24,6,18,2015,95986
1647,6088,3268,2820,2015,95987
1648,8767,4463,4304,2015,95988
1649,41635,20743,20892,2015,95991
1650,35469,17565,17904,2015,95993
1651,34597,16771,17826,2015,96001
1652,32958,16294,16664,2015,96002
1653,44714,21721,22993,2015,96003
1654,314,147,167,2015,96006
1655,23130,11473,11657,2015,96007
1656,1108,589,519,2015,96008
1657,294,142,152,2015,96009
1658,169,124,45,2015,96010
1659,148,74,74,2015,96011
1660,4111,2083,2028,2015,96013
1661,116,72,44,2015,96014
1662,626,349,277,2015,96015
1663,573,297,276,2015,96016
1664,175,101,74,2015,96017
1665,10126,5043,5083,2015,96019
1666,2287,1272,1015,2015,96020
1667,16122,7864,8258,2015,96021
1668,17736,8718,9018,2015,96022
1669,1184,579,605,2015,96023
1670,967,485,482,2015,96024
1671,2089,1138,951,2015,96025
1672,2464,1277,1187,2015,96027
1673,1635,797,838,2015,96028
1674,158,99,59,2015,96029
1675,149,75,74,2015,96031
1676,2345,1310,1035,2015,96032
1677,580,324,256,2015,96033
1678,255,118,137,2015,96034
1679,3431,1803,1628,2015,96035
1680,180,74,106,2015,96037
1681,636,293,343,2015,96038
1682,1078,539,539,2015,96039
1683,292,159,133,2015,96040
1684,3019,1636,1383,2015,96041
1685,962,504,458,2015,96044
1686,183,101,82,2015,96046
1687,783,421,362,2015,96047
1688,822,373,449,2015,96048
1689,76,44,32,2015,96049
1690,411,218,193,2015,96050
1691,1304,564,740,2015,96051
1692,1533,868,665,2015,96052
1693,276,159,117,2015,96054
1694,3987,1972,2015,2015,96055
1695,1368,651,717,2015,96056
1696,1348,685,663,2015,96057
1697,806,463,343,2015,96058
1698,740,416,324,2015,96059
1699,25,12,13,2015,96061
1700,1245,608,637,2015,96062
1701,199,106,93,2015,96063
1702,5001,2527,2474,2015,96064
1703,445,238,207,2015,96065
1704,6991,3231,3760,2015,96067
1705,148,121,27,2015,96068
1706,758,412,346,2015,96069
1707,125,45,80,2015,96071
1708,4207,2024,2183,2015,96073
1709,223,163,60,2015,96074
1710,299,194,105,2015,96075
1711,122,82,40,2015,96076
1712,27524,13478,14046,2015,96080
1713,484,215,269,2015,96084
1714,67,37,30,2015,96085
1715,359,199,160,2015,96086
1716,521,268,253,2015,96087
1717,4200,2240,1960,2015,96088
1718,410,186,224,2015,96090
1719,521,277,244,2015,96091
1720,300,181,119,2015,96092
1721,4032,1934,2098,2015,96093
1722,6145,3027,3118,2015,96094
1723,771,397,374,2015,96096
1724,9860,4738,5122,2015,96097
1725,5531,2853,2678,2015,96101
1726,1331,624,707,2015,96103
1727,559,284,275,2015,96104
1728,47,25,22,2015,96105
1729,217,97,120,2015,96106
1730,1306,697,609,2015,96107
1731,10,5,5,2015,96108
1732,804,406,398,2015,96109
1733,157,82,75,2015,96110
1734,40,27,13,2015,96111
1735,266,111,155,2015,96112
1736,2158,1721,437,2015,96113
1737,3531,1813,1718,2015,96114
1738,119,58,61,2015,96115
1739,129,74,55,2015,96116
1740,227,112,115,2015,96117
1741,1717,847,870,2015,96118
1742,124,52,72,2015,96119
1743,1064,616,448,2015,96120
1744,298,162,136,2015,96121
1745,3864,1892,1972,2015,96122
1746,35,16,19,2015,96123
1747,380,192,188,2015,96124
1748,242,136,106,2015,96125
1749,55,23,32,2015,96126
1750,831,468,363,2015,96128
1751,123,54,69,2015,96129
1752,21456,15368,6088,2015,96130
1753,105,54,51,2015,96132
1754,235,78,157,2015,96133
1755,2357,1135,1222,2015,96134
1756,15,15,0,2015,96135
1757,103,28,75,2015,96136
1758,3733,1990,1743,2015,96137
1759,999,492,507,2015,96140
1760,585,318,267,2015,96141
1761,706,285,421,2015,96142
1762,4124,2478,1646,2015,96143
1763,2872,1584,1288,2015,96145
1764,857,514,343,2015,96146
1765,853,471,382,2015,96148
1766,28912,15069,13843,2015,96150
1767,0,0,0,2015,96155
1768,18256,9774,8482,2015,96161
1769,326,203,123,2015,97635
0,Estimate!!SEX AND AGE!!Total population,Estimate!!SEX AND AGE!!Total population!!Male,Estimate!!SEX AND AGE!!Total population!!Female,2014,Geographic Area Name
1,368,174,194,2014,89010
2,1843,1038,805,2014,89019
3,9831,4856,4975,2014,89060
4,4938,2431,2507,2014,89061
5,1563,815,748,2014,89439
6,56314,27515,28799,2014,90001
7,50098,24587,25511,2014,90002
8,66913,32691,34222,2014,90003
9,63547,31926,31621,2014,90004
10,38638,19666,18972,2014,90005
11,61419,31748,29671,2014,90006
12,43779,21987,21792,2014,90007
13,33012,14362,18650,2014,90008
14,3792,1809,1983,2014,90010
15,102926,51432,51494,2014,90011
16,30029,18092,11937,2014,90012
17,10575,6229,4346,2014,90013
18,6659,4158,2501,2014,90014
19,18226,9532,8694,2014,90015
20,47786,22193,25593,2014,90016
21,23719,12654,11065,2014,90017
22,48852,22841,26011,2014,90018
23,67606,32886,34720,2014,90019
24,39102,19278,19824,2014,90020
25,2913,1926,987,2014,90021
26,69516,34138,35378,2014,90022
27,45886,23009,22877,2014,90023
28,50117,23768,26349,2014,90024
29,45284,22869,22415,2014,90025
30,67986,34296,33690,2014,90026
31,46025,23177,22848,2014,90027
32,29994,16289,13705,2014,90028
33,40161,20921,19240,2014,90029
34,39333,19810,19523,2014,90031
35,47309,23438,23871,2014,90032
36,48567,24273,24294,2014,90033
37,58968,29670,29298,2014,90034
38,31399,14877,16522,2014,90035
39,36425,17867,18558,2014,90036
40,61536,30175,31361,2014,90037
41,28798,14722,14076,2014,90038
42,27843,14343,13500,2014,90039
43,12830,6298,6532,2014,90040
44,28439,13573,14866,2014,90041
45,61034,30160,30874,2014,90042
46,43118,19801,23317,2014,90043
47,88412,42042,46370,2014,90044
48,41453,20391,21062,2014,90045
49,51329,27376,23953,2014,90046
50,46999,21151,25848,2014,90047
51,22409,10417,11992,2014,90048
52,35262,16065,19197,2014,90049
53,8380,3719,4661,2014,90056
54,45747,24270,21477,2014,90057
55,2748,1388,1360,2014,90058
56,42470,20567,21903,2014,90059
57,28641,13117,15524,2014,90061
58,32675,15288,17387,2014,90062
59,54353,27260,27093,2014,90063
60,25788,12462,13326,2014,90064
61,46254,24147,22107,2014,90065
62,58337,29483,28854,2014,90066
63,2364,1075,1289,2014,90067
64,21943,12111,9832,2014,90068
65,20426,12373,8053,2014,90069
66,0,0,0,2014,90071
67,801,618,183,2014,90073
68,8328,4028,4300,2014,90077
69,0,0,0,2014,90079
70,3326,1540,1786,2014,90089
71,0,0,0,2014,90090
72,6062,2740,3322,2014,90094
73,0,0,0,2014,90095
74,102515,51437,51078,2014,90201
75,21478,10022,11456,2014,90210
76,8080,3642,4438,2014,90211
77,12415,5586,6829,2014,90212
78,50222,23909,26313,2014,90220
79,53657,26104,27553,2014,90221
80,32362,15551,16811,2014,90222
81,33090,16298,16792,2014,90230
82,15353,7516,7837,2014,90232
83,26287,13286,13001,2014,90240
84,43596,21549,22047,2014,90241
85,43199,21262,21937,2014,90242
86,16839,8743,8096,2014,90245
87,47374,22740,24634,2014,90247
88,9936,4850,5086,2014,90248
89,27451,13159,14292,2014,90249
90,95223,46645,48578,2014,90250
91,19725,10234,9491,2014,90254
92,76206,37946,38260,2014,90255
93,35854,18243,17611,2014,90260
94,70650,33973,36677,2014,90262
95,1987,896,1091,2014,90263
96,17660,8720,8940,2014,90265
97,35534,17458,18076,2014,90266
98,27663,13865,13798,2014,90270
99,23497,11405,12092,2014,90272
100,25482,12455,13027,2014,90274
101,42420,20221,22199,2014,90275
102,34546,16774,17772,2014,90277
103,40839,19937,20902,2014,90278
104,95515,47093,48422,2014,90280
105,6902,3157,3745,2014,90290
106,27803,14594,13209,2014,90291
107,21507,10016,11491,2014,90292
108,11997,6021,5976,2014,90293
109,36714,17460,19254,2014,90301
110,30219,13705,16514,2014,90302
111,26453,12624,13829,2014,90303
112,26936,13477,13459,2014,90304
113,15501,6639,8862,2014,90305
114,7035,3615,3420,2014,90401
115,11503,5511,5992,2014,90402
116,25116,11702,13414,2014,90403
117,21641,10265,11376,2014,90404
118,28535,13775,14760,2014,90405
119,43407,20711,22696,2014,90501
120,17135,8229,8906,2014,90502
121,45518,21952,23566,2014,90503
122,32777,16653,16124,2014,90504
123,37381,17745,19636,2014,90505
124,0,0,0,2014,90506
125,34143,16983,17160,2014,90601
126,26676,12820,13856,2014,90602
127,20475,9940,10535,2014,90603
128,39541,19085,20456,2014,90604
129,42103,20581,21522,2014,90605
130,32978,16394,16584,2014,90606
131,45992,22551,23441,2014,90620
132,35478,17402,18076,2014,90621
133,15767,7460,8307,2014,90623
134,48844,23324,25520,2014,90630
135,68899,33401,35498,2014,90631
136,49543,24166,25377,2014,90638
137,63400,30784,32616,2014,90640
138,106521,53685,52836,2014,90650
139,63686,31266,32420,2014,90660
140,15594,7472,8122,2014,90670
141,30770,15206,15564,2014,90680
142,16698,8510,8188,2014,90701
143,50069,23795,26274,2014,90703
144,3952,1911,2041,2014,90704
145,77455,37184,40271,2014,90706
146,27550,13050,14500,2014,90710
147,32015,15307,16708,2014,90712
148,28411,13943,14468,2014,90713
149,20283,9902,10381,2014,90715
150,14358,6903,7455,2014,90716
151,21612,10507,11105,2014,90717
152,22325,10778,11547,2014,90720
153,54813,27196,27617,2014,90723
154,62348,31540,30808,2014,90731
155,19810,8979,10831,2014,90732
156,24288,10929,13359,2014,90740
157,842,474,368,2014,90742
158,330,174,156,2014,90743
159,58061,29190,28871,2014,90744
160,57727,28454,29273,2014,90745
161,26738,13202,13536,2014,90746
162,0,0,0,2014,90747
163,11400,5504,5896,2014,90755
164,38816,20485,18331,2014,90802
165,30805,15149,15656,2014,90803
166,40679,20241,20438,2014,90804
167,94561,46308,48253,2014,90805
168,43140,20895,22245,2014,90806
169,33726,15962,17764,2014,90807
170,39834,19712,20122,2014,90808
171,36736,18259,18477,2014,90810
172,60017,30053,29964,2014,90813
173,18789,9396,9393,2014,90814
174,40572,19795,20777,2014,90815
175,169,144,25,2014,90822
176,0,0,0,2014,90831
177,37481,18318,19163,2014,91001
178,32392,15292,17100,2014,91006
179,34198,15862,18336,2014,91007
180,1149,513,636,2014,91008
181,25797,12503,13294,2014,91010
182,20671,10176,10495,2014,91011
183,42235,20655,21580,2014,91016
184,9249,4403,4846,2014,91020
185,11060,5222,5838,2014,91024
186,25914,12422,13492,2014,91030
187,20017,10184,9833,2014,91040
188,28126,13727,14399,2014,91042
189,168,27,141,2014,91046
190,21098,9839,11259,2014,91101
191,27684,13940,13744,2014,91103
192,38421,18969,19452,2014,91104
193,11373,5705,5668,2014,91105
194,24861,12960,11901,2014,91106
195,31828,15837,15991,2014,91107
196,13613,6559,7054,2014,91108
197,22985,10951,12034,2014,91201
198,23007,10530,12477,2014,91202
199,13740,6778,6962,2014,91203
200,16292,7698,8594,2014,91204
201,38138,18434,19704,2014,91205
202,33706,16060,17646,2014,91206
203,10334,5183,5151,2014,91207
204,16548,7795,8753,2014,91208
205,614,345,269,2014,91210
206,31078,14798,16280,2014,91214
207,26439,13333,13106,2014,91301
208,25165,11856,13309,2014,91302
209,27827,14219,13608,2014,91303
210,53517,25835,27682,2014,91304
211,48707,25285,23422,2014,91306
212,25597,12968,12629,2014,91307
213,37769,18332,19437,2014,91311
214,28190,13213,14977,2014,91316
215,44958,22607,22351,2014,91320
216,34576,17731,16845,2014,91321
217,29178,14632,14546,2014,91324
218,32823,16790,16033,2014,91325
219,36024,17398,18626,2014,91326
220,2708,1124,1584,2014,91330
221,102367,50898,51469,2014,91331
222,77952,37834,40118,2014,91335
223,35455,18357,17098,2014,91340
224,91701,45481,46220,2014,91342
225,61976,31564,30412,2014,91343
226,53165,26184,26981,2014,91344
227,18196,8710,9486,2014,91345
228,35826,17811,18015,2014,91350
229,32433,15992,16441,2014,91351
230,46874,23140,23734,2014,91352
231,29034,14603,14431,2014,91354
232,33635,16492,17143,2014,91355
233,29847,14407,15440,2014,91356
234,44208,20863,23345,2014,91360
235,20266,9953,10313,2014,91361
236,35564,17349,18215,2014,91362
237,26975,13388,13587,2014,91364
238,42029,20969,21060,2014,91367
239,0,0,0,2014,91371
240,14512,6956,7556,2014,91377
241,20296,9969,10327,2014,91381
242,28949,17691,11258,2014,91384
243,42518,20996,21522,2014,91387
244,19691,9901,9790,2014,91390
245,40503,20381,20122,2014,91401
246,70781,34897,35884,2014,91402
247,24353,11974,12379,2014,91403
248,53406,26451,26955,2014,91405
249,53528,27164,26364,2014,91406
250,24146,12302,11844,2014,91411
251,32130,15569,16561,2014,91423
252,14563,6933,7630,2014,91436
253,19829,9292,10537,2014,91501
254,12605,5822,6783,2014,91502
255,25544,11977,13567,2014,91504
256,31133,15071,16062,2014,91505
257,18428,9113,9315,2014,91506
258,38781,20160,18621,2014,91601
259,18315,8882,9433,2014,91602
260,29072,13906,15166,2014,91604
261,56060,27599,28461,2014,91605
262,45467,22866,22601,2014,91606
263,29591,14225,15366,2014,91607
264,0,0,0,2014,91608
265,40822,20440,20382,2014,91701
266,60475,29719,30756,2014,91702
267,77692,38798,38894,2014,91706
268,3447,925,2522,2014,91708
269,76187,37918,38269,2014,91709
270,83042,45336,37706,2014,91710
271,36484,17482,19002,2014,91711
272,36352,17974,18378,2014,91722
273,20010,9847,10163,2014,91723
274,25405,12641,12764,2014,91724
275,66979,32962,34017,2014,91730
276,29209,14911,14298,2014,91731
277,63849,31276,32573,2014,91732
278,43790,21684,22106,2014,91733
279,24759,11861,12898,2014,91737
280,38009,19282,18727,2014,91739
281,26324,12880,13444,2014,91740
282,25678,12770,12908,2014,91741
283,87096,43637,43459,2014,91744
284,55237,26358,28879,2014,91745
285,29420,14221,15199,2014,91746
286,47859,23826,24033,2014,91748
287,33969,17039,16930,2014,91750
288,28649,14322,14327,2014,91752
289,33622,16273,17349,2014,91754
290,27305,13110,14195,2014,91755
291,369,188,181,2014,91759
292,59892,28840,31052,2014,91761
293,56148,27991,28157,2014,91762
294,37432,18590,18842,2014,91763
295,54078,26511,27567,2014,91764
296,47562,23329,24233,2014,91765
297,71851,35333,36518,2014,91766
298,49027,24047,24980,2014,91767
299,36454,18038,18416,2014,91768
300,63119,30525,32594,2014,91770
301,33869,16158,17711,2014,91773
302,25395,12428,12967,2014,91775
303,37378,17856,19522,2014,91776
304,35274,16439,18835,2014,91780
305,26034,12458,13576,2014,91784
306,52152,24020,28132,2014,91786
307,43369,21706,21663,2014,91789
308,46059,21785,24274,2014,91790
309,33174,15438,17736,2014,91791
310,30102,14795,15307,2014,91792
311,53792,25789,28003,2014,91801
312,30586,14943,15643,2014,91803
313,18184,9080,9104,2014,91901
314,19504,9717,9787,2014,91902
315,1370,749,621,2014,91905
316,3644,1981,1663,2014,91906
317,76797,38112,38685,2014,91910
318,83710,40926,42784,2014,91911
319,43655,21015,22640,2014,91913
320,16926,7584,9342,2014,91914
321,27290,12999,14291,2014,91915
322,1580,811,769,2014,91916
323,896,417,479,2014,91917
324,331,183,148,2014,91931
325,26257,13082,13175,2014,91932
326,293,202,91,2014,91934
327,8426,4251,4175,2014,91935
328,33474,16476,16998,2014,91941
329,39438,18711,20727,2014,91942
330,26027,12792,13235,2014,91945
331,47,15,32,2014,91948
332,61262,30898,30364,2014,91950
333,1722,892,830,2014,91962
334,1043,557,486,2014,91963
335,59481,29909,29572,2014,91977
336,9812,4728,5084,2014,91978
337,631,349,282,2014,91980
338,4306,2172,2134,2014,92003
339,2624,1466,1158,2014,92004
340,11782,5728,6054,2014,92007
341,26464,13405,13059,2014,92008
342,43627,21809,21818,2014,92009
343,15283,7884,7399,2014,92010
344,23883,11877,12006,2014,92011
345,13525,6808,6717,2014,92014
346,44357,22264,22093,2014,92019
347,58305,29137,29168,2014,92020
348,66854,32943,33911,2014,92021
349,49226,24417,24809,2014,92024
350,49734,24990,24744,2014,92025
351,49981,24395,25586,2014,92026
352,56892,27891,29001,2014,92027
353,48335,24300,24035,2014,92028
354,19528,9944,9584,2014,92029
355,2977,1418,1559,2014,92036
356,39241,18639,20602,2014,92037
357,42323,20807,21516,2014,92040
358,42992,22381,20611,2014,92054
359,12725,11850,875,2014,92055
360,52758,26654,26104,2014,92056
361,55618,27873,27745,2014,92057
362,45685,24132,21553,2014,92058
363,1450,731,719,2014,92059
364,61,31,30,2014,92060
365,1824,1020,804,2014,92061
366,49079,24063,25016,2014,92064
367,36039,18124,17915,2014,92065
368,273,143,130,2014,92066
369,9020,4253,4767,2014,92067
370,47130,23021,24109,2014,92069
371,1193,595,598,2014,92070
372,55362,26547,28815,2014,92071
373,12437,6026,6411,2014,92075
374,45926,21435,24491,2014,92078
375,28843,14094,14749,2014,92081
376,19825,9870,9955,2014,92082
377,36604,18762,17842,2014,92083
378,48275,23780,24495,2014,92084
379,1335,648,687,2014,92086
380,1433,642,791,2014,92091
381,35893,21265,14628,2014,92101
382,44893,22817,22076,2014,92102
383,31927,16941,14986,2014,92103
384,44590,22449,22141,2014,92104
385,71334,35116,36218,2014,92105
386,19539,9914,9625,2014,92106
387,26947,13574,13373,2014,92107
388,19245,10033,9212,2014,92108
389,45304,24066,21238,2014,92109
390,28006,14247,13759,2014,92110
391,47590,23713,23877,2014,92111
392,57580,30604,26976,2014,92113
393,69305,34160,35145,2014,92114
394,61718,31252,30466,2014,92115
395,32943,17357,15586,2014,92116
396,53205,27293,25912,2014,92117
397,22664,11343,11321,2014,92118
398,23926,10920,13006,2014,92119
399,25365,12603,12762,2014,92120
400,4832,2813,2019,2014,92121
401,44602,22413,22189,2014,92122
402,29240,14918,14322,2014,92123
403,30196,14579,15617,2014,92124
404,78201,40809,37392,2014,92126
405,41900,20098,21802,2014,92127
406,49264,22636,26628,2014,92128
407,54664,27083,27581,2014,92129
408,50280,24672,25608,2014,92130
409,33868,15952,17916,2014,92131
410,0,0,0,2014,92132
411,151,131,20,2014,92134
412,955,767,188,2014,92135
413,37450,18108,19342,2014,92139
414,2594,2461,133,2014,92140
415,1968,957,1011,2014,92145
416,562,464,98,2014,92147
417,86740,44260,42480,2014,92154
418,714,706,8,2014,92155
419,31518,15171,16347,2014,92173
420,63915,31507,32408,2014,92201
421,27466,13436,14030,2014,92203
422,4839,2452,2387,2014,92210
423,24564,11637,12927,2014,92211
424,32793,15712,17081,2014,92220
425,0,0,0,2014,92222
426,46719,22886,23833,2014,92223
427,23509,15259,8250,2014,92225
428,26818,13076,13742,2014,92227
429,3297,1628,1669,2014,92230
430,39675,18634,21041,2014,92231
431,10460,7286,3174,2014,92233
432,52534,27341,25193,2014,92234
433,43037,21687,21350,2014,92236
434,428,324,104,2014,92239
435,35878,17931,17947,2014,92240
436,9156,4573,4583,2014,92241
437,1235,583,652,2014,92242
438,48615,23908,24707,2014,92243
439,7147,3535,3612,2014,92249
440,8461,4487,3974,2014,92250
441,22348,12939,9409,2014,92251
442,9228,4744,4484,2014,92252
443,38462,18689,19773,2014,92253
444,12300,6218,6082,2014,92254
445,3631,1755,1876,2014,92256
446,1757,918,839,2014,92257
447,520,275,245,2014,92258
448,269,139,130,2014,92259
449,32855,14750,18105,2014,92260
450,26693,14762,11931,2014,92262
451,19754,11353,8401,2014,92264
452,62,45,17,2014,92266
453,0,0,0,2014,92267
454,605,287,318,2014,92268
455,17634,8639,8995,2014,92270
456,1228,558,670,2014,92273
457,18937,10603,8334,2014,92274
458,1413,735,678,2014,92275
459,7921,3681,4240,2014,92276
460,24112,11637,12475,2014,92277
461,4156,3762,394,2014,92278
462,15,15,0,2014,92280
463,1960,927,1033,2014,92281
464,783,370,413,2014,92282
465,2334,1175,1159,2014,92283
466,25045,12376,12669,2014,92284
467,2731,1427,1304,2014,92285
468,32667,16959,15708,2014,92301
469,17,17,0,2014,92304
470,321,194,127,2014,92305
471,38204,19053,19151,2014,92307
472,39953,19056,20897,2014,92308
473,916,499,417,2014,92309
474,9191,5214,3977,2014,92310
475,32831,16469,16362,2014,92311
476,12252,5804,6448,2014,92313
477,10572,5010,5562,2014,92314
478,5236,2336,2900,2014,92315
479,31720,16060,15660,2014,92316
480,8097,3978,4119,2014,92320
481,1244,691,553,2014,92321
482,911,417,494,2014,92322
483,58013,28954,29059,2014,92324
484,8318,4273,4045,2014,92325
485,1202,559,643,2014,92327
486,281,136,145,2014,92328
487,7,7,0,2014,92332
488,640,327,313,2014,92333
489,99580,50052,49528,2014,92335
490,91510,45267,46243,2014,92336
491,37844,18609,19235,2014,92337
492,0,0,0,2014,92338
493,997,487,510,2014,92339
494,294,135,159,2014,92341
495,6303,3276,3027,2014,92342
496,21392,10751,10641,2014,92344
497,81049,40409,40640,2014,92345
498,58845,30006,28839,2014,92346
499,1554,724,830,2014,92347
500,6783,3160,3623,2014,92352
501,21555,10497,11058,2014,92354
502,6293,3246,3047,2014,92356
503,1127,571,556,2014,92358
504,8298,3857,4441,2014,92359
505,5355,2572,2783,2014,92363
506,30,22,8,2014,92364
507,1953,904,1049,2014,92365
508,1064,526,538,2014,92368
509,14729,8086,6643,2014,92371
510,5929,3081,2848,2014,92372
511,34017,16622,17395,2014,92373
512,40911,19866,21045,2014,92374
513,85647,42834,42813,2014,92376
514,19750,9537,10213,2014,92377
515,166,68,98,2014,92378
516,5161,2560,2601,2014,92382
517,34,23,11,2014,92384
518,269,135,134,2014,92385
519,1949,891,1058,2014,92386
520,115,58,57,2014,92389
521,3001,1629,1372,2014,92391
522,56461,27095,29366,2014,92392
523,34479,18101,16378,2014,92394
524,42481,19710,22771,2014,92395
525,4616,2324,2292,2014,92397
526,1165,604,561,2014,92398
527,54056,27454,26602,2014,92399
528,2104,941,1163,2014,92401
529,60501,29900,30601,2014,92404
530,29526,14659,14867,2014,92405
531,60118,29572,30546,2014,92407
532,15318,7812,7506,2014,92408
533,47510,23614,23896,2014,92410
534,26364,12326,14038,2014,92411
535,22216,11580,10636,2014,92501
536,92959,46293,46666,2014,92503
537,53960,27383,26577,2014,92504
538,49064,24318,24746,2014,92505
539,45993,22467,23526,2014,92506
540,55156,27425,27731,2014,92507
541,36583,17795,18788,2014,92508
542,78221,39512,38709,2014,92509
543,1129,649,480,2014,92518
544,51816,26217,25599,2014,92530
545,21260,10086,11174,2014,92532
546,2750,1336,1414,2014,92536
547,3890,1720,2170,2014,92539
548,34680,16459,18221,2014,92543
549,47136,23328,23808,2014,92544
550,41078,19385,21693,2014,92545
551,7020,3592,3428,2014,92548
552,2652,1370,1282,2014,92549
553,33050,15663,17387,2014,92551
554,73803,36029,37774,2014,92553
555,40419,19320,21099,2014,92555
556,51871,25401,26470,2014,92557
557,1600,779,821,2014,92561
558,63293,30387,32906,2014,92562
559,57605,28492,29113,2014,92563
560,9469,4815,4654,2014,92567
561,56766,28341,28425,2014,92570
562,54825,26897,27928,2014,92571
563,16200,7748,8452,2014,92582
564,31167,15011,16156,2014,92583
565,46346,22614,23732,2014,92584
566,20148,10020,10128,2014,92585
567,19384,8748,10636,2014,92586
568,16787,8175,8612,2014,92587
569,3841,1845,1996,2014,92590
570,39767,19426,20341,2014,92591
571,74558,37359,37199,2014,92592
572,31139,15909,15230,2014,92595
573,26044,13332,12712,2014,92596
574,23529,11694,11835,2014,92602
575,20173,9793,10380,2014,92603
576,28425,13937,14488,2014,92604
577,22294,10798,11496,2014,92606
578,11799,5790,6009,2014,92610
579,29325,14623,14702,2014,92612
580,25657,12111,13546,2014,92614
581,15805,7583,8222,2014,92617
582,21345,11550,9795,2014,92618
583,43802,21307,22495,2014,92620
584,6450,3441,3009,2014,92624
585,12572,5921,6651,2014,92625
586,51575,25931,25644,2014,92626
587,60806,31121,29685,2014,92627
588,26955,12935,14020,2014,92629
589,59657,29458,30199,2014,92630
590,16284,5749,10535,2014,92637
591,55505,26631,28874,2014,92646
592,59741,29497,30244,2014,92647
593,46623,23179,23444,2014,92648
594,32976,16511,16465,2014,92649
595,23668,11810,11858,2014,92651
596,28853,14354,14499,2014,92653
597,9139,4483,4656,2014,92655
598,51370,24306,27064,2014,92656
599,9751,4936,4815,2014,92657
600,35308,17680,17628,2014,92660
601,3152,1654,1498,2014,92661
602,3018,1381,1637,2014,92662
603,22772,11783,10989,2014,92663
604,35041,17204,17837,2014,92672
605,29875,15088,14787,2014,92673
606,35596,17566,18030,2014,92675
607,2033,1135,898,2014,92676
608,64642,31090,33552,2014,92677
609,427,209,218,2014,92678
610,32822,15959,16863,2014,92679
611,91204,45384,45820,2014,92683
612,45074,22766,22308,2014,92688
613,48129,23430,24699,2014,92691
614,48967,24212,24755,2014,92692
615,24568,12000,12568,2014,92694
616,52588,26416,26172,2014,92701
617,69890,35883,34007,2014,92703
618,87121,43962,43159,2014,92704
619,46163,22080,24083,2014,92705
620,36585,18640,17945,2014,92706
621,63595,31420,32175,2014,92707
622,57441,28472,28969,2014,92708
623,60438,29614,30824,2014,92780
624,22583,11118,11465,2014,92782
625,63883,31633,32250,2014,92801
626,43743,21890,21853,2014,92802
627,85969,41975,43994,2014,92804
628,70839,36763,34076,2014,92805
629,39616,19613,20003,2014,92806
630,36323,17777,18546,2014,92807
631,20137,9943,10194,2014,92808
632,37580,17944,19636,2014,92821
633,2960,1420,1540,2014,92823
634,35316,16899,18417,2014,92831
635,25247,12818,12429,2014,92832
636,53309,26244,27065,2014,92833
637,23378,11261,12117,2014,92835
638,56291,28809,27482,2014,92840
639,32839,16461,16378,2014,92841
640,44468,22133,22335,2014,92843
641,24314,12118,12196,2014,92844
642,17202,8271,8931,2014,92845
643,27304,14930,12374,2014,92860
644,5911,3003,2908,2014,92861
645,19715,10041,9674,2014,92865
646,15473,7604,7869,2014,92866
647,44569,21825,22744,2014,92867
648,27353,14944,12409,2014,92868
649,37390,18487,18903,2014,92869
650,53474,26462,27012,2014,92870
651,48654,24092,24562,2014,92879
652,61187,30526,30661,2014,92880
653,32817,16887,15930,2014,92881
654,70188,35362,34826,2014,92882
655,31940,15502,16438,2014,92883
656,48649,24616,24033,2014,92886
657,20071,9975,10096,2014,92887
658,32360,16069,16291,2014,93001
659,51454,25083,26371,2014,93003
660,30417,15299,15118,2014,93004
661,43234,21050,22184,2014,93010
662,35366,16555,18811,2014,93012
663,15944,7549,8395,2014,93013
664,17423,8771,8652,2014,93015
665,36407,17839,18568,2014,93021
666,7069,3662,3407,2014,93022
667,20603,10040,10563,2014,93023
668,61215,31492,29723,2014,93030
669,82263,42274,39989,2014,93033
670,26966,13464,13502,2014,93035
671,44277,21990,22287,2014,93036
672,2037,1054,983,2014,93040
673,23998,11759,12239,2014,93041
674,82,78,4,2014,93042
675,116,60,56,2014,93043
676,33836,17252,16584,2014,93060
677,56687,28065,28622,2014,93063
678,0,0,0,2014,93064
679,72273,35087,37186,2014,93065
680,3179,1743,1436,2014,93066
681,641,297,344,2014,93067
682,32860,17024,15836,2014,93101
683,20271,10533,9738,2014,93103
684,24967,11866,13101,2014,93105
685,12119,5506,6613,2014,93108
686,11031,5303,5728,2014,93109
687,17321,8807,8514,2014,93110
688,17554,8708,8846,2014,93111
689,55064,27900,27164,2014,93117
690,1173,622,551,2014,93201
691,3486,1687,1799,2014,93202
692,21784,11634,10150,2014,93203
693,14553,9818,4735,2014,93204
694,2065,867,1198,2014,93205
695,2196,1180,1016,2014,93206
696,263,128,135,2014,93207
697,125,63,62,2014,93208
698,21303,13074,8229,2014,93210
699,25204,17897,7307,2014,93212
700,56028,32140,23888,2014,93215
701,1009,492,517,2014,93218
702,10378,5128,5250,2014,93219
703,265,172,93,2014,93220
704,15391,7768,7623,2014,93221
705,1681,813,868,2014,93222
706,10759,5093,5666,2014,93223
707,429,224,205,2014,93224
708,5572,2740,2832,2014,93225
709,363,179,184,2014,93226
710,66316,33459,32857,2014,93230
711,6896,3342,3554,2014,93234
712,4044,2016,2028,2014,93235
713,1575,802,773,2014,93238
714,1950,973,977,2014,93239
715,5667,2780,2887,2014,93240
716,18474,9326,9148,2014,93241
717,3230,1617,1613,2014,93242
718,1720,747,973,2014,93243
719,340,175,165,2014,93244
720,37062,18951,18111,2014,93245
721,18932,9588,9344,2014,93247
722,2698,1486,1212,2014,93249
723,13925,7617,6308,2014,93250
724,229,142,87,2014,93251
725,3665,2865,800,2014,93252
726,700,328,372,2014,93254
727,598,240,358,2014,93255
728,6035,2998,3037,2014,93256
729,75390,37285,38105,2014,93257
730,2292,1224,1068,2014,93258
731,175,102,73,2014,93260
732,3248,1639,1609,2014,93261
733,59,30,29,2014,93262
734,20204,10314,9890,2014,93263
735,2892,1449,1443,2014,93265
736,1465,643,822,2014,93266
737,6962,3476,3486,2014,93267
738,16890,8559,8331,2014,93268
739,5519,2695,2824,2014,93270
740,2278,1213,1065,2014,93271
741,3438,1938,1500,2014,93272
742,71430,35120,36310,2014,93274
743,176,97,79,2014,93276
744,51849,25067,26782,2014,93277
745,27390,16703,10687,2014,93280
746,2313,1249,1064,2014,93283
747,2218,1185,1033,2014,93285
748,9942,4802,5140,2014,93286
749,141,80,61,2014,93287
750,54899,28122,26777,2014,93291
751,38825,20072,18753,2014,93292
752,11685,5627,6058,2014,93301
753,51607,25698,25909,2014,93304
754,37871,19844,18027,2014,93305
755,68910,33405,35505,2014,93306
756,84184,41307,42877,2014,93307
757,54132,26552,27580,2014,93308
758,60631,29877,30754,2014,93309
759,44358,21652,22706,2014,93311
760,56313,28448,27865,2014,93312
761,43644,22257,21387,2014,93313
762,23264,11995,11269,2014,93314
763,27920,13668,14252,2014,93401
764,14880,7298,7582,2014,93402
765,34833,21805,13028,2014,93405
766,0,0,0,2014,93410
767,30076,14753,15323,2014,93420
768,31899,16453,15446,2014,93422
769,853,398,455,2014,93424
770,1522,939,583,2014,93426
771,5279,2610,2669,2014,93427
772,6348,2988,3360,2014,93428
773,114,51,63,2014,93429
774,2735,1347,1388,2014,93430
775,798,444,354,2014,93432
776,13337,6375,6962,2014,93433
777,7178,3689,3489,2014,93434
778,55176,28372,26804,2014,93436
779,3464,1893,1571,2014,93437
780,1472,693,779,2014,93440
781,1195,630,565,2014,93441
782,10998,5445,5553,2014,93442
783,19578,9512,10066,2014,93444
784,7168,3434,3734,2014,93445
785,44288,21673,22615,2014,93446
786,7789,3718,4071,2014,93449
787,814,426,388,2014,93450
788,4187,2102,2085,2014,93451
789,721,468,253,2014,93452
790,3486,1668,1818,2014,93453
791,37362,18910,18452,2014,93454
792,42513,19986,22527,2014,93455
793,56514,29036,27478,2014,93458
794,4944,2554,2390,2014,93460
795,1661,948,713,2014,93461
796,8132,4217,3915,2014,93463
797,9652,4665,4987,2014,93465
798,5258,3017,2241,2014,93501
799,13232,6940,6292,2014,93505
800,7289,3831,3458,2014,93510
801,178,64,114,2014,93512
802,1584,828,756,2014,93513
803,14472,7209,7263,2014,93514
804,2271,1014,1257,2014,93516
805,796,359,437,2014,93517
806,986,486,500,2014,93518
807,97,62,35,2014,93519
808,18,5,13,2014,93522
809,3378,1697,1681,2014,93523
810,263,250,13,2014,93524
811,714,372,342,2014,93526
812,1914,947,967,2014,93527
813,79,49,30,2014,93528
814,589,506,83,2014,93529
815,28,12,16,2014,93530
816,338,169,169,2014,93531
817,2419,1135,1284,2014,93532
818,39120,18964,20156,2014,93534
819,73282,35154,38128,2014,93535
820,71313,38303,33010,2014,93536
821,651,282,369,2014,93541
822,13578,6930,6648,2014,93543
823,951,526,425,2014,93544
824,2099,1103,996,2014,93545
825,9408,4896,4512,2014,93546
826,334,170,164,2014,93549
827,74203,36490,37713,2014,93550
828,50572,24795,25777,2014,93551
829,42073,20742,21331,2014,93552
830,1975,997,978,2014,93553
831,128,78,50,2014,93554
832,32967,16501,16466,2014,93555
833,267,95,172,2014,93558
834,19189,9941,9248,2014,93560
835,34246,19510,14736,2014,93561
836,1781,937,844,2014,93562
837,375,209,166,2014,93563
838,6558,3512,3046,2014,93591
839,20,11,9,2014,93592
840,2457,1237,1220,2014,93601
841,4207,2235,1972,2014,93602
842,274,142,132,2014,93603
843,874,381,493,2014,93604
844,201,103,98,2014,93605
845,604,262,342,2014,93606
846,725,414,311,2014,93608
847,5843,3008,2835,2014,93609
848,24151,9062,15089,2014,93610
849,48597,23585,25012,2014,93611
850,34814,16994,17820,2014,93612
851,10865,5493,5372,2014,93614
852,5923,2947,2976,2014,93615
853,2126,1112,1014,2014,93616
854,29628,15724,13904,2014,93618
855,30409,14781,15628,2014,93619
856,10028,5189,4839,2014,93620
857,307,152,155,2014,93621
858,9747,5191,4556,2014,93622
859,58,22,36,2014,93623
860,1359,815,544,2014,93624
861,7068,3663,3405,2014,93625
862,813,439,374,2014,93626
863,85,46,39,2014,93627
864,266,99,167,2014,93628
865,18990,9597,9393,2014,93630
866,16844,8522,8322,2014,93631
867,0,0,0,2014,93633
868,15,11,4,2014,93634
869,39439,19574,19865,2014,93635
870,11919,5797,6122,2014,93636
871,40101,19617,20484,2014,93637
872,49761,25673,24088,2014,93638
873,12140,6510,5630,2014,93640
874,233,160,73,2014,93641
875,2724,1452,1272,2014,93643
876,7434,3727,3707,2014,93644
877,212,86,126,2014,93645
878,10716,5205,5511,2014,93646
879,11926,5960,5966,2014,93647
880,16102,8215,7887,2014,93648
881,3767,1856,1911,2014,93650
882,1569,769,800,2014,93651
883,288,160,128,2014,93652
884,1357,664,693,2014,93653
885,31575,16188,15387,2014,93654
886,7194,3753,3441,2014,93656
887,35653,17135,18518,2014,93657
888,4621,2299,2322,2014,93660
889,30700,15692,15008,2014,93662
890,703,411,292,2014,93664
891,612,384,228,2014,93665
892,683,276,407,2014,93666
893,2089,1198,891,2014,93667
894,1215,599,616,2014,93668
895,284,104,180,2014,93669
896,910,510,400,2014,93673
897,2808,1487,1321,2014,93675
898,10788,5553,5235,2014,93701
899,47850,24472,23378,2014,93702
900,34122,17574,16548,2014,93703
901,26009,12066,13943,2014,93704
902,38130,18074,20056,2014,93705
903,39794,20083,19711,2014,93706
904,33114,15622,17492,2014,93710
905,37630,18057,19573,2014,93711
906,46153,22060,24093,2014,93720
907,6308,3983,2325,2014,93721
908,80455,39651,40804,2014,93722
909,9271,4773,4498,2014,93723
910,26879,13327,13552,2014,93725
911,42618,20796,21822,2014,93726
912,73671,36905,36766,2014,93727
913,14711,7155,7556,2014,93728
914,10137,5014,5123,2014,93730
915,26438,13316,13122,2014,93901
916,60887,31855,29032,2014,93905
917,63529,30701,32828,2014,93906
918,21812,11231,10581,2014,93907
919,12350,6144,6206,2014,93908
920,839,532,307,2014,93920
921,3164,1393,1771,2014,93921
922,12954,6020,6934,2014,93923
923,5967,2709,3258,2014,93924
924,1672,876,796,2014,93925
925,9128,4572,4556,2014,93926
926,17697,8768,8929,2014,93927
927,362,229,133,2014,93928
928,16843,9330,7513,2014,93930
929,564,295,269,2014,93932
930,22696,11091,11605,2014,93933
931,33760,17367,16393,2014,93940
932,6,0,6,2014,93943
933,15365,7317,8048,2014,93950
934,4578,2158,2420,2014,93953
935,246,113,133,2014,93954
936,34084,16276,17808,2014,93955
937,27212,18715,8497,2014,93960
938,939,533,406,2014,93962
939,26679,13195,13484,2014,94002
940,4421,1967,2454,2014,94005
941,42223,20597,21626,2014,94010
942,48536,24127,24409,2014,94014
943,62941,30555,32386,2014,94015
944,18382,8989,9393,2014,94019
945,1483,675,808,2014,94020
946,211,90,121,2014,94021
947,19737,9601,10136,2014,94022
948,22573,10971,11602,2014,94024
949,40945,19641,21304,2014,94025
950,7230,3634,3596,2014,94027
951,6720,3322,3398,2014,94028
952,22203,10728,11475,2014,94030
953,2880,1391,1489,2014,94037
954,3435,1827,1608,2014,94038
955,33958,17626,16332,2014,94040
956,13551,7018,6533,2014,94041
957,29280,15340,13940,2014,94043
958,38416,18589,19827,2014,94044
959,1650,884,766,2014,94060
960,37667,18339,19328,2014,94061
961,27014,13409,13605,2014,94062
962,31881,16867,15014,2014,94063
963,11585,5457,6128,2014,94065
964,42100,21106,20994,2014,94066
965,29879,14638,15241,2014,94070
966,320,192,128,2014,94074
967,66002,32633,33369,2014,94080
968,23964,12239,11725,2014,94085
969,47051,24263,22788,2014,94086
970,55229,27532,27697,2014,94087
971,20476,10475,10001,2014,94089
972,28013,15939,12074,2014,94102
973,24108,14111,9997,2014,94103
974,223,122,101,2014,94104
975,6282,3552,2730,2014,94105
976,27792,14801,12991,2014,94107
977,13930,7020,6910,2014,94108
978,54768,28683,26085,2014,94109
979,71422,37527,33895,2014,94110
980,3477,1851,1626,2014,94111
981,83032,40955,42077,2014,94112
982,32229,19038,13191,2014,94114
983,34556,16529,18027,2014,94115
984,45552,21297,24255,2014,94116
985,42638,23114,19524,2014,94117
986,40102,18798,21304,2014,94118
987,42043,20368,21675,2014,94121
988,58547,28034,30513,2014,94122
989,25528,12173,13355,2014,94123
990,35201,17526,17675,2014,94124
991,19356,9838,9518,2014,94127
992,83,21,62,2014,94128
993,3334,1704,1630,2014,94129
994,3083,1652,1431,2014,94130
995,28370,15197,13173,2014,94131
996,31926,15511,16415,2014,94132
997,27662,13882,13780,2014,94133
998,40343,19147,21196,2014,94134
999,5530,3147,2383,2014,94158
1000,16927,8347,8580,2014,94301
1001,47159,23330,23829,2014,94303
1002,3688,1868,1820,2014,94304
1003,13538,7804,5734,2014,94305
1004,27094,13491,13603,2014,94306
1005,36838,18724,18114,2014,94401
1006,24306,11789,12517,2014,94402
1007,40032,19450,20582,2014,94403
1008,35045,17038,18007,2014,94404
1009,62571,30315,32256,2014,94501
1010,13192,6203,6989,2014,94502
1011,20116,9885,10231,2014,94503
1012,14353,7570,6783,2014,94505
1013,21896,10557,11339,2014,94506
1014,15973,8082,7891,2014,94507
1015,4118,2143,1975,2014,94508
1016,63351,30101,33250,2014,94509
1017,27515,13302,14213,2014,94510
1018,2158,1166,992,2014,94511
1019,214,28,186,2014,94512
1020,56929,28636,28293,2014,94513
1021,1174,640,534,2014,94514
1022,7314,3787,3527,2014,94515
1023,154,82,72,2014,94516
1024,12781,6466,6315,2014,94517
1025,26647,12936,13711,2014,94518
1026,19927,9931,9996,2014,94519
1027,38743,19881,18862,2014,94520
1028,41138,19802,21336,2014,94521
1029,34428,16415,18013,2014,94523
1030,3151,1389,1762,2014,94525
1031,32274,15284,16990,2014,94526
1032,915,468,447,2014,94528
1033,24301,11954,12347,2014,94530
1034,42587,21612,20975,2014,94531
1035,70634,34453,36181,2014,94533
1036,36499,17723,18776,2014,94534
1037,4543,2732,1811,2014,94535
1038,70696,34860,35836,2014,94536
1039,63850,31735,32115,2014,94538
1040,51459,25465,25994,2014,94539
1041,62738,29879,32859,2014,94541
1042,12498,5770,6728,2014,94542
1043,76508,38331,38177,2014,94544
1044,30936,15291,15645,2014,94545
1045,43448,20473,22975,2014,94546
1046,24622,11895,12727,2014,94547
1047,400,208,192,2014,94548
1048,28298,13568,14730,2014,94549
1049,48050,23952,24098,2014,94550
1050,39775,20165,19610,2014,94551
1051,15209,7986,7223,2014,94552
1052,48891,23837,25054,2014,94553
1053,35654,17876,17778,2014,94555
1054,15505,7427,8078,2014,94556
1055,67967,33687,34280,2014,94558
1056,27062,13768,13294,2014,94559
1057,43635,21659,21976,2014,94560
1058,38481,19226,19255,2014,94561
1059,18284,9209,9075,2014,94563
1060,18704,9038,9666,2014,94564
1061,87395,41951,45444,2014,94565
1062,42523,20849,21674,2014,94566
1063,730,363,367,2014,94567
1064,48097,24023,24074,2014,94568
1065,320,222,98,2014,94569
1066,8171,3757,4414,2014,94571
1067,9648,4571,5077,2014,94572
1068,142,84,58,2014,94573
1069,9300,4615,4685,2014,94574
1070,1274,556,718,2014,94575
1071,87,12,75,2014,94576
1072,45808,22154,23654,2014,94577
1073,38629,18607,20022,2014,94578
1074,21842,11594,10248,2014,94579
1075,29311,13849,15462,2014,94580
1076,39721,19581,20140,2014,94582
1077,35272,17485,17787,2014,94583
1078,29205,14754,14451,2014,94585
1079,984,504,480,2014,94586
1080,71675,35399,36276,2014,94587
1081,31910,15898,16012,2014,94588
1082,30811,14404,16407,2014,94589
1083,34859,16858,18001,2014,94590
1084,54530,26385,28145,2014,94591
1085,651,302,349,2014,94592
1086,16837,6647,10190,2014,94595
1087,20778,9717,11061,2014,94596
1088,20645,10316,10329,2014,94597
1089,26974,12629,14345,2014,94598
1090,3187,1383,1804,2014,94599
1091,49990,25988,24002,2014,94601
1092,29794,13987,15807,2014,94602
1093,32306,15760,16546,2014,94603
1094,43168,20450,22718,2014,94605
1095,37001,18188,18813,2014,94606
1096,24830,12028,12802,2014,94607
1097,26323,13053,13270,2014,94608
1098,22059,10517,11542,2014,94609
1099,29734,14080,15654,2014,94610
1100,37225,17914,19311,2014,94611
1101,14500,7588,6912,2014,94612
1102,842,145,697,2014,94613
1103,17007,7913,9094,2014,94618
1104,24146,11361,12785,2014,94619
1105,32269,15827,16442,2014,94621
1106,16868,8129,8739,2014,94702
1107,21421,10710,10711,2014,94703
1108,26334,12544,13790,2014,94704
1109,12790,6182,6608,2014,94705
1110,20206,9658,10548,2014,94706
1111,12402,5744,6658,2014,94707
1112,11143,5304,5839,2014,94708
1113,12030,6025,6005,2014,94709
1114,6439,3233,3206,2014,94710
1115,3059,1498,1561,2014,94720
1116,29269,14354,14915,2014,94801
1117,25998,12857,13141,2014,94803
1118,40941,19736,21205,2014,94804
1119,14329,6858,7471,2014,94805
1120,60101,29549,30552,2014,94806
1121,0,0,0,2014,94850
1122,42027,21253,20774,2014,94901
1123,30110,14505,15605,2014,94903
1124,12271,5678,6593,2014,94904
1125,12583,5805,6778,2014,94920
1126,492,203,289,2014,94922
1127,736,304,432,2014,94923
1128,1434,702,732,2014,94924
1129,9478,4445,5033,2014,94925
1130,42668,19577,23091,2014,94928
1131,82,27,55,2014,94929
1132,8756,4154,4602,2014,94930
1133,8570,4050,4520,2014,94931
1134,1069,533,536,2014,94933
1135,970,501,469,2014,94937
1136,884,375,509,2014,94938
1137,6935,3144,3791,2014,94939
1138,194,96,98,2014,94940
1139,30605,14655,15950,2014,94941
1140,17973,8540,9433,2014,94945
1141,682,333,349,2014,94946
1142,25969,12366,13603,2014,94947
1143,16386,8425,7961,2014,94949
1144,74,42,32,2014,94950
1145,4812,2252,2560,2014,94951
1146,35081,17028,18053,2014,94952
1147,36624,17830,18794,2014,94954
1148,1687,744,943,2014,94956
1149,1063,511,552,2014,94957
1150,15999,7416,8583,2014,94960
1151,461,215,246,2014,94963
1152,4478,4313,165,2014,94964
1153,11114,5244,5870,2014,94965
1154,495,215,280,2014,94970
1155,362,150,212,2014,94971
1156,39,18,21,2014,94972
1157,1831,964,867,2014,94973
1158,1660,816,844,2014,95002
1159,24383,11685,12698,2014,95003
1160,3886,1914,1972,2014,95004
1161,6615,3258,3357,2014,95005
1162,9162,4776,4386,2014,95006
1163,727,452,275,2014,95007
1164,45495,22505,22990,2014,95008
1165,9367,4705,4662,2014,95010
1166,10470,5092,5378,2014,95012
1167,32,18,14,2014,95013
1168,62478,30570,31908,2014,95014
1169,654,326,328,2014,95017
1170,7660,3677,3983,2014,95018
1171,7374,3671,3703,2014,95019
1172,59666,29786,29880,2014,95020
1173,50625,25296,25329,2014,95023
1174,13429,6641,6788,2014,95030
1175,25898,12992,12906,2014,95032
1176,9628,4873,4755,2014,95033
1177,69635,34522,35113,2014,95035
1178,46834,22970,23864,2014,95037
1179,1545,652,893,2014,95039
1180,146,101,45,2014,95041
1181,636,302,334,2014,95043
1182,3969,2078,1891,2014,95045
1183,6303,3092,3211,2014,95046
1184,37714,19800,17914,2014,95050
1185,54406,26798,27608,2014,95051
1186,2730,1443,1287,2014,95053
1187,23914,12249,11665,2014,95054
1188,47148,23513,23635,2014,95060
1189,36358,18094,18264,2014,95062
1190,8425,3797,4628,2014,95064
1191,8331,4172,4159,2014,95065
1192,15095,7616,7479,2014,95066
1193,31093,15228,15865,2014,95070
1194,10849,5529,5320,2014,95073
1195,330,156,174,2014,95075
1196,84587,42622,41965,2014,95076
1197,19239,10310,8929,2014,95110
1198,60907,30559,30348,2014,95111
1199,57503,30287,27216,2014,95112
1200,1163,620,543,2014,95113
1201,52597,26829,25768,2014,95116
1202,32074,16968,15106,2014,95117
1203,31579,15490,16089,2014,95118
1204,10595,5155,5440,2014,95119
1205,37673,18775,18898,2014,95120
1206,38603,19315,19288,2014,95121
1207,57564,28546,29018,2014,95122
1208,64602,31322,33280,2014,95123
1209,48505,24092,24413,2014,95124
1210,54696,26227,28469,2014,95125
1211,34618,17685,16933,2014,95126
1212,64498,33237,31261,2014,95127
1213,37026,19432,17594,2014,95128
1214,40530,20100,20430,2014,95129
1215,14559,7452,7107,2014,95130
1216,29660,15164,14496,2014,95131
1217,41222,20455,20767,2014,95132
1218,27381,13734,13647,2014,95133
1219,16811,8782,8029,2014,95134
1220,21349,10106,11243,2014,95135
1221,41852,20544,21308,2014,95136
1222,19136,9388,9748,2014,95138
1223,6632,3215,3417,2014,95139
1224,233,128,105,2014,95140
1225,46993,23188,23805,2014,95148
1226,5409,2673,2736,2014,95202
1227,15711,8220,7491,2014,95203
1228,29246,14005,15241,2014,95204
1229,36928,18875,18053,2014,95205
1230,65324,32940,32384,2014,95206
1231,48748,22304,26444,2014,95207
1232,41459,19750,21709,2014,95209
1233,40820,19797,21023,2014,95210
1234,1814,739,1075,2014,95211
1235,25244,12683,12561,2014,95212
1236,23764,12393,11371,2014,95215
1237,28354,13766,14588,2014,95219
1238,7501,3850,3651,2014,95220
1239,5228,2420,2808,2014,95222
1240,3042,1547,1495,2014,95223
1241,266,147,119,2014,95224
1242,570,200,370,2014,95225
1243,295,164,131,2014,95226
1244,938,420,518,2014,95227
1245,4576,2460,2116,2014,95228
1246,635,239,396,2014,95230
1247,4961,3231,1730,2014,95231
1248,217,94,123,2014,95232
1249,591,254,337,2014,95233
1250,261,185,76,2014,95234
1251,3829,1895,1934,2014,95236
1252,2999,1645,1354,2014,95237
1253,47297,23592,23705,2014,95240
1254,26187,12765,13422,2014,95242
1255,2064,1066,998,2014,95245
1256,1258,601,657,2014,95246
1257,4689,2042,2647,2014,95247
1258,178,57,121,2014,95248
1259,3796,2130,1666,2014,95249
1260,65,31,34,2014,95250
1261,874,447,427,2014,95251
1262,14143,7092,7051,2014,95252
1263,682,370,312,2014,95254
1264,1991,990,1001,2014,95255
1265,385,138,247,2014,95257
1266,3973,2112,1861,2014,95258
1267,38007,18994,19013,2014,95301
1268,1019,528,491,2014,95303
1269,17971,10514,7457,2014,95304
1270,53,37,16,2014,95305
1271,952,524,428,2014,95306
1272,42470,21548,20922,2014,95307
1273,1934,902,1032,2014,95310
1274,2073,1028,1045,2014,95311
1275,276,157,119,2014,95312
1276,1006,530,476,2014,95313
1277,0,0,0,2014,95314
1278,12381,6181,6200,2014,95315
1279,6733,3110,3623,2014,95316
1280,1033,617,416,2014,95317
1281,601,297,304,2014,95318
1282,1581,803,778,2014,95319
1283,12739,6516,6223,2014,95320
1284,3461,1825,1636,2014,95321
1285,8727,4721,4006,2014,95322
1286,998,548,450,2014,95323
1287,7733,3894,3839,2014,95324
1288,61,46,15,2014,95325
1289,9487,4353,5134,2014,95326
1290,8679,5838,2841,2014,95327
1291,4717,2423,2294,2014,95328
1292,2654,1311,1343,2014,95329
1293,17702,8683,9019,2014,95330
1294,3064,1565,1499,2014,95333
1295,16330,8228,8102,2014,95334
1296,613,282,331,2014,95335
1297,46433,22667,23766,2014,95336
1298,31399,15207,16192,2014,95337
1299,11075,5400,5675,2014,95338
1300,34745,16628,18117,2014,95340
1301,33744,17779,15965,2014,95341
1302,448,228,220,2014,95345
1303,1541,804,737,2014,95346
1304,31387,15503,15884,2014,95348
1305,50676,24082,26594,2014,95350
1306,48437,23964,24473,2014,95351
1307,24356,11992,12364,2014,95354
1308,59955,28199,31756,2014,95355
1309,32794,15784,17010,2014,95356
1310,11353,5669,5684,2014,95357
1311,31709,16630,15079,2014,95358
1312,11756,5887,5869,2014,95360
1313,32544,16432,16112,2014,95361
1314,26087,13464,12623,2014,95363
1315,0,0,0,2014,95364
1316,4796,2582,2214,2014,95365
1317,16734,7971,8763,2014,95366
1318,24045,11868,12177,2014,95367
1319,14474,7546,6928,2014,95368
1320,977,447,530,2014,95369
1321,26904,13252,13652,2014,95370
1322,1969,976,993,2014,95372
1323,1847,1005,842,2014,95374
1324,228,87,141,2014,95375
1325,49398,25155,24243,2014,95376
1326,32453,16586,15867,2014,95377
1327,3837,1764,2073,2014,95379
1328,41069,20327,20742,2014,95380
1329,37163,18661,18502,2014,95382
1330,3728,1920,1808,2014,95383
1331,515,292,223,2014,95385
1332,10066,5161,4905,2014,95386
1333,768,394,374,2014,95387
1334,14410,7397,7013,2014,95388
1335,1312,883,429,2014,95389
1336,12359,5994,6365,2014,95391
1337,38604,18541,20063,2014,95401
1338,44918,22853,22065,2014,95403
1339,40253,20071,20182,2014,95404
1340,21516,10451,11065,2014,95405
1341,40657,21364,19293,2014,95407
1342,25784,12039,13745,2014,95409
1343,886,410,476,2014,95410
1344,352,185,167,2014,95412
1345,1591,932,659,2014,95415
1346,170,63,107,2014,95417
1347,442,205,237,2014,95420
1348,1537,754,783,2014,95421
1349,15453,7899,7554,2014,95422
1350,3040,1657,1383,2014,95423
1351,10699,5141,5558,2014,95425
1352,1659,900,759,2014,95426
1353,227,133,94,2014,95427
1354,2491,1298,1193,2014,95428
1355,77,47,30,2014,95429
1356,0,0,0,2014,95430
1357,511,310,201,2014,95431
1358,348,133,215,2014,95432
1359,355,200,155,2014,95435
1360,5582,2975,2607,2014,95436
1361,14351,7241,7110,2014,95437
1362,566,285,281,2014,95439
1363,1989,1084,905,2014,95441
1364,3154,1602,1552,2014,95442
1365,268,145,123,2014,95443
1366,774,314,460,2014,95444
1367,1522,810,712,2014,95445
1368,4419,2419,2000,2014,95446
1369,17078,8350,8728,2014,95448
1370,1583,896,687,2014,95449
1371,228,128,100,2014,95450
1372,12035,5903,6132,2014,95451
1373,1314,659,655,2014,95452
1374,10345,4919,5426,2014,95453
1375,2135,1115,1020,2014,95454
1376,600,213,387,2014,95456
1377,3331,1592,1739,2014,95457
1378,3334,1651,1683,2014,95458
1379,596,290,306,2014,95459
1380,2338,1037,1301,2014,95460
1381,3318,1756,1562,2014,95461
1382,1216,600,616,2014,95462
1383,18,0,18,2014,95463
1384,2208,998,1210,2014,95464
1385,2328,1125,1203,2014,95465
1386,913,586,327,2014,95466
1387,6168,3189,2979,2014,95467
1388,1192,592,600,2014,95468
1389,1960,1009,951,2014,95469
1390,6874,3675,3199,2014,95470
1391,528,267,261,2014,95471
1392,29408,14542,14866,2014,95472
1393,38822,19207,19615,2014,95476
1394,33157,16144,17013,2014,95482
1395,2508,1415,1093,2014,95485
1396,54,25,29,2014,95486
1397,309,151,158,2014,95488
1398,12905,6482,6423,2014,95490
1399,29629,14459,15170,2014,95492
1400,187,75,112,2014,95493
1401,188,97,91,2014,95494
1402,983,435,548,2014,95497
1403,23769,11997,11772,2014,95501
1404,24900,12501,12399,2014,95503
1405,452,315,137,2014,95511
1406,170,63,107,2014,95514
1407,18496,9131,9365,2014,95519
1408,20769,9840,10929,2014,95521
1409,1902,1051,851,2014,95524
1410,1668,833,835,2014,95525
1411,237,126,111,2014,95526
1412,553,297,256,2014,95527
1413,1273,596,677,2014,95528
1414,24202,13689,10513,2014,95531
1415,3078,1543,1535,2014,95536
1416,130,105,25,2014,95537
1417,13012,6376,6636,2014,95540
1418,2718,1364,1354,2014,95542
1419,551,225,326,2014,95543
1420,99,63,36,2014,95545
1421,3434,1662,1772,2014,95546
1422,1347,623,724,2014,95547
1423,1459,881,578,2014,95548
1424,869,446,423,2014,95549
1425,269,180,89,2014,95550
1426,1826,1037,789,2014,95551
1427,587,291,296,2014,95552
1428,1173,542,631,2014,95553
1429,325,156,169,2014,95554
1430,329,165,164,2014,95555
1431,655,437,218,2014,95556
1432,360,214,146,2014,95558
1433,103,26,77,2014,95559
1434,1374,659,715,2014,95560
1435,3435,1697,1738,2014,95562
1436,559,281,278,2014,95563
1437,500,318,182,2014,95564
1438,1092,523,569,2014,95565
1439,1854,768,1086,2014,95567
1440,94,40,54,2014,95568
1441,277,189,88,2014,95569
1442,2083,1097,986,2014,95570
1443,152,96,56,2014,95571
1444,1433,855,578,2014,95573
1445,454,256,198,2014,95585
1446,128,69,59,2014,95587
1447,1226,722,504,2014,95589
1448,180,94,86,2014,95595
1449,161,87,74,2014,95601
1450,18498,9029,9469,2014,95602
1451,28652,14525,14127,2014,95603
1452,44,22,22,2014,95604
1453,14326,7191,7135,2014,95605
1454,35,16,19,2014,95606
1455,315,192,123,2014,95607
1456,60729,28955,31774,2014,95608
1457,43572,21886,21686,2014,95610
1458,1045,462,583,2014,95612
1459,4283,2164,2119,2014,95614
1460,1090,557,533,2014,95615
1461,48106,22634,25472,2014,95616
1462,27222,13711,13511,2014,95618
1463,4937,2521,2416,2014,95619
1464,21005,10432,10573,2014,95620
1465,41474,19232,22242,2014,95621
1466,4317,2072,2245,2014,95623
1467,63131,31312,31819,2014,95624
1468,200,73,127,2014,95625
1469,6335,3129,3206,2014,95626
1470,3498,1622,1876,2014,95627
1471,40767,20021,20746,2014,95628
1472,1002,432,570,2014,95629
1473,73356,39685,33671,2014,95630
1474,5910,3091,2819,2014,95631
1475,30064,13981,16083,2014,95632
1476,3247,1597,1650,2014,95633
1477,3143,1712,1431,2014,95634
1478,870,499,371,2014,95635
1479,771,406,365,2014,95636
1480,694,256,438,2014,95637
1481,2047,1069,978,2014,95638
1482,311,100,211,2014,95639
1483,10681,7207,3474,2014,95640
1484,1732,859,873,2014,95641
1485,6619,3095,3524,2014,95642
1486,2110,1070,1040,2014,95645
1487,98,50,48,2014,95646
1488,48869,23444,25425,2014,95648
1489,12255,5755,6500,2014,95650
1490,517,231,286,2014,95651
1491,1010,604,406,2014,95652
1492,565,294,271,2014,95653
1493,4592,2256,2336,2014,95655
1494,6261,3017,3244,2014,95658
1495,775,378,397,2014,95659
1496,33014,16671,16343,2014,95660
1497,30559,14829,15730,2014,95661
1498,31814,15452,16362,2014,95662
1499,2485,1114,1371,2014,95663
1500,1135,621,514,2014,95664
1501,4862,2565,2297,2014,95665
1502,5533,2626,2907,2014,95666
1503,36639,17860,18779,2014,95667
1504,752,420,332,2014,95668
1505,2676,1250,1426,2014,95669
1506,52886,25346,27540,2014,95670
1507,5166,2377,2789,2014,95672
1508,14773,7196,7577,2014,95673
1509,922,424,498,2014,95674
1510,309,148,161,2014,95675
1511,22808,10907,11901,2014,95677
1512,41929,20282,21647,2014,95678
1513,48,17,31,2014,95679
1514,260,140,120,2014,95680
1515,1475,901,574,2014,95681
1516,29972,14727,15245,2014,95682
1517,6555,3317,3238,2014,95683
1518,2980,1629,1351,2014,95684
1519,4278,2008,2270,2014,95685
1520,965,452,513,2014,95686
1521,65781,36016,29765,2014,95687
1522,35820,17992,17828,2014,95688
1523,904,447,457,2014,95689
1524,1932,928,1004,2014,95690
1525,35929,17518,18411,2014,95691
1526,4812,2463,2349,2014,95692
1527,5943,2883,3060,2014,95693
1528,9574,4633,4941,2014,95694
1529,38790,18924,19866,2014,95695
1530,554,325,229,2014,95697
1531,219,112,107,2014,95698
1532,148,93,55,2014,95699
1533,718,351,367,2014,95701
1534,1065,517,548,2014,95703
1535,4953,2423,2530,2014,95709
1536,9920,4913,5007,2014,95713
1537,284,146,138,2014,95714
1538,80,47,33,2014,95715
1539,199,98,101,2014,95717
1540,60,31,29,2014,95720
1541,13,13,0,2014,95721
1542,4524,2119,2405,2014,95722
1543,0,0,0,2014,95724
1544,8566,4111,4455,2014,95726
1545,495,241,254,2014,95728
1546,30,17,13,2014,95735
1547,250,128,122,2014,95736
1548,9780,4991,4789,2014,95742
1549,23715,12197,11518,2014,95746
1550,56415,26280,30135,2014,95747
1551,44638,23124,21514,2014,95757
1552,62099,29521,32578,2014,95758
1553,40603,20679,19924,2014,95762
1554,36391,17852,18539,2014,95765
1555,21827,11109,10718,2014,95776
1556,7131,3629,3502,2014,95811
1557,10076,6275,3801,2014,95814
1558,25772,12809,12963,2014,95815
1559,16845,8575,8270,2014,95816
1560,14472,6698,7774,2014,95817
1561,20135,9556,10579,2014,95818
1562,18374,8064,10310,2014,95819
1563,34529,16369,18160,2014,95820
1564,34439,16651,17788,2014,95821
1565,42907,20471,22436,2014,95822
1566,73641,35259,38382,2014,95823
1567,29781,15599,14182,2014,95824
1568,31083,13756,17327,2014,95825
1569,38378,18967,19411,2014,95826
1570,20294,9398,10896,2014,95827
1571,61490,30541,30949,2014,95828
1572,25786,12453,13333,2014,95829
1573,762,436,326,2014,95830
1574,41597,19836,21761,2014,95831
1575,11908,5827,6081,2014,95832
1576,39117,18482,20635,2014,95833
1577,23986,12035,11951,2014,95834
1578,39073,19873,19200,2014,95835
1579,289,135,154,2014,95837
1580,35935,17679,18256,2014,95838
1581,19361,8907,10454,2014,95841
1582,31671,15368,16303,2014,95842
1583,47172,22862,24310,2014,95843
1584,22698,11099,11599,2014,95864
1585,32742,16132,16610,2014,95901
1586,1772,1095,677,2014,95903
1587,115,24,91,2014,95910
1588,4550,2202,2348,2014,95912
1589,555,241,314,2014,95914
1590,58,28,30,2014,95915
1591,1291,753,538,2014,95916
1592,3508,1860,1648,2014,95917
1593,1805,968,837,2014,95918
1594,1529,810,719,2014,95919
1595,417,209,208,2014,95920
1596,595,335,260,2014,95922
1597,12,7,5,2014,95923
1598,83,47,36,2014,95925
1599,38276,19020,19256,2014,95926
1600,36081,16930,19151,2014,95928
1601,72,35,37,2014,95930
1602,7808,4126,3682,2014,95932
1603,504,268,236,2014,95934
1604,594,312,282,2014,95935
1605,244,145,99,2014,95936
1606,1133,555,578,2014,95937
1607,3936,2005,1931,2014,95938
1608,512,275,237,2014,95939
1609,505,254,251,2014,95941
1610,1098,605,493,2014,95942
1611,805,408,397,2014,95943
1612,12,12,0,2014,95944
1613,25223,12058,13165,2014,95945
1614,10206,4765,5441,2014,95946
1615,1663,747,916,2014,95947
1616,10349,5199,5150,2014,95948
1617,19640,9338,10302,2014,95949
1618,724,360,364,2014,95950
1619,2948,1473,1475,2014,95951
1620,10631,5217,5414,2014,95953
1621,12535,6356,6179,2014,95954
1622,1384,644,740,2014,95955
1623,459,274,185,2014,95956
1624,773,401,372,2014,95957
1625,17013,8760,8253,2014,95959
1626,974,492,482,2014,95960
1627,26979,13708,13271,2014,95961
1628,1285,685,600,2014,95962
1629,15018,7585,7433,2014,95963
1630,20599,10548,10051,2014,95965
1631,30916,15168,15748,2014,95966
1632,1438,637,801,2014,95968
1633,27443,13803,13640,2014,95969
1634,482,272,210,2014,95970
1635,5798,2858,2940,2014,95971
1636,33511,16617,16894,2014,95973
1637,0,0,0,2014,95974
1638,2072,1134,938,2014,95975
1639,1887,1127,760,2014,95977
1640,0,0,0,2014,95978
1641,685,374,311,2014,95979
1642,102,67,35,2014,95981
1643,3251,1594,1657,2014,95982
1644,440,229,211,2014,95983
1645,0,0,0,2014,95984
1646,17,0,17,2014,95986
1647,5979,3258,2721,2014,95987
1648,8913,4502,4411,2014,95988
1649,41212,20129,21083,2014,95991
1650,35847,18194,17653,2014,95993
1651,34469,16984,17485,2014,96001
1652,33202,16325,16877,2014,96002
1653,44398,21800,22598,2014,96003
1654,400,198,202,2014,96006
1655,22942,11085,11857,2014,96007
1656,1128,650,478,2014,96008
1657,329,160,169,2014,96009
1658,187,128,59,2014,96010
1659,155,85,70,2014,96011
1660,3881,1921,1960,2014,96013
1661,152,90,62,2014,96014
1662,814,438,376,2014,96015
1663,532,249,283,2014,96016
1664,234,128,106,2014,96017
1665,10129,4943,5186,2014,96019
1666,2246,1218,1028,2014,96020
1667,16121,8102,8019,2014,96021
1668,17488,8408,9080,2014,96022
1669,1339,647,692,2014,96023
1670,1163,551,612,2014,96024
1671,2102,1136,966,2014,96025
1672,2462,1273,1189,2014,96027
1673,1633,647,986,2014,96028
1674,165,94,71,2014,96029
1675,165,71,94,2014,96031
1676,2339,1303,1036,2014,96032
1677,526,293,233,2014,96033
1678,285,128,157,2014,96034
1679,3604,1915,1689,2014,96035
1680,220,96,124,2014,96037
1681,599,278,321,2014,96038
1682,1206,633,573,2014,96039
1683,229,119,110,2014,96040
1684,2795,1564,1231,2014,96041
1685,1040,541,499,2014,96044
1686,255,141,114,2014,96046
1687,775,403,372,2014,96047
1688,977,459,518,2014,96048
1689,90,52,38,2014,96049
1690,408,224,184,2014,96050
1691,1110,530,580,2014,96051
1692,1652,918,734,2014,96052
1693,294,166,128,2014,96054
1694,4097,2058,2039,2014,96055
1695,1407,710,697,2014,96056
1696,1332,667,665,2014,96057
1697,752,420,332,2014,96058
1698,711,402,309,2014,96059
1699,19,7,12,2014,96061
1700,1253,629,624,2014,96062
1701,222,124,98,2014,96063
1702,4762,2347,2415,2014,96064
1703,387,214,173,2014,96065
1704,6994,3278,3716,2014,96067
1705,135,92,43,2014,96068
1706,880,467,413,2014,96069
1707,77,35,42,2014,96071
1708,4502,2250,2252,2014,96073
1709,199,163,36,2014,96074
1710,308,209,99,2014,96075
1711,88,61,27,2014,96076
1712,27650,13414,14236,2014,96080
1713,530,229,301,2014,96084
1714,50,30,20,2014,96085
1715,379,202,177,2014,96086
1716,525,309,216,2014,96087
1717,4099,2166,1933,2014,96088
1718,397,184,213,2014,96090
1719,578,312,266,2014,96091
1720,277,140,137,2014,96092
1721,4006,1837,2169,2014,96093
1722,6370,3172,3198,2014,96094
1723,814,433,381,2014,96096
1724,9790,4712,5078,2014,96097
1725,5260,2642,2618,2014,96101
1726,1357,646,711,2014,96103
1727,548,266,282,2014,96104
1728,165,73,92,2014,96105
1729,275,138,137,2014,96106
1730,1077,665,412,2014,96107
1731,7,3,4,2014,96108
1732,731,375,356,2014,96109
1733,129,61,68,2014,96110
1734,69,35,34,2014,96111
1735,230,100,130,2014,96112
1736,2294,1837,457,2014,96113
1737,3315,1824,1491,2014,96114
1738,212,105,107,2014,96115
1739,162,93,69,2014,96116
1740,244,114,130,2014,96117
1741,1590,777,813,2014,96118
1742,71,39,32,2014,96119
1743,1091,616,475,2014,96120
1744,249,146,103,2014,96121
1745,4382,2215,2167,2014,96122
1746,36,16,20,2014,96123
1747,366,176,190,2014,96124
1748,285,115,170,2014,96125
1749,133,86,47,2014,96126
1750,758,422,336,2014,96128
1751,35,12,23,2014,96129
1752,21920,15187,6733,2014,96130
1753,103,54,49,2014,96132
1754,160,51,109,2014,96133
1755,2506,1285,1221,2014,96134
1756,0,0,0,2014,96135
1757,135,66,69,2014,96136
1758,3606,1974,1632,2014,96137
1759,1126,614,512,2014,96140
1760,669,368,301,2014,96141
1761,731,268,463,2014,96142
1762,3855,2264,1591,2014,96143
1763,3215,1770,1445,2014,96145
1764,823,412,411,2014,96146
1765,781,444,337,2014,96148
1766,28618,14812,13806,2014,96150
1767,0,0,0,2014,96155
1768,18475,9832,8643,2014,96161
1769,303,167,136,2014,97635
0,Estimate!!SEX AND AGE!!Total population,Estimate!!SEX AND AGE!!Total population!!Male,Estimate!!SEX AND AGE!!Total population!!Female,2013,Geographic Area Name
1,319,168,151,2013,89010
2,1892,1090,802,2013,89019
3,10281,5091,5190,2013,89060
4,4669,2464,2205,2013,89061
5,1687,893,794,2013,89439
6,54760,26926,27834,2013,90001
7,49475,23989,25486,2013,90002
8,66200,32356,33844,2013,90003
9,62760,31899,30861,2013,90004
10,39548,20735,18813,2013,90005
11,59498,30859,28639,2013,90006
12,43173,21471,21702,2013,90007
13,33280,14929,18351,2013,90008
14,4133,2155,1978,2013,90010
15,100882,50624,50258,2013,90011
16,29528,17916,11612,2013,90012
17,10256,6296,3960,2013,90013
18,6008,3714,2294,2013,90014
19,18358,9793,8565,2013,90015
20,47273,21911,25362,2013,90016
21,23755,12867,10888,2013,90017
22,48498,23033,25465,2013,90018
23,65408,31715,33693,2013,90019
24,39866,19866,20000,2013,90020
25,2940,2084,856,2013,90021
26,70147,34752,35395,2013,90022
27,45126,22610,22516,2013,90023
28,50964,23875,27089,2013,90024
29,43555,22073,21482,2013,90025
30,68726,35014,33712,2013,90026
31,45942,23142,22800,2013,90027
32,28151,15561,12590,2013,90028
33,40208,20893,19315,2013,90029
34,40052,19890,20162,2013,90031
35,47784,23412,24372,2013,90032
36,49049,24526,24523,2013,90033
37,58703,29229,29474,2013,90034
38,30999,14589,16410,2013,90035
39,36101,17825,18276,2013,90036
40,61845,30401,31444,2013,90037
41,29836,15001,14835,2013,90038
42,27049,14122,12927,2013,90039
43,12696,6335,6361,2013,90040
44,28203,13220,14983,2013,90041
45,60623,29653,30970,2013,90042
46,43527,19990,23537,2013,90043
47,87590,41812,45778,2013,90044
48,40272,19734,20538,2013,90045
49,50499,26451,24048,2013,90046
50,47533,21690,25843,2013,90047
51,21316,9956,11360,2013,90048
52,35310,16219,19091,2013,90049
53,8536,3680,4856,2013,90056
54,45392,24452,20940,2013,90057
55,2980,1528,1452,2013,90058
56,41831,19712,22119,2013,90059
57,27457,12823,14634,2013,90061
58,32450,15608,16842,2013,90062
59,54160,27229,26931,2013,90063
60,26103,12605,13498,2013,90064
61,45242,23508,21734,2013,90065
62,59031,29446,29585,2013,90066
63,2312,1031,1281,2013,90067
64,22043,12362,9681,2013,90068
65,20731,12305,8426,2013,90069
66,0,0,0,2013,90071
67,773,642,131,2013,90073
68,8506,3984,4522,2013,90077
69,0,0,0,2013,90079
70,3276,1512,1764,2013,90089
71,0,0,0,2013,90090
72,5852,2680,3172,2013,90094
73,0,0,0,2013,90095
74,101932,51794,50138,2013,90201
75,21548,10047,11501,2013,90210
76,7748,3339,4409,2013,90211
77,12510,5713,6797,2013,90212
78,49810,23622,26188,2013,90220
79,52446,25617,26829,2013,90221
80,31893,15446,16447,2013,90222
81,32335,15314,17021,2013,90230
82,15454,7652,7802,2013,90232
83,25411,12796,12615,2013,90240
84,43776,21773,22003,2013,90241
85,43147,21370,21777,2013,90242
86,16760,8654,8106,2013,90245
87,47361,22118,25243,2013,90247
88,9822,4920,4902,2013,90248
89,26800,12969,13831,2013,90249
90,93994,45623,48371,2013,90250
91,19605,10305,9300,2013,90254
92,76620,38335,38285,2013,90255
93,35508,17625,17883,2013,90260
94,70137,33545,36592,2013,90262
95,1899,826,1073,2013,90263
96,17630,8814,8816,2013,90265
97,35324,17419,17905,2013,90266
98,27527,13837,13690,2013,90270
99,22779,10900,11879,2013,90272
100,25339,12416,12923,2013,90274
101,42051,19976,22075,2013,90275
102,34635,17106,17529,2013,90277
103,40574,19133,21441,2013,90278
104,95000,46711,48289,2013,90280
105,7093,3290,3803,2013,90290
106,27253,14396,12857,2013,90291
107,21536,9944,11592,2013,90292
108,12403,6169,6234,2013,90293
109,36798,17862,18936,2013,90301
110,30502,13980,16522,2013,90302
111,26339,12863,13476,2013,90303
112,28101,14152,13949,2013,90304
113,14814,6474,8340,2013,90305
114,6821,3816,3005,2013,90401
115,11749,5797,5952,2013,90402
116,24864,11631,13233,2013,90403
117,20807,9617,11190,2013,90404
118,28560,13466,15094,2013,90405
119,42373,20525,21848,2013,90501
120,16947,8115,8832,2013,90502
121,46780,22576,24204,2013,90503
122,31633,15887,15746,2013,90504
123,36306,17125,19181,2013,90505
124,0,0,0,2013,90506
125,33145,16765,16380,2013,90601
126,25768,12440,13328,2013,90602
127,20083,9821,10262,2013,90603
128,40661,19779,20882,2013,90604
129,42017,20588,21429,2013,90605
130,32791,16085,16706,2013,90606
131,45266,21890,23376,2013,90620
132,35507,17621,17886,2013,90621
133,15689,7451,8238,2013,90623
134,48590,23328,25262,2013,90630
135,68065,33355,34710,2013,90631
136,49222,24113,25109,2013,90638
137,63016,30678,32338,2013,90640
138,105940,52844,53096,2013,90650
139,63310,30928,32382,2013,90660
140,15489,7764,7725,2013,90670
141,30261,15032,15229,2013,90680
142,16657,8529,8128,2013,90701
143,49526,23648,25878,2013,90703
144,3960,1948,2012,2013,90704
145,76989,37219,39770,2013,90706
146,26830,12708,14122,2013,90710
147,31710,15038,16672,2013,90712
148,27653,13817,13836,2013,90713
149,20953,10144,10809,2013,90715
150,14280,7027,7253,2013,90716
151,21459,10330,11129,2013,90717
152,22227,10541,11686,2013,90720
153,54468,27289,27179,2013,90723
154,61432,30648,30784,2013,90731
155,19651,8999,10652,2013,90732
156,24073,10798,13275,2013,90740
157,866,471,395,2013,90742
158,441,229,212,2013,90743
159,57358,28834,28524,2013,90744
160,58162,28626,29536,2013,90745
161,26276,12578,13698,2013,90746
162,0,0,0,2013,90747
163,11260,5545,5715,2013,90755
164,39297,20624,18673,2013,90802
165,30563,14718,15845,2013,90803
166,40472,20204,20268,2013,90804
167,92991,45335,47656,2013,90805
168,43176,21029,22147,2013,90806
169,32645,15936,16709,2013,90807
170,40016,20018,19998,2013,90808
171,36113,17774,18339,2013,90810
172,59178,30019,29159,2013,90813
173,18937,9490,9447,2013,90814
174,40966,19799,21167,2013,90815
175,176,141,35,2013,90822
176,0,0,0,2013,90831
177,37832,18341,19491,2013,91001
178,32271,15303,16968,2013,91006
179,33586,15745,17841,2013,91007
180,1217,556,661,2013,91008
181,24708,11821,12887,2013,91010
182,20590,10272,10318,2013,91011
183,41985,20158,21827,2013,91016
184,8585,4141,4444,2013,91020
185,10983,5182,5801,2013,91024
186,25747,12303,13444,2013,91030
187,19296,9680,9616,2013,91040
188,28725,13747,14978,2013,91042
189,176,29,147,2013,91046
190,21378,10139,11239,2013,91101
191,26984,13364,13620,2013,91103
192,37590,18614,18976,2013,91104
193,11401,5433,5968,2013,91105
194,24355,12569,11786,2013,91106
195,32415,16364,16051,2013,91107
196,13540,6506,7034,2013,91108
197,23272,11200,12072,2013,91201
198,22610,10484,12126,2013,91202
199,13213,6342,6871,2013,91203
200,15924,7515,8409,2013,91204
201,38504,18862,19642,2013,91205
202,33014,15648,17366,2013,91206
203,10435,5375,5060,2013,91207
204,15962,7677,8285,2013,91208
205,651,379,272,2013,91210
206,31653,15335,16318,2013,91214
207,26218,12969,13249,2013,91301
208,25070,12298,12772,2013,91302
209,26744,13573,13171,2013,91303
210,53194,25553,27641,2013,91304
211,47879,24592,23287,2013,91306
212,25496,12883,12613,2013,91307
213,38117,18515,19602,2013,91311
214,27736,13335,14401,2013,91316
215,45060,22745,22315,2013,91320
216,35243,18241,17002,2013,91321
217,27304,13355,13949,2013,91324
218,33121,16426,16695,2013,91325
219,35900,17122,18778,2013,91326
220,2138,890,1248,2013,91330
221,100535,50338,50197,2013,91331
222,76616,37496,39120,2013,91335
223,35161,17535,17626,2013,91340
224,89686,44709,44977,2013,91342
225,62321,31492,30829,2013,91343
226,52892,25996,26896,2013,91344
227,18254,8810,9444,2013,91345
228,35410,17857,17553,2013,91350
229,31773,16213,15560,2013,91351
230,46334,22986,23348,2013,91352
231,29487,14824,14663,2013,91354
232,32282,16192,16090,2013,91355
233,30090,14398,15692,2013,91356
234,43767,21022,22745,2013,91360
235,20631,10100,10531,2013,91361
236,35093,16917,18176,2013,91362
237,25971,12956,13015,2013,91364
238,40506,19801,20705,2013,91367
239,0,0,0,2013,91371
240,14564,6774,7790,2013,91377
241,19800,9940,9860,2013,91381
242,29189,18319,10870,2013,91384
243,41058,20388,20670,2013,91387
244,20875,10593,10282,2013,91390
245,39466,19801,19665,2013,91401
246,71486,35890,35596,2013,91402
247,23672,11718,11954,2013,91403
248,54435,27254,27181,2013,91405
249,52682,26282,26400,2013,91406
250,24546,12824,11722,2013,91411
251,31466,15169,16297,2013,91423
252,14147,6758,7389,2013,91436
253,20398,9585,10813,2013,91501
254,11420,5232,6188,2013,91502
255,25228,11765,13463,2013,91504
256,31636,15409,16227,2013,91505
257,18260,8889,9371,2013,91506
258,37807,19852,17955,2013,91601
259,17771,8706,9065,2013,91602
260,28468,13845,14623,2013,91604
261,55793,27707,28086,2013,91605
262,45788,22881,22907,2013,91606
263,28993,14468,14525,2013,91607
264,0,0,0,2013,91608
265,40270,19962,20308,2013,91701
266,60036,29482,30554,2013,91702
267,77192,38847,38345,2013,91706
268,3585,904,2681,2013,91708
269,75551,37240,38311,2013,91709
270,81596,43328,38268,2013,91710
271,36011,17012,18999,2013,91711
272,35370,17186,18184,2013,91722
273,19778,9553,10225,2013,91723
274,25407,12753,12654,2013,91724
275,66362,32587,33775,2013,91730
276,29744,15749,13995,2013,91731
277,62548,30921,31627,2013,91732
278,43593,21437,22156,2013,91733
279,24138,11568,12570,2013,91737
280,37242,18610,18632,2013,91739
281,25961,12439,13522,2013,91740
282,25540,12644,12896,2013,91741
283,84674,42681,41993,2013,91744
284,55776,26438,29338,2013,91745
285,28869,14190,14679,2013,91746
286,46966,23517,23449,2013,91748
287,34045,16760,17285,2013,91750
288,30073,15070,15003,2013,91752
289,33616,16476,17140,2013,91754
290,26945,12769,14176,2013,91755
291,363,180,183,2013,91759
292,58919,28636,30283,2013,91761
293,55982,26969,29013,2013,91762
294,37191,18926,18265,2013,91763
295,53688,26389,27299,2013,91764
296,47273,22842,24431,2013,91765
297,71541,34987,36554,2013,91766
298,48768,24209,24559,2013,91767
299,36142,17690,18452,2013,91768
300,62489,30159,32330,2013,91770
301,33441,15972,17469,2013,91773
302,25363,12509,12854,2013,91775
303,37246,18139,19107,2013,91776
304,34890,16400,18490,2013,91780
305,26464,12788,13676,2013,91784
306,51381,24413,26968,2013,91786
307,42609,21384,21225,2013,91789
308,46404,21997,24407,2013,91790
309,31796,14609,17187,2013,91791
310,30452,14859,15593,2013,91792
311,54176,26178,27998,2013,91801
312,29591,14254,15337,2013,91803
313,17123,8479,8644,2013,91901
314,18579,9215,9364,2013,91902
315,1099,540,559,2013,91905
316,4071,2084,1987,2013,91906
317,77320,38164,39156,2013,91910
318,81872,39032,42840,2013,91911
319,40954,19809,21145,2013,91913
320,17516,7781,9735,2013,91914
321,26271,12987,13284,2013,91915
322,1487,761,726,2013,91916
323,884,399,485,2013,91917
324,489,312,177,2013,91931
325,25827,13146,12681,2013,91932
326,239,170,69,2013,91934
327,8238,4193,4045,2013,91935
328,32413,15868,16545,2013,91941
329,38828,18419,20409,2013,91942
330,25719,12800,12919,2013,91945
331,45,15,30,2013,91948
332,60784,30927,29857,2013,91950
333,1377,717,660,2013,91962
334,1091,585,506,2013,91963
335,60542,30335,30207,2013,91977
336,9276,4533,4743,2013,91978
337,195,85,110,2013,91980
338,4157,2073,2084,2013,92003
339,2679,1497,1182,2013,92004
340,11273,5541,5732,2013,92007
341,26536,13412,13124,2013,92008
342,42649,21102,21547,2013,92009
343,14968,7611,7357,2013,92010
344,23120,11274,11846,2013,92011
345,13403,6799,6604,2013,92014
346,44406,22136,22270,2013,92019
347,57747,28474,29273,2013,92020
348,65175,32029,33146,2013,92021
349,49048,24186,24862,2013,92024
350,49110,24158,24952,2013,92025
351,49537,24404,25133,2013,92026
352,55461,27022,28439,2013,92027
353,47282,23980,23302,2013,92028
354,20198,10185,10013,2013,92029
355,2807,1382,1425,2013,92036
356,40114,19229,20885,2013,92037
357,41214,20111,21103,2013,92040
358,42751,22191,20560,2013,92054
359,12457,11747,710,2013,92055
360,52182,25932,26250,2013,92056
361,54901,27663,27238,2013,92057
362,45943,24300,21643,2013,92058
363,1374,666,708,2013,92059
364,74,29,45,2013,92060
365,2113,1053,1060,2013,92061
366,48622,24115,24507,2013,92064
367,37299,18975,18324,2013,92065
368,233,113,120,2013,92066
369,8068,3709,4359,2013,92067
370,46492,23033,23459,2013,92069
371,1165,601,564,2013,92070
372,54469,25768,28701,2013,92071
373,12345,6005,6340,2013,92075
374,44007,20333,23674,2013,92078
375,27785,13681,14104,2013,92081
376,20559,10153,10406,2013,92082
377,37282,18733,18549,2013,92083
378,46811,23311,23500,2013,92084
379,1343,640,703,2013,92086
380,1383,626,757,2013,92091
381,35914,21230,14684,2013,92101
382,43853,22632,21221,2013,92102
383,31064,16477,14587,2013,92103
384,45471,22718,22753,2013,92104
385,68469,33655,34814,2013,92105
386,20087,10228,9859,2013,92106
387,26535,13163,13372,2013,92107
388,18794,9513,9281,2013,92108
389,44012,23271,20741,2013,92109
390,27444,14200,13244,2013,92110
391,47271,23830,23441,2013,92111
392,58158,31759,26399,2013,92113
393,68160,33624,34536,2013,92114
394,61084,30675,30409,2013,92115
395,32218,16979,15239,2013,92116
396,52648,27024,25624,2013,92117
397,21247,10593,10654,2013,92118
398,22965,11017,11948,2013,92119
399,25131,12646,12485,2013,92120
400,4580,2613,1967,2013,92121
401,45556,22995,22561,2013,92122
402,28943,14719,14224,2013,92123
403,30742,15181,15561,2013,92124
404,77860,40716,37144,2013,92126
405,40246,19493,20753,2013,92127
406,49332,22829,26503,2013,92128
407,53387,26449,26938,2013,92129
408,48721,23719,25002,2013,92130
409,33672,16067,17605,2013,92131
410,0,0,0,2013,92132
411,101,89,12,2013,92134
412,688,561,127,2013,92135
413,36594,18138,18456,2013,92139
414,2514,2383,131,2013,92140
415,1529,751,778,2013,92145
416,514,391,123,2013,92147
417,84060,42972,41088,2013,92154
418,775,764,11,2013,92155
419,31031,15002,16029,2013,92173
420,62551,30707,31844,2013,92201
421,26183,12883,13300,2013,92203
422,4876,2391,2485,2013,92210
423,23729,11416,12313,2013,92211
424,32134,14983,17151,2013,92220
425,0,0,0,2013,92222
426,44458,22047,22411,2013,92223
427,23624,15671,7953,2013,92225
428,26438,13198,13240,2013,92227
429,2699,1397,1302,2013,92230
430,39245,18417,20828,2013,92231
431,10578,7322,3256,2013,92233
432,51927,26500,25427,2013,92234
433,41815,21123,20692,2013,92236
434,383,293,90,2013,92239
435,35078,17637,17441,2013,92240
436,9378,4541,4837,2013,92241
437,1313,643,670,2013,92242
438,48190,23514,24676,2013,92243
439,7103,3601,3502,2013,92249
440,8424,4430,3994,2013,92250
441,21858,12805,9053,2013,92251
442,10047,5214,4833,2013,92252
443,37750,18270,19480,2013,92253
444,11366,5519,5847,2013,92254
445,3664,1736,1928,2013,92256
446,1962,958,1004,2013,92257
447,397,137,260,2013,92258
448,366,202,164,2013,92259
449,32452,14418,18034,2013,92260
450,25852,14425,11427,2013,92262
451,20240,11422,8818,2013,92264
452,47,47,0,2013,92266
453,0,0,0,2013,92267
454,561,266,295,2013,92268
455,17456,8961,8495,2013,92270
456,1295,624,671,2013,92273
457,18780,10380,8400,2013,92274
458,1122,641,481,2013,92275
459,7429,3653,3776,2013,92276
460,23691,11506,12185,2013,92277
461,4441,4120,321,2013,92278
462,0,0,0,2013,92280
463,1773,826,947,2013,92281
464,668,309,359,2013,92282
465,2670,1367,1303,2013,92283
466,24951,12267,12684,2013,92284
467,2739,1429,1310,2013,92285
468,32222,16822,15400,2013,92301
469,17,17,0,2013,92304
470,295,182,113,2013,92305
471,37265,18118,19147,2013,92307
472,39987,19186,20801,2013,92308
473,837,482,355,2013,92309
474,9049,5231,3818,2013,92310
475,32724,16405,16319,2013,92311
476,12169,5877,6292,2013,92313
477,10235,5160,5075,2013,92314
478,5213,2429,2784,2013,92315
479,31151,16146,15005,2013,92316
480,7940,3912,4028,2013,92320
481,965,511,454,2013,92321
482,811,427,384,2013,92322
483,57326,28894,28432,2013,92324
484,8053,4168,3885,2013,92325
485,1291,593,698,2013,92327
486,285,118,167,2013,92328
487,8,8,0,2013,92332
488,635,326,309,2013,92333
489,98460,49857,48603,2013,92335
490,90633,44854,45779,2013,92336
491,37474,18422,19052,2013,92337
492,0,0,0,2013,92338
493,984,426,558,2013,92339
494,326,149,177,2013,92341
495,6800,3435,3365,2013,92342
496,20116,9930,10186,2013,92344
497,80683,40676,40007,2013,92345
498,57499,29349,28150,2013,92346
499,1696,799,897,2013,92347
500,6410,3031,3379,2013,92352
501,21427,10157,11270,2013,92354
502,6504,3315,3189,2013,92356
503,986,485,501,2013,92358
504,8087,3983,4104,2013,92359
505,5242,2591,2651,2013,92363
506,57,32,25,2013,92364
507,2308,1094,1214,2013,92365
508,930,477,453,2013,92368
509,14729,7922,6807,2013,92371
510,4920,2384,2536,2013,92372
511,33891,16612,17279,2013,92373
512,40605,19508,21097,2013,92374
513,84699,42306,42393,2013,92376
514,19137,9202,9935,2013,92377
515,135,49,86,2013,92378
516,5577,2825,2752,2013,92382
517,56,34,22,2013,92384
518,274,146,128,2013,92385
519,1866,892,974,2013,92386
520,108,59,49,2013,92389
521,2693,1460,1233,2013,92391
522,54557,26074,28483,2013,92392
523,35027,18509,16518,2013,92394
524,42364,19943,22421,2013,92395
525,4497,2340,2157,2013,92397
526,949,514,435,2013,92398
527,53370,26942,26428,2013,92399
528,2076,966,1110,2013,92401
529,61918,30180,31738,2013,92404
530,29967,14904,15063,2013,92405
531,58275,28603,29672,2013,92407
532,14548,7630,6918,2013,92408
533,47192,23935,23257,2013,92410
534,25822,12159,13663,2013,92411
535,22211,11648,10563,2013,92501
536,90989,45342,45647,2013,92503
537,54221,27000,27221,2013,92504
538,49435,24838,24597,2013,92505
539,44704,21576,23128,2013,92506
540,54152,26291,27861,2013,92507
541,35937,17808,18129,2013,92508
542,78117,39397,38720,2013,92509
543,1049,614,435,2013,92518
544,50141,25705,24436,2013,92530
545,20383,10014,10369,2013,92532
546,3454,1474,1980,2013,92536
547,3887,1761,2126,2013,92539
548,34406,16626,17780,2013,92543
549,45256,22743,22513,2013,92544
550,39770,18841,20929,2013,92545
551,7017,3583,3434,2013,92548
552,2157,1062,1095,2013,92549
553,30468,14940,15528,2013,92551
554,75024,36348,38676,2013,92553
555,39748,18740,21008,2013,92555
556,51196,24726,26470,2013,92557
557,1509,741,768,2013,92561
558,62070,30302,31768,2013,92562
559,56252,27953,28299,2013,92563
560,8906,4517,4389,2013,92567
561,54115,27363,26752,2013,92570
562,53820,26119,27701,2013,92571
563,16580,7842,8738,2013,92582
564,30029,14874,15155,2013,92583
565,45510,22698,22812,2013,92584
566,19222,9415,9807,2013,92585
567,19091,8548,10543,2013,92586
568,16081,7996,8085,2013,92587
569,3529,1705,1824,2013,92590
570,39092,18992,20100,2013,92591
571,72760,36060,36700,2013,92592
572,30448,15588,14860,2013,92595
573,24297,12174,12123,2013,92596
574,22239,10891,11348,2013,92602
575,20172,9654,10518,2013,92603
576,27942,13347,14595,2013,92604
577,21740,10635,11105,2013,92606
578,11250,5609,5641,2013,92610
579,28040,13783,14257,2013,92612
580,25131,12249,12882,2013,92614
581,16388,7768,8620,2013,92617
582,18617,9923,8694,2013,92618
583,41443,20418,21025,2013,92620
584,6258,3235,3023,2013,92624
585,11975,5623,6352,2013,92625
586,51904,26312,25592,2013,92626
587,59488,30524,28964,2013,92627
588,27173,13586,13587,2013,92629
589,59401,29018,30383,2013,92630
590,16251,5840,10411,2013,92637
591,55184,26270,28914,2013,92646
592,58081,28865,29216,2013,92647
593,45598,22810,22788,2013,92648
594,33470,16605,16865,2013,92649
595,23559,12097,11462,2013,92651
596,28607,14074,14533,2013,92653
597,9231,4506,4725,2013,92655
598,50820,24249,26571,2013,92656
599,10078,4977,5101,2013,92657
600,34068,16992,17076,2013,92660
601,3840,2054,1786,2013,92661
602,2903,1332,1571,2013,92662
603,23141,12194,10947,2013,92663
604,35224,17297,17927,2013,92672
605,29263,14449,14814,2013,92673
606,35192,17548,17644,2013,92675
607,2146,1194,952,2013,92676
608,63797,30407,33390,2013,92677
609,436,227,209,2013,92678
610,33377,16634,16743,2013,92679
611,90640,45221,45419,2013,92683
612,44767,22040,22727,2013,92688
613,47275,23035,24240,2013,92691
614,48739,23852,24887,2013,92692
615,22527,11256,11271,2013,92694
616,54117,27797,26320,2013,92701
617,69952,36268,33684,2013,92703
618,87208,43129,44079,2013,92704
619,45815,22160,23655,2013,92705
620,36287,18407,17880,2013,92706
621,60288,30173,30115,2013,92707
622,56510,28245,28265,2013,92708
623,58755,28947,29808,2013,92780
624,22889,11171,11718,2013,92782
625,62859,31373,31486,2013,92801
626,42502,21062,21440,2013,92802
627,84648,41777,42871,2013,92804
628,71568,37167,34401,2013,92805
629,39468,19475,19993,2013,92806
630,36027,17826,18201,2013,92807
631,20495,10275,10220,2013,92808
632,37254,18160,19094,2013,92821
633,2761,1359,1402,2013,92823
634,34970,16244,18726,2013,92831
635,25264,12773,12491,2013,92832
636,52232,25355,26877,2013,92833
637,23477,11303,12174,2013,92835
638,55513,28364,27149,2013,92840
639,32512,16355,16157,2013,92841
640,44351,22251,22100,2013,92843
641,24614,12551,12063,2013,92844
642,17125,8181,8944,2013,92845
643,27177,15078,12099,2013,92860
644,5842,2999,2843,2013,92861
645,19529,9927,9602,2013,92865
646,15213,7419,7794,2013,92866
647,44148,21537,22611,2013,92867
648,27149,14697,12452,2013,92868
649,38001,18971,19030,2013,92869
650,52794,26128,26666,2013,92870
651,48327,23580,24747,2013,92879
652,66353,33485,32868,2013,92880
653,32048,16416,15632,2013,92881
654,68885,34663,34222,2013,92882
655,30364,14530,15834,2013,92883
656,47786,23917,23869,2013,92886
657,19700,9643,10057,2013,92887
658,32094,15799,16295,2013,93001
659,50446,24711,25735,2013,93003
660,30737,15229,15508,2013,93004
661,43924,21746,22178,2013,93010
662,34964,16893,18071,2013,93012
663,16156,7959,8197,2013,93013
664,17440,8963,8477,2013,93015
665,35847,17532,18315,2013,93021
666,6726,3478,3248,2013,93022
667,20512,9989,10523,2013,93023
668,59435,30367,29068,2013,93030
669,81644,41970,39674,2013,93033
670,27207,13597,13610,2013,93035
671,43568,21722,21846,2013,93036
672,1914,951,963,2013,93040
673,23874,11628,12246,2013,93041
674,64,60,4,2013,93042
675,0,0,0,2013,93043
676,33489,17392,16097,2013,93060
677,55846,28124,27722,2013,93063
678,0,0,0,2013,93064
679,71899,34457,37442,2013,93065
680,3240,1773,1467,2013,93066
681,543,247,296,2013,93067
682,32523,16461,16062,2013,93101
683,20607,10628,9979,2013,93103
684,24379,11483,12896,2013,93105
685,11446,5212,6234,2013,93108
686,10443,5095,5348,2013,93109
687,17572,9235,8337,2013,93110
688,17313,8378,8935,2013,93111
689,54251,27160,27091,2013,93117
690,1084,531,553,2013,93201
691,3738,1838,1900,2013,93202
692,21208,11157,10051,2013,93203
693,15001,9680,5321,2013,93204
694,2190,956,1234,2013,93205
695,2240,1177,1063,2013,93206
696,304,151,153,2013,93207
697,142,81,61,2013,93208
698,21846,13653,8193,2013,93210
699,25618,18522,7096,2013,93212
700,56141,32500,23641,2013,93215
701,845,438,407,2013,93218
702,9570,4671,4899,2013,93219
703,255,167,88,2013,93220
704,15488,7711,7777,2013,93221
705,1555,745,810,2013,93222
706,10695,5069,5626,2013,93223
707,459,246,213,2013,93224
708,5373,2647,2726,2013,93225
709,382,183,199,2013,93226
710,65927,33688,32239,2013,93230
711,6936,3400,3536,2013,93234
712,3924,2161,1763,2013,93235
713,1653,883,770,2013,93238
714,1720,881,839,2013,93239
715,5100,2575,2525,2013,93240
716,18541,9728,8813,2013,93241
717,3267,1674,1593,2013,93242
718,1419,696,723,2013,93243
719,293,162,131,2013,93244
720,36708,18890,17818,2013,93245
721,18417,9403,9014,2013,93247
722,2459,1411,1048,2013,93249
723,13493,7750,5743,2013,93250
724,233,130,103,2013,93251
725,3830,3012,818,2013,93252
726,611,318,293,2013,93254
727,627,257,370,2013,93255
728,5591,2986,2605,2013,93256
729,76470,38481,37989,2013,93257
730,1854,986,868,2013,93258
731,162,100,62,2013,93260
732,3317,1693,1624,2013,93261
733,45,16,29,2013,93262
734,19613,9763,9850,2013,93263
735,2879,1462,1417,2013,93265
736,1378,640,738,2013,93266
737,7010,3575,3435,2013,93267
738,17143,8622,8521,2013,93268
739,5615,2722,2893,2013,93270
740,2155,1139,1016,2013,93271
741,3396,1853,1543,2013,93272
742,70820,34793,36027,2013,93274
743,148,81,67,2013,93276
744,51604,24943,26661,2013,93277
745,27162,16731,10431,2013,93280
746,2319,1247,1072,2013,93283
747,2005,1033,972,2013,93285
748,9950,5016,4934,2013,93286
749,112,67,45,2013,93287
750,53742,27203,26539,2013,93291
751,38107,19158,18949,2013,93292
752,11396,5434,5962,2013,93301
753,52421,26402,26019,2013,93304
754,37194,19289,17905,2013,93305
755,67322,32689,34633,2013,93306
756,82472,40705,41767,2013,93307
757,53639,26840,26799,2013,93308
758,59489,29171,30318,2013,93309
759,42591,20435,22156,2013,93311
760,55539,27887,27652,2013,93312
761,44571,22926,21645,2013,93313
762,22535,11440,11095,2013,93314
763,28571,14534,14037,2013,93401
764,14260,6978,7282,2013,93402
765,33567,20960,12607,2013,93405
766,0,0,0,2013,93410
767,30401,14936,15465,2013,93420
768,31349,16042,15307,2013,93422
769,853,371,482,2013,93424
770,1372,832,540,2013,93426
771,5370,2890,2480,2013,93427
772,6393,3068,3325,2013,93428
773,94,40,54,2013,93429
774,2733,1383,1350,2013,93430
775,1041,523,518,2013,93432
776,13269,6313,6956,2013,93433
777,7123,3503,3620,2013,93434
778,54433,28007,26426,2013,93436
779,3693,2009,1684,2013,93437
780,1680,820,860,2013,93440
781,1212,618,594,2013,93441
782,10896,5308,5588,2013,93442
783,19712,9590,10122,2013,93444
784,7248,3498,3750,2013,93445
785,43356,21381,21975,2013,93446
786,7746,3684,4062,2013,93449
787,791,373,418,2013,93450
788,4212,2054,2158,2013,93451
789,609,352,257,2013,93452
790,3575,1825,1750,2013,93453
791,36509,18379,18130,2013,93454
792,42919,20583,22336,2013,93455
793,55651,28978,26673,2013,93458
794,5348,2685,2663,2013,93460
795,1589,911,678,2013,93461
796,7822,3991,3831,2013,93463
797,9738,4748,4990,2013,93465
798,5411,2822,2589,2013,93501
799,13324,6795,6529,2013,93505
800,7216,3765,3451,2013,93510
801,143,36,107,2013,93512
802,1541,811,730,2013,93513
803,14250,7142,7108,2013,93514
804,2347,1041,1306,2013,93516
805,591,325,266,2013,93517
806,1131,580,551,2013,93518
807,89,45,44,2013,93519
808,15,7,8,2013,93522
809,2926,1430,1496,2013,93523
810,454,445,9,2013,93524
811,713,352,361,2013,93526
812,2125,1079,1046,2013,93527
813,49,19,30,2013,93528
814,419,364,55,2013,93529
815,56,24,32,2013,93530
816,409,208,201,2013,93531
817,2476,1141,1335,2013,93532
818,39563,19181,20382,2013,93534
819,73606,35229,38377,2013,93535
820,69988,37475,32513,2013,93536
821,766,367,399,2013,93541
822,13251,6732,6519,2013,93543
823,944,514,430,2013,93544
824,2214,1155,1059,2013,93545
825,9681,5091,4590,2013,93546
826,364,175,189,2013,93549
827,74561,36660,37901,2013,93550
828,50306,24595,25711,2013,93551
829,39943,19368,20575,2013,93552
830,2242,1241,1001,2013,93553
831,116,64,52,2013,93554
832,32376,16047,16329,2013,93555
833,249,78,171,2013,93558
834,19371,9779,9592,2013,93560
835,34851,20137,14714,2013,93561
836,1877,966,911,2013,93562
837,344,213,131,2013,93563
838,6483,3463,3020,2013,93591
839,16,9,7,2013,93592
840,2050,1026,1024,2013,93601
841,4074,1985,2089,2013,93602
842,271,132,139,2013,93603
843,967,427,540,2013,93604
844,243,130,113,2013,93605
845,424,200,224,2013,93606
846,804,429,375,2013,93608
847,6282,3073,3209,2013,93609
848,24206,8923,15283,2013,93610
849,47559,22931,24628,2013,93611
850,34415,16350,18065,2013,93612
851,11245,5683,5562,2013,93614
852,6135,3134,3001,2013,93615
853,2455,1323,1132,2013,93616
854,29022,15552,13470,2013,93618
855,29476,14480,14996,2013,93619
856,9825,5141,4684,2013,93620
857,316,155,161,2013,93621
858,9558,5154,4404,2013,93622
859,51,18,33,2013,93623
860,1377,774,603,2013,93624
861,7049,3647,3402,2013,93625
862,773,419,354,2013,93626
863,51,30,21,2013,93627
864,240,119,121,2013,93628
865,18407,9413,8994,2013,93630
866,16576,8246,8330,2013,93631
867,0,0,0,2013,93633
868,24,10,14,2013,93634
869,38929,19290,19639,2013,93635
870,11341,5524,5817,2013,93636
871,40515,19960,20555,2013,93637
872,48805,25526,23279,2013,93638
873,11902,6457,5445,2013,93640
874,598,421,177,2013,93641
875,2674,1369,1305,2013,93643
876,7308,3640,3668,2013,93644
877,606,222,384,2013,93645
878,10785,5192,5593,2013,93646
879,12320,6021,6299,2013,93647
880,15648,8067,7581,2013,93648
881,3428,1582,1846,2013,93650
882,1830,891,939,2013,93651
883,415,231,184,2013,93652
884,1115,585,530,2013,93653
885,30665,15695,14970,2013,93654
886,6883,3512,3371,2013,93656
887,35768,17321,18447,2013,93657
888,4582,2308,2274,2013,93660
889,30340,15513,14827,2013,93662
890,701,416,285,2013,93664
891,449,303,146,2013,93665
892,524,234,290,2013,93666
893,1985,1108,877,2013,93667
894,1285,649,636,2013,93668
895,230,81,149,2013,93669
896,959,533,426,2013,93673
897,2566,1318,1248,2013,93675
898,10602,5602,5000,2013,93701
899,48181,24334,23847,2013,93702
900,35127,18133,16994,2013,93703
901,26369,12299,14070,2013,93704
902,38600,18670,19930,2013,93705
903,38963,19464,19499,2013,93706
904,32701,15912,16789,2013,93710
905,37651,17805,19846,2013,93711
906,46300,21755,24545,2013,93720
907,6445,3864,2581,2013,93721
908,79727,39446,40281,2013,93722
909,8809,4542,4267,2013,93723
910,25884,12591,13293,2013,93725
911,41140,20184,20956,2013,93726
912,70774,35939,34835,2013,93727
913,14791,7432,7359,2013,93728
914,10896,5522,5374,2013,93730
915,26642,13378,13264,2013,93901
916,60905,32061,28844,2013,93905
917,62073,30474,31599,2013,93906
918,21152,10796,10356,2013,93907
919,12675,6178,6497,2013,93908
920,765,454,311,2013,93920
921,3169,1479,1690,2013,93921
922,13141,6108,7033,2013,93923
923,5882,2792,3090,2013,93924
924,1708,905,803,2013,93925
925,8735,4394,4341,2013,93926
926,17270,8475,8795,2013,93927
927,308,177,131,2013,93928
928,16234,9027,7207,2013,93930
929,466,287,179,2013,93932
930,22634,10929,11705,2013,93933
931,33685,17128,16557,2013,93940
932,7,0,7,2013,93943
933,15241,7306,7935,2013,93950
934,4766,2191,2575,2013,93953
935,222,103,119,2013,93954
936,33709,16617,17092,2013,93955
937,27334,18628,8706,2013,93960
938,878,455,423,2013,93962
939,26483,13079,13404,2013,94002
940,4330,2090,2240,2013,94005
941,41480,20682,20798,2013,94010
942,47818,23626,24192,2013,94014
943,61591,29861,31730,2013,94015
944,18199,8897,9302,2013,94019
945,1435,692,743,2013,94020
946,115,42,73,2013,94021
947,19358,9406,9952,2013,94022
948,22349,11001,11348,2013,94024
949,40372,19466,20906,2013,94025
950,7110,3581,3529,2013,94027
951,6788,3278,3510,2013,94028
952,21867,10489,11378,2013,94030
953,3080,1508,1572,2013,94037
954,3000,1560,1440,2013,94038
955,33852,17131,16721,2013,94040
956,13219,6615,6604,2013,94041
957,28189,14304,13885,2013,94043
958,37943,18357,19586,2013,94044
959,1764,871,893,2013,94060
960,37176,18087,19089,2013,94061
961,27142,13403,13739,2013,94062
962,31497,16808,14689,2013,94063
963,11109,5379,5730,2013,94065
964,41636,20383,21253,2013,94066
965,29531,14530,15001,2013,94070
966,253,177,76,2013,94074
967,65200,32499,32701,2013,94080
968,23476,12156,11320,2013,94085
969,45775,24190,21585,2013,94086
970,54362,27319,27043,2013,94087
971,20505,10190,10315,2013,94089
972,25881,15030,10851,2013,94102
973,23907,13760,10147,2013,94103
974,211,87,124,2013,94104
975,5553,3013,2540,2013,94105
976,27856,14484,13372,2013,94107
977,13709,6893,6816,2013,94108
978,55519,27853,27666,2013,94109
979,72128,37502,34626,2013,94110
980,3496,1788,1708,2013,94111
981,82726,41115,41611,2013,94112
982,31397,18885,12512,2013,94114
983,33782,15733,18049,2013,94115
984,45157,21093,24064,2013,94116
985,41568,22501,19067,2013,94117
986,40292,19166,21126,2013,94118
987,42104,20625,21479,2013,94121
988,57369,28174,29195,2013,94122
989,24500,11507,12993,2013,94123
990,35309,17721,17588,2013,94124
991,19576,10126,9450,2013,94127
992,66,0,66,2013,94128
993,2787,1451,1336,2013,94129
994,2654,1480,1174,2013,94130
995,26908,14222,12686,2013,94131
996,31080,14982,16098,2013,94132
997,27970,14035,13935,2013,94133
998,38815,18886,19929,2013,94134
999,5219,3171,2048,2013,94158
1000,16420,8105,8315,2013,94301
1001,46357,22760,23597,2013,94303
1002,3797,1856,1941,2013,94304
1003,13515,7373,6142,2013,94305
1004,27236,13514,13722,2013,94306
1005,36691,18624,18067,2013,94401
1006,23289,11369,11920,2013,94402
1007,39720,19385,20335,2013,94403
1008,34431,16584,17847,2013,94404
1009,61639,30085,31554,2013,94501
1010,13179,6165,7014,2013,94502
1011,19902,9503,10399,2013,94503
1012,13083,6828,6255,2013,94505
1013,21096,9888,11208,2013,94506
1014,15977,8118,7859,2013,94507
1015,3740,1951,1789,2013,94508
1016,62651,29536,33115,2013,94509
1017,27294,13162,14132,2013,94510
1018,2172,1148,1024,2013,94511
1019,231,42,189,2013,94512
1020,55488,27810,27678,2013,94513
1021,1069,556,513,2013,94514
1022,7241,3816,3425,2013,94515
1023,129,68,61,2013,94516
1024,12644,6487,6157,2013,94517
1025,26965,13170,13795,2013,94518
1026,19400,9566,9834,2013,94519
1027,37489,19891,17598,2013,94520
1028,41354,20127,21227,2013,94521
1029,33923,16315,17608,2013,94523
1030,3121,1411,1710,2013,94525
1031,32755,15829,16926,2013,94526
1032,1124,501,623,2013,94528
1033,24101,11844,12257,2013,94530
1034,41700,20494,21206,2013,94531
1035,69067,33189,35878,2013,94533
1036,36560,17656,18904,2013,94534
1037,4728,2988,1740,2013,94535
1038,69921,35007,34914,2013,94536
1039,61784,30832,30952,2013,94538
1040,51494,25695,25799,2013,94539
1041,61311,29268,32043,2013,94541
1042,12385,5713,6672,2013,94542
1043,76542,37966,38576,2013,94544
1044,30083,14750,15333,2013,94545
1045,42650,20205,22445,2013,94546
1046,24454,11766,12688,2013,94547
1047,338,169,169,2013,94548
1048,27784,13475,14309,2013,94549
1049,47648,23510,24138,2013,94550
1050,37705,19550,18155,2013,94551
1051,14719,7389,7330,2013,94552
1052,48018,23882,24136,2013,94553
1053,34973,17747,17226,2013,94555
1054,15064,7125,7939,2013,94556
1055,66824,33336,33488,2013,94558
1056,27167,13931,13236,2013,94559
1057,43139,21636,21503,2013,94560
1058,37679,19008,18671,2013,94561
1059,18024,9014,9010,2013,94563
1060,18612,9115,9497,2013,94564
1061,86204,41968,44236,2013,94565
1062,41638,20312,21326,2013,94566
1063,800,387,413,2013,94567
1064,47384,24102,23282,2013,94568
1065,325,218,107,2013,94569
1066,8025,3876,4149,2013,94571
1067,8689,4397,4292,2013,94572
1068,117,71,46,2013,94573
1069,9538,4681,4857,2013,94574
1070,1420,617,803,2013,94575
1071,88,10,78,2013,94576
1072,44344,21569,22775,2013,94577
1073,39225,18871,20354,2013,94578
1074,21652,11157,10495,2013,94579
1075,28701,13622,15079,2013,94580
1076,38928,18756,20172,2013,94582
1077,34937,17338,17599,2013,94583
1078,28823,14740,14083,2013,94585
1079,866,405,461,2013,94586
1080,70687,34393,36294,2013,94587
1081,30949,15901,15048,2013,94588
1082,30364,13928,16436,2013,94589
1083,35263,17330,17933,2013,94590
1084,53548,26048,27500,2013,94591
1085,562,254,308,2013,94592
1086,16448,6517,9931,2013,94595
1087,20307,9294,11013,2013,94596
1088,20070,10055,10015,2013,94597
1089,26672,12363,14309,2013,94598
1090,3166,1452,1714,2013,94599
1091,49279,25806,23473,2013,94601
1092,28553,13085,15468,2013,94602
1093,32977,15846,17131,2013,94603
1094,42639,20313,22326,2013,94605
1095,36214,17667,18547,2013,94606
1096,25107,12036,13071,2013,94607
1097,26288,13145,13143,2013,94608
1098,21210,9590,11620,2013,94609
1099,29978,14177,15801,2013,94610
1100,36676,17838,18838,2013,94611
1101,13816,7152,6664,2013,94612
1102,861,152,709,2013,94613
1103,17226,8060,9166,2013,94618
1104,22809,10973,11836,2013,94619
1105,31833,15848,15985,2013,94621
1106,16324,7830,8494,2013,94702
1107,21281,10602,10679,2013,94703
1108,24906,11356,13550,2013,94704
1109,12979,6297,6682,2013,94705
1110,19918,9569,10349,2013,94706
1111,12324,5820,6504,2013,94707
1112,11073,5291,5782,2013,94708
1113,12360,6610,5750,2013,94709
1114,6478,3153,3325,2013,94710
1115,3026,1502,1524,2013,94720
1116,29825,14970,14855,2013,94801
1117,26124,12758,13366,2013,94803
1118,39995,18962,21033,2013,94804
1119,14232,6673,7559,2013,94805
1120,59720,29373,30347,2013,94806
1121,0,0,0,2013,94850
1122,41056,20978,20078,2013,94901
1123,30411,14882,15529,2013,94903
1124,12087,5502,6585,2013,94904
1125,12528,5744,6784,2013,94920
1126,323,129,194,2013,94922
1127,668,302,366,2013,94923
1128,1164,573,591,2013,94924
1129,9326,4239,5087,2013,94925
1130,42361,19785,22576,2013,94928
1131,70,21,49,2013,94929
1132,8606,4119,4487,2013,94930
1133,8646,4227,4419,2013,94931
1134,1078,505,573,2013,94933
1135,1099,581,518,2013,94937
1136,907,373,534,2013,94938
1137,6887,3250,3637,2013,94939
1138,228,110,118,2013,94940
1139,30650,14758,15892,2013,94941
1140,18107,8706,9401,2013,94945
1141,669,344,325,2013,94946
1142,24540,11466,13074,2013,94947
1143,16895,8455,8440,2013,94949
1144,47,30,17,2013,94950
1145,4253,2113,2140,2013,94951
1146,34039,16751,17288,2013,94952
1147,36785,17778,19007,2013,94954
1148,1779,822,957,2013,94956
1149,969,457,512,2013,94957
1150,15986,7441,8545,2013,94960
1151,448,207,241,2013,94963
1152,4827,4656,171,2013,94964
1153,10926,5202,5724,2013,94965
1154,595,281,314,2013,94970
1155,357,162,195,2013,94971
1156,38,19,19,2013,94972
1157,1745,844,901,2013,94973
1158,1728,808,920,2013,95002
1159,24430,11639,12791,2013,95003
1160,3689,1871,1818,2013,95004
1161,6168,3020,3148,2013,95005
1162,9597,4862,4735,2013,95006
1163,517,336,181,2013,95007
1164,45187,22696,22491,2013,95008
1165,9241,4738,4503,2013,95010
1166,10456,5270,5186,2013,95012
1167,22,11,11,2013,95013
1168,61521,29769,31752,2013,95014
1169,741,399,342,2013,95017
1170,7993,3926,4067,2013,95018
1171,7692,3972,3720,2013,95019
1172,58246,29280,28966,2013,95020
1173,50067,24882,25185,2013,95023
1174,13791,6552,7239,2013,95030
1175,25664,12541,13123,2013,95032
1176,9309,4764,4545,2013,95033
1177,68178,34066,34112,2013,95035
1178,46100,22296,23804,2013,95037
1179,1308,527,781,2013,95039
1180,215,120,95,2013,95041
1181,616,300,316,2013,95043
1182,4010,2198,1812,2013,95045
1183,6547,3235,3312,2013,95046
1184,37057,18932,18125,2013,95050
1185,53152,26443,26709,2013,95051
1186,2513,1317,1196,2013,95053
1187,24408,12554,11854,2013,95054
1188,46688,23590,23098,2013,95060
1189,36201,17908,18293,2013,95062
1190,7865,3952,3913,2013,95064
1191,8443,4218,4225,2013,95065
1192,14993,7442,7551,2013,95066
1193,30923,15173,15750,2013,95070
1194,10571,5309,5262,2013,95073
1195,293,134,159,2013,95075
1196,82930,41387,41543,2013,95076
1197,18739,9788,8951,2013,95110
1198,59521,29948,29573,2013,95111
1199,55481,29280,26201,2013,95112
1200,838,413,425,2013,95113
1201,51010,26096,24914,2013,95116
1202,32277,17294,14983,2013,95117
1203,31858,15571,16287,2013,95118
1204,10291,5218,5073,2013,95119
1205,38366,19073,19293,2013,95120
1206,37699,19044,18655,2013,95121
1207,55438,27766,27672,2013,95122
1208,63621,31401,32220,2013,95123
1209,47446,23859,23587,2013,95124
1210,54200,25773,28427,2013,95125
1211,33711,17019,16692,2013,95126
1212,65258,33772,31486,2013,95127
1213,35898,18699,17199,2013,95128
1214,39740,19753,19987,2013,95129
1215,13954,7321,6633,2013,95130
1216,28999,15055,13944,2013,95131
1217,40838,20363,20475,2013,95132
1218,26867,13540,13327,2013,95133
1219,15517,8222,7295,2013,95134
1220,20908,9968,10940,2013,95135
1221,42464,20740,21724,2013,95136
1222,18870,8962,9908,2013,95138
1223,6545,3108,3437,2013,95139
1224,299,175,124,2013,95140
1225,45741,22579,23162,2013,95148
1226,5404,2699,2705,2013,95202
1227,14857,7788,7069,2013,95203
1228,29227,13906,15321,2013,95204
1229,35831,18370,17461,2013,95205
1230,66092,32967,33125,2013,95206
1231,47883,22139,25744,2013,95207
1232,41221,20150,21071,2013,95209
1233,40180,19698,20482,2013,95210
1234,1904,725,1179,2013,95211
1235,25892,12574,13318,2013,95212
1236,24067,12572,11495,2013,95215
1237,27686,13165,14521,2013,95219
1238,7395,3800,3595,2013,95220
1239,5146,2334,2812,2013,95222
1240,3056,1540,1516,2013,95223
1241,297,148,149,2013,95224
1242,565,279,286,2013,95225
1243,284,165,119,2013,95226
1244,675,287,388,2013,95227
1245,4286,2138,2148,2013,95228
1246,711,278,433,2013,95230
1247,5179,3271,1908,2013,95231
1248,286,132,154,2013,95232
1249,475,166,309,2013,95233
1250,263,249,14,2013,95234
1251,3768,1902,1866,2013,95236
1252,3269,1741,1528,2013,95237
1253,46482,22834,23648,2013,95240
1254,25525,12257,13268,2013,95242
1255,2273,1151,1122,2013,95245
1256,1207,578,629,2013,95246
1257,4599,2067,2532,2013,95247
1258,131,30,101,2013,95248
1259,3575,2038,1537,2013,95249
1260,62,31,31,2013,95250
1261,1022,567,455,2013,95251
1262,14908,7865,7043,2013,95252
1263,463,188,275,2013,95254
1264,2162,1062,1100,2013,95255
1265,396,152,244,2013,95257
1266,3874,2124,1750,2013,95258
1267,37593,19286,18307,2013,95301
1268,1085,552,533,2013,95303
1269,17314,10402,6912,2013,95304
1270,78,30,48,2013,95305
1271,918,445,473,2013,95306
1272,43160,21243,21917,2013,95307
1273,1648,840,808,2013,95310
1274,2182,1057,1125,2013,95311
1275,251,134,117,2013,95312
1276,1012,545,467,2013,95313
1277,0,0,0,2013,95314
1278,12168,5989,6179,2013,95315
1279,6820,3124,3696,2013,95316
1280,972,585,387,2013,95317
1281,549,257,292,2013,95318
1282,1490,698,792,2013,95319
1283,13000,6642,6358,2013,95320
1284,3401,1748,1653,2013,95321
1285,9042,4929,4113,2013,95322
1286,1182,626,556,2013,95323
1287,7546,3889,3657,2013,95324
1288,62,49,13,2013,95325
1289,8922,4210,4712,2013,95326
1290,9306,6164,3142,2013,95327
1291,4726,2389,2337,2013,95328
1292,2646,1300,1346,2013,95329
1293,16889,8240,8649,2013,95330
1294,3108,1556,1552,2013,95333
1295,16057,8091,7966,2013,95334
1296,623,293,330,2013,95335
1297,45015,22181,22834,2013,95336
1298,31302,15234,16068,2013,95337
1299,11471,5676,5795,2013,95338
1300,33512,15685,17827,2013,95340
1301,33713,17685,16028,2013,95341
1302,344,167,177,2013,95345
1303,1191,647,544,2013,95346
1304,30838,15008,15830,2013,95348
1305,50260,24173,26087,2013,95350
1306,47534,23786,23748,2013,95351
1307,24856,12233,12623,2013,95354
1308,59111,27686,31425,2013,95355
1309,31134,14925,16209,2013,95356
1310,11195,5572,5623,2013,95357
1311,31639,16394,15245,2013,95358
1312,11660,5990,5670,2013,95360
1313,32374,15883,16491,2013,95361
1314,26426,13924,12502,2013,95363
1315,0,0,0,2013,95364
1316,5041,2696,2345,2013,95365
1317,16651,8243,8408,2013,95366
1318,23428,12054,11374,2013,95367
1319,14656,7570,7086,2013,95368
1320,1094,522,572,2013,95369
1321,28021,13889,14132,2013,95370
1322,1614,781,833,2013,95372
1323,1778,1084,694,2013,95374
1324,142,59,83,2013,95375
1325,49442,25659,23783,2013,95376
1326,31597,15855,15742,2013,95377
1327,3782,1816,1966,2013,95379
1328,41109,20275,20834,2013,95380
1329,36860,18644,18216,2013,95382
1330,3440,1759,1681,2013,95383
1331,347,150,197,2013,95385
1332,9794,5148,4646,2013,95386
1333,943,459,484,2013,95387
1334,14274,7409,6865,2013,95388
1335,1236,831,405,2013,95389
1336,11996,5794,6202,2013,95391
1337,36646,18054,18592,2013,95401
1338,44914,22846,22068,2013,95403
1339,39988,20093,19895,2013,95404
1340,21168,10387,10781,2013,95405
1341,40741,20887,19854,2013,95407
1342,26055,12259,13796,2013,95409
1343,884,379,505,2013,95410
1344,322,167,155,2013,95412
1345,1657,969,688,2013,95415
1346,197,81,116,2013,95417
1347,358,176,182,2013,95420
1348,1490,765,725,2013,95421
1349,15427,7761,7666,2013,95422
1350,3234,1872,1362,2013,95423
1351,10628,5058,5570,2013,95425
1352,1895,992,903,2013,95426
1353,201,124,77,2013,95427
1354,2561,1284,1277,2013,95428
1355,84,57,27,2013,95429
1356,0,0,0,2013,95430
1357,525,318,207,2013,95431
1358,375,150,225,2013,95432
1359,322,181,141,2013,95435
1360,5092,2720,2372,2013,95436
1361,14527,7478,7049,2013,95437
1362,791,389,402,2013,95439
1363,2226,1230,996,2013,95441
1364,3475,1730,1745,2013,95442
1365,370,200,170,2013,95443
1366,660,252,408,2013,95444
1367,1709,893,816,2013,95445
1368,4598,2424,2174,2013,95446
1369,16910,8274,8636,2013,95448
1370,1571,876,695,2013,95449
1371,224,113,111,2013,95450
1372,12248,5991,6257,2013,95451
1373,1223,591,632,2013,95452
1374,10701,5346,5355,2013,95453
1375,2279,1191,1088,2013,95454
1376,725,217,508,2013,95456
1377,3292,1721,1571,2013,95457
1378,3126,1511,1615,2013,95458
1379,543,262,281,2013,95459
1380,2361,1080,1281,2013,95460
1381,3439,1796,1643,2013,95461
1382,1267,578,689,2013,95462
1383,0,0,0,2013,95463
1384,2426,1025,1401,2013,95464
1385,2274,1114,1160,2013,95465
1386,1192,758,434,2013,95466
1387,5410,2709,2701,2013,95467
1388,1177,629,548,2013,95468
1389,1906,1014,892,2013,95469
1390,6236,3177,3059,2013,95470
1391,453,200,253,2013,95471
1392,29381,14467,14914,2013,95472
1393,38800,18887,19913,2013,95476
1394,33538,16635,16903,2013,95482
1395,2044,1125,919,2013,95485
1396,42,14,28,2013,95486
1397,267,133,134,2013,95488
1398,12158,5750,6408,2013,95490
1399,29552,14359,15193,2013,95492
1400,291,119,172,2013,95493
1401,219,107,112,2013,95494
1402,869,403,466,2013,95497
1403,23704,12107,11597,2013,95501
1404,24899,12051,12848,2013,95503
1405,398,279,119,2013,95511
1406,191,68,123,2013,95514
1407,19055,9581,9474,2013,95519
1408,20319,10115,10204,2013,95521
1409,1964,993,971,2013,95524
1410,1751,893,858,2013,95525
1411,273,118,155,2013,95526
1412,491,254,237,2013,95527
1413,1207,551,656,2013,95528
1414,24687,13993,10694,2013,95531
1415,3156,1602,1554,2013,95536
1416,71,43,28,2013,95537
1417,12877,6304,6573,2013,95540
1418,2252,1138,1114,2013,95542
1419,549,202,347,2013,95543
1420,92,63,29,2013,95545
1421,3476,1647,1829,2013,95546
1422,1443,734,709,2013,95547
1423,1398,846,552,2013,95548
1424,745,328,417,2013,95549
1425,272,177,95,2013,95550
1426,1944,1089,855,2013,95551
1427,554,266,288,2013,95552
1428,1381,706,675,2013,95553
1429,455,209,246,2013,95554
1430,360,188,172,2013,95555
1431,637,430,207,2013,95556
1432,353,217,136,2013,95558
1433,113,27,86,2013,95559
1434,1145,594,551,2013,95560
1435,3409,1617,1792,2013,95562
1436,679,325,354,2013,95563
1437,454,280,174,2013,95564
1438,1064,505,559,2013,95565
1439,1723,692,1031,2013,95567
1440,93,32,61,2013,95568
1441,308,211,97,2013,95569
1442,2085,1084,1001,2013,95570
1443,133,90,43,2013,95571
1444,1443,750,693,2013,95573
1445,443,253,190,2013,95585
1446,126,66,60,2013,95587
1447,1198,658,540,2013,95589
1448,128,73,55,2013,95595
1449,139,75,64,2013,95601
1450,18049,8955,9094,2013,95602
1451,28054,14144,13910,2013,95603
1452,44,21,23,2013,95604
1453,14160,7003,7157,2013,95605
1454,98,48,50,2013,95606
1455,371,226,145,2013,95607
1456,60255,29122,31133,2013,95608
1457,43333,21385,21948,2013,95610
1458,968,456,512,2013,95612
1459,4341,2155,2186,2013,95614
1460,999,459,540,2013,95615
1461,47995,22447,25548,2013,95616
1462,27262,13941,13321,2013,95618
1463,4893,2377,2516,2013,95619
1464,20845,10191,10654,2013,95620
1465,41573,19347,22226,2013,95621
1466,3913,1894,2019,2013,95623
1467,62335,30750,31585,2013,95624
1468,188,70,118,2013,95625
1469,5979,2847,3132,2013,95626
1470,3171,1450,1721,2013,95627
1471,40921,19923,20998,2013,95628
1472,949,469,480,2013,95629
1473,72462,39804,32658,2013,95630
1474,5874,2868,3006,2013,95631
1475,29892,14293,15599,2013,95632
1476,3441,1752,1689,2013,95633
1477,3080,1557,1523,2013,95634
1478,921,529,392,2013,95635
1479,937,513,424,2013,95636
1480,622,240,382,2013,95637
1481,1984,1026,958,2013,95638
1482,299,81,218,2013,95639
1483,10825,7375,3450,2013,95640
1484,1590,781,809,2013,95641
1485,6705,3248,3457,2013,95642
1486,1962,1038,924,2013,95645
1487,66,22,44,2013,95646
1488,48243,23223,25020,2013,95648
1489,11741,5630,6111,2013,95650
1490,451,175,276,2013,95651
1491,836,480,356,2013,95652
1492,481,230,251,2013,95653
1493,4802,2308,2494,2013,95655
1494,6522,3155,3367,2013,95658
1495,760,366,394,2013,95659
1496,32835,16522,16313,2013,95660
1497,30269,14706,15563,2013,95661
1498,31411,15386,16025,2013,95662
1499,2332,1099,1233,2013,95663
1500,1095,569,526,2013,95664
1501,4240,2119,2121,2013,95665
1502,5525,2544,2981,2013,95666
1503,35924,17489,18435,2013,95667
1504,844,496,348,2013,95668
1505,2864,1421,1443,2013,95669
1506,53259,26152,27107,2013,95670
1507,5273,2642,2631,2013,95672
1508,15430,7545,7885,2013,95673
1509,739,374,365,2013,95674
1510,405,215,190,2013,95675
1511,22675,10851,11824,2013,95677
1512,42606,20578,22028,2013,95678
1513,29,8,21,2013,95679
1514,245,133,112,2013,95680
1515,992,569,423,2013,95681
1516,29590,14348,15242,2013,95682
1517,6354,3059,3295,2013,95683
1518,3069,1521,1548,2013,95684
1519,4368,2025,2343,2013,95685
1520,1020,490,530,2013,95686
1521,66129,36812,29317,2013,95687
1522,34599,17390,17209,2013,95688
1523,1151,559,592,2013,95689
1524,2015,978,1037,2013,95690
1525,35485,17580,17905,2013,95691
1526,4992,2437,2555,2013,95692
1527,5640,2696,2944,2013,95693
1528,10008,4769,5239,2013,95694
1529,37686,18432,19254,2013,95695
1530,307,188,119,2013,95697
1531,177,104,73,2013,95698
1532,267,199,68,2013,95699
1533,759,388,371,2013,95701
1534,1055,480,575,2013,95703
1535,4942,2483,2459,2013,95709
1536,9645,4916,4729,2013,95713
1537,271,144,127,2013,95714
1538,88,40,48,2013,95715
1539,188,98,90,2013,95717
1540,67,35,32,2013,95720
1541,14,14,0,2013,95721
1542,4583,2240,2343,2013,95722
1543,0,0,0,2013,95724
1544,8902,4330,4572,2013,95726
1545,495,237,258,2013,95728
1546,31,18,13,2013,95735
1547,278,142,136,2013,95736
1548,8873,4547,4326,2013,95742
1549,24012,12006,12006,2013,95746
1550,53452,25175,28277,2013,95747
1551,42752,22085,20667,2013,95757
1552,61155,29233,31922,2013,95758
1553,40829,21055,19774,2013,95762
1554,35914,17583,18331,2013,95765
1555,22083,11006,11077,2013,95776
1556,7370,3830,3540,2013,95811
1557,9802,6067,3735,2013,95814
1558,25627,12644,12983,2013,95815
1559,16624,8332,8292,2013,95816
1560,14377,6574,7803,2013,95817
1561,19960,9304,10656,2013,95818
1562,17705,7874,9831,2013,95819
1563,33967,16002,17965,2013,95820
1564,33190,16056,17134,2013,95821
1565,43024,19932,23092,2013,95822
1566,74154,35264,38890,2013,95823
1567,29344,15218,14126,2013,95824
1568,31505,14305,17200,2013,95825
1569,37215,18573,18642,2013,95826
1570,20120,9298,10822,2013,95827
1571,60993,30673,30320,2013,95828
1572,25565,12604,12961,2013,95829
1573,725,382,343,2013,95830
1574,41224,19353,21871,2013,95831
1575,12051,5615,6436,2013,95832
1576,38264,18126,20138,2013,95833
1577,24201,12267,11934,2013,95834
1578,38606,19925,18681,2013,95835
1579,240,120,120,2013,95837
1580,35584,17787,17797,2013,95838
1581,18612,8608,10004,2013,95841
1582,31689,15234,16455,2013,95842
1583,46775,22539,24236,2013,95843
1584,21554,10400,11154,2013,95864
1585,32569,16327,16242,2013,95901
1586,1981,1246,735,2013,95903
1587,135,29,106,2013,95910
1588,4814,2326,2488,2013,95912
1589,629,331,298,2013,95914
1590,63,27,36,2013,95915
1591,1244,731,513,2013,95916
1592,3336,1803,1533,2013,95917
1593,1549,857,692,2013,95918
1594,1305,605,700,2013,95919
1595,449,213,236,2013,95920
1596,637,328,309,2013,95922
1597,33,17,16,2013,95923
1598,47,47,0,2013,95925
1599,37747,18593,19154,2013,95926
1600,36194,17307,18887,2013,95928
1601,0,0,0,2013,95930
1602,7776,4132,3644,2013,95932
1603,317,126,191,2013,95934
1604,366,240,126,2013,95935
1605,250,166,84,2013,95936
1606,1320,648,672,2013,95937
1607,4015,2046,1969,2013,95938
1608,488,253,235,2013,95939
1609,589,291,298,2013,95941
1610,1362,767,595,2013,95942
1611,894,435,459,2013,95943
1612,0,0,0,2013,95944
1613,24762,11927,12835,2013,95945
1614,9874,4650,5224,2013,95946
1615,1795,878,917,2013,95947
1616,10289,5222,5067,2013,95948
1617,19999,9595,10404,2013,95949
1618,664,356,308,2013,95950
1619,2671,1383,1288,2013,95951
1620,10575,4959,5616,2013,95953
1621,12464,6380,6084,2013,95954
1622,1251,548,703,2013,95955
1623,346,198,148,2013,95956
1624,875,457,418,2013,95957
1625,17668,9006,8662,2013,95959
1626,989,457,532,2013,95960
1627,26753,13569,13184,2013,95961
1628,1527,841,686,2013,95962
1629,15214,7641,7573,2013,95963
1630,20130,10028,10102,2013,95965
1631,30983,15583,15400,2013,95966
1632,1494,682,812,2013,95968
1633,27298,13276,14022,2013,95969
1634,525,297,228,2013,95970
1635,5639,2658,2981,2013,95971
1636,33046,16352,16694,2013,95973
1637,0,0,0,2013,95974
1638,2005,1040,965,2013,95975
1639,1971,1141,830,2013,95977
1640,24,24,0,2013,95978
1641,631,346,285,2013,95979
1642,169,108,61,2013,95981
1643,3154,1571,1583,2013,95982
1644,557,312,245,2013,95983
1645,21,10,11,2013,95984
1646,36,0,36,2013,95986
1647,5931,3159,2772,2013,95987
1648,8937,4510,4427,2013,95988
1649,41309,20350,20959,2013,95991
1650,35628,18017,17611,2013,95993
1651,33702,16671,17031,2013,96001
1652,33730,16428,17302,2013,96002
1653,44405,21741,22664,2013,96003
1654,532,261,271,2013,96006
1655,22785,11081,11704,2013,96007
1656,983,599,384,2013,96008
1657,443,227,216,2013,96009
1658,214,148,66,2013,96010
1659,134,86,48,2013,96011
1660,3626,1680,1946,2013,96013
1661,190,105,85,2013,96014
1662,704,359,345,2013,96015
1663,687,343,344,2013,96016
1664,212,111,101,2013,96017
1665,10094,4877,5217,2013,96019
1666,2211,1183,1028,2013,96020
1667,16352,8265,8087,2013,96021
1668,17023,8233,8790,2013,96022
1669,1193,608,585,2013,96023
1670,1204,621,583,2013,96024
1671,2179,1093,1086,2013,96025
1672,2379,1217,1162,2013,96027
1673,1637,677,960,2013,96028
1674,131,72,59,2013,96029
1675,204,83,121,2013,96031
1676,2223,1227,996,2013,96032
1677,463,266,197,2013,96033
1678,338,199,139,2013,96034
1679,3253,1646,1607,2013,96035
1680,215,99,116,2013,96037
1681,549,215,334,2013,96038
1682,1285,615,670,2013,96039
1683,219,116,103,2013,96040
1684,2993,1721,1272,2013,96041
1685,946,466,480,2013,96044
1686,200,107,93,2013,96046
1687,779,421,358,2013,96047
1688,1053,479,574,2013,96048
1689,89,48,41,2013,96049
1690,411,216,195,2013,96050
1691,1120,570,550,2013,96051
1692,1580,895,685,2013,96052
1693,250,133,117,2013,96054
1694,4067,1963,2104,2013,96055
1695,1496,721,775,2013,96056
1696,1475,758,717,2013,96057
1697,848,451,397,2013,96058
1698,783,410,373,2013,96059
1699,27,12,15,2013,96061
1700,1123,590,533,2013,96062
1701,212,113,99,2013,96063
1702,4482,2186,2296,2013,96064
1703,338,200,138,2013,96065
1704,7313,3654,3659,2013,96067
1705,183,135,48,2013,96068
1706,799,409,390,2013,96069
1707,85,43,42,2013,96071
1708,4664,2420,2244,2013,96073
1709,226,174,52,2013,96074
1710,345,217,128,2013,96075
1711,177,87,90,2013,96076
1712,28084,13858,14226,2013,96080
1713,593,237,356,2013,96084
1714,46,30,16,2013,96085
1715,368,203,165,2013,96086
1716,576,345,231,2013,96087
1717,4317,2366,1951,2013,96088
1718,390,187,203,2013,96090
1719,694,403,291,2013,96091
1720,242,124,118,2013,96092
1721,3755,1639,2116,2013,96093
1722,6422,3240,3182,2013,96094
1723,842,443,399,2013,96096
1724,9932,4839,5093,2013,96097
1725,4915,2403,2512,2013,96101
1726,1200,573,627,2013,96103
1727,675,341,334,2013,96104
1728,406,138,268,2013,96105
1729,224,117,107,2013,96106
1730,1329,754,575,2013,96107
1731,16,8,8,2013,96108
1732,783,359,424,2013,96109
1733,128,61,67,2013,96110
1734,60,23,37,2013,96111
1735,254,118,136,2013,96112
1736,2058,1705,353,2013,96113
1737,3260,1762,1498,2013,96114
1738,194,88,106,2013,96115
1739,214,115,99,2013,96116
1740,227,111,116,2013,96117
1741,1592,757,835,2013,96118
1742,74,34,40,2013,96119
1743,1045,657,388,2013,96120
1744,262,142,120,2013,96121
1745,4697,2359,2338,2013,96122
1746,6,3,3,2013,96123
1747,351,164,187,2013,96124
1748,340,123,217,2013,96125
1749,105,76,29,2013,96126
1750,647,389,258,2013,96128
1751,133,64,69,2013,96129
1752,21963,14799,7164,2013,96130
1753,64,38,26,2013,96132
1754,108,29,79,2013,96133
1755,2869,1517,1352,2013,96134
1756,0,0,0,2013,96135
1757,157,77,80,2013,96136
1758,3826,2160,1666,2013,96137
1759,1116,556,560,2013,96140
1760,761,408,353,2013,96141
1761,669,279,390,2013,96142
1762,4225,2575,1650,2013,96143
1763,2997,1618,1379,2013,96145
1764,853,410,443,2013,96146
1765,786,423,363,2013,96148
1766,28686,14866,13820,2013,96150
1767,0,0,0,2013,96155
1768,18113,9442,8671,2013,96161
1769,464,250,214,2013,97635
0,Estimate!!SEX AND AGE!!Total population,Estimate!!SEX AND AGE!!Male,Estimate!!SEX AND AGE!!Female,2012,Geographic Area Name
1,18544,9040,9504,2012,00601
2,41640,20435,21205,2012,00602
3,54540,26688,27852,2012,00603
4,6593,3250,3343,2012,00606
5,29141,14170,14971,2012,00610
6,69017,32617,36400,2012,00612
7,10750,5260,5490,2012,00616
8,24733,11849,12884,2012,00617
9,5923,2789,3134,2012,00622
10,44943,21558,23385,2012,00623
11,26016,12644,13372,2012,00624
12,35085,16995,18090,2012,00627
13,1800,892,908,2012,00631
14,25312,12082,13230,2012,00637
15,18997,9350,9647,2012,00638
16,30771,15040,15731,2012,00641
17,38179,18316,19863,2012,00646
18,5869,2909,2960,2012,00647
19,15120,7415,7705,2012,00650
20,3244,1598,1646,2012,00652
21,13502,6429,7073,2012,00653
22,21438,10401,11037,2012,00656
23,41945,20286,21659,2012,00659
24,17217,8015,9202,2012,00660
25,43598,21185,22413,2012,00662
26,16665,8317,8348,2012,00664
27,26102,12774,13328,2012,00667
28,29569,14595,14974,2012,00669
29,9814,4853,4961,2012,00670
30,44365,21100,23265,2012,00674
31,40145,19714,20431,2012,00676
32,15197,7365,7832,2012,00677
33,27419,13407,14012,2012,00678
34,57220,27865,29355,2012,00680
35,32899,15318,17581,2012,00682
36,33581,16355,17226,2012,00683
37,42552,20767,21785,2012,00685
38,32617,16247,16370,2012,00687
39,13036,6714,6322,2012,00688
40,6174,2855,3319,2012,00690
41,37615,17951,19664,2012,00692
42,60873,29367,31506,2012,00693
43,152,107,45,2012,00694
44,41788,20237,21551,2012,00698
45,29175,14132,15043,2012,00703
46,7950,4048,3902,2012,00704
47,25575,12421,13154,2012,00705
48,12201,6031,6170,2012,00707
49,19542,9205,10337,2012,00714
50,4270,2224,2046,2012,00715
51,32840,15745,17095,2012,00716
52,18615,8029,10586,2012,00717
53,26604,12750,13854,2012,00718
54,30992,15323,15669,2012,00719
55,23259,11726,11533,2012,00720
56,19225,9488,9737,2012,00723
57,91035,42952,48083,2012,00725
58,56679,26772,29907,2012,00727
59,43260,21904,21356,2012,00728
60,54914,26357,28557,2012,00729
61,39124,18481,20643,2012,00730
62,13869,6712,7157,2012,00731
63,13803,6538,7265,2012,00735
64,51689,25102,26587,2012,00736
65,35127,16644,18483,2012,00738
66,39171,19083,20088,2012,00739
67,1730,712,1018,2012,00740
68,5189,2264,2925,2012,00741
69,54984,26871,28113,2012,00745
70,23203,11130,12073,2012,00751
71,40631,19940,20691,2012,00754
72,23261,11242,12019,2012,00757
73,9236,4586,4650,2012,00765
74,26315,12967,13348,2012,00766
75,37863,18462,19401,2012,00767
76,40088,19478,20610,2012,00769
77,38231,18580,19651,2012,00771
78,21883,10423,11460,2012,00772
79,20050,9528,10522,2012,00773
80,1535,786,749,2012,00775
81,40945,19573,21372,2012,00777
82,45564,21779,23785,2012,00778
83,13340,6548,6792,2012,00780
84,18989,9552,9437,2012,00782
85,36756,17969,18787,2012,00783
86,44782,22279,22503,2012,00784
87,386,196,190,2012,00786
88,53104,25419,27685,2012,00791
89,30674,15148,15526,2012,00794
90,48403,23071,25332,2012,00795
91,6257,3550,2707,2012,00901
92,36,25,11,2012,00906
93,17049,7853,9196,2012,00907
94,5394,2667,2727,2012,00909
95,7481,3387,4094,2012,00911
96,6353,2924,3429,2012,00912
97,8648,3924,4724,2012,00913
98,32368,14612,17756,2012,00915
99,21275,9830,11445,2012,00917
100,16890,7286,9604,2012,00918
101,19528,9063,10465,2012,00920
102,38800,16993,21807,2012,00921
103,30072,14099,15973,2012,00923
104,57860,26340,31520,2012,00924
105,6896,3446,3450,2012,00925
106,108427,50532,57895,2012,00926
107,15769,6774,8995,2012,00927
108,266,173,93,2012,00934
109,1316,743,573,2012,00936
110,82068,39001,43067,2012,00949
111,0,0,0,2012,00950
112,16,10,6,2012,00951
113,10099,4852,5247,2012,00952
114,73159,35458,37701,2012,00953
115,79371,38079,41292,2012,00956
116,46330,21689,24641,2012,00957
117,48030,21373,26657,2012,00959
118,1585,1564,21,2012,00960
119,33000,16398,16602,2012,00961
120,22200,10233,11967,2012,00962
121,9256,4447,4809,2012,00965
122,17445,8080,9365,2012,00966
123,3986,1628,2358,2012,00968
124,42731,19818,22913,2012,00969
125,30042,14804,15238,2012,00971
126,64104,30570,33534,2012,00976
127,16247,7504,8743,2012,00979
128,16656,7397,9259,2012,00982
129,42485,19646,22839,2012,00983
130,37382,17524,19858,2012,00985
131,59995,27755,32240,2012,00987
132,17380,8231,9149,2012,01001
133,28718,14059,14659,2012,01002
134,11286,5053,6233,2012,01003
135,5120,2557,2563,2012,01005
136,14593,7447,7146,2012,01007
137,1160,585,575,2012,01008
138,636,326,310,2012,01009
139,3610,1660,1950,2012,01010
140,1326,642,684,2012,01011
141,506,286,220,2012,01012
142,21822,10875,10947,2012,01013
143,30893,15042,15851,2012,01020
144,2611,1137,1474,2012,01022
145,1066,539,527,2012,01026
146,17622,8403,9219,2012,01027
147,15710,7549,8161,2012,01028
148,601,343,258,2012,01029
149,11096,5658,5438,2012,01030
150,1547,789,758,2012,01031
151,626,284,342,2012,01032
152,6197,2891,3306,2012,01033
153,1952,1043,909,2012,01034
154,5239,2461,2778,2012,01035
155,5096,2517,2579,2012,01036
156,716,392,324,2012,01037
157,2676,1277,1399,2012,01038
158,1532,794,738,2012,01039
159,39996,18934,21062,2012,01040
160,2670,1223,1447,2012,01050
161,1926,1058,868,2012,01053
162,1812,873,939,2012,01054
163,21146,10567,10579,2012,01056
164,8511,4217,4294,2012,01057
165,15065,6091,8974,2012,01060
166,10980,5248,5732,2012,01062
167,671,15,656,2012,01063
168,0,0,0,2012,01066
169,1796,866,930,2012,01068
170,8881,4338,4543,2012,01069
171,529,259,270,2012,01070
172,1485,771,714,2012,01071
173,1449,724,725,2012,01072
174,5828,3016,2812,2012,01073
175,271,138,133,2012,01074
176,17705,7250,10455,2012,01075
177,9496,4573,4923,2012,01077
178,492,224,268,2012,01079
179,2329,1091,1238,2012,01080
180,1862,1031,831,2012,01081
181,10265,5152,5113,2012,01082
182,2913,1434,1479,2012,01083
183,239,116,123,2012,01084
184,40590,19459,21131,2012,01085
185,1298,580,718,2012,01086
186,595,253,342,2012,01088
187,28411,13976,14435,2012,01089
188,1440,642,798,2012,01092
189,298,175,123,2012,01093
190,240,108,132,2012,01094
191,14275,6529,7746,2012,01095
192,2220,1063,1157,2012,01096
193,83,22,61,2012,01097
194,1138,548,590,2012,01098
195,2340,1078,1262,2012,01103
196,22833,10756,12077,2012,01104
197,12664,6445,6219,2012,01105
198,16079,7406,8673,2012,01106
199,11071,5356,5715,2012,01107
200,25551,12085,13466,2012,01108
201,31503,14826,16677,2012,01109
202,13762,6196,7566,2012,01118
203,14946,7006,7940,2012,01119
204,2347,1290,1057,2012,01128
205,7330,3430,3900,2012,01129
206,8655,4257,4398,2012,01151
207,0,0,0,2012,01199
208,45975,21517,24458,2012,01201
209,8657,4179,4478,2012,01220
210,875,427,448,2012,01222
211,2399,1167,1232,2012,01223
212,291,157,134,2012,01224
213,3036,1524,1512,2012,01225
214,7024,3584,3440,2012,01226
215,170,36,134,2012,01229
216,8486,4134,4352,2012,01230
217,2867,1511,1356,2012,01235
218,1396,626,770,2012,01236
219,2599,1391,1208,2012,01237
220,6190,2872,3318,2012,01238
221,4442,2036,2406,2012,01240
222,569,396,173,2012,01242
223,267,147,120,2012,01243
224,133,65,68,2012,01244
225,821,449,372,2012,01245
226,16160,7994,8166,2012,01247
227,623,305,318,2012,01253
228,1120,529,591,2012,01254
229,886,443,443,2012,01255
230,663,368,295,2012,01256
231,2072,1030,1042,2012,01257
232,321,143,178,2012,01258
233,564,313,251,2012,01259
234,157,120,37,2012,01260
235,1171,555,616,2012,01262
236,143,65,78,2012,01264
237,1600,697,903,2012,01266
238,7994,3540,4454,2012,01267
239,776,388,388,2012,01270
240,17843,8707,9136,2012,01301
241,1439,633,806,2012,01330
242,13520,6839,6681,2012,01331
243,2528,1246,1282,2012,01337
244,231,119,112,2012,01338
245,1586,777,809,2012,01339
246,1671,857,814,2012,01340
247,1776,871,905,2012,01341
248,1481,737,744,2012,01342
249,85,34,51,2012,01343
250,1471,747,724,2012,01344
251,426,210,216,2012,01346
252,102,49,53,2012,01347
253,847,366,481,2012,01349
254,105,49,56,2012,01350
255,2367,1205,1162,2012,01351
256,1565,726,839,2012,01354
257,895,429,466,2012,01355
258,3043,1589,1454,2012,01360
259,7966,4118,3848,2012,01364
260,1301,609,692,2012,01366
261,530,263,267,2012,01367
262,1051,537,514,2012,01368
263,4127,1985,2142,2012,01370
264,4631,2095,2536,2012,01373
265,3690,1884,1806,2012,01375
266,5432,2422,3010,2012,01376
267,631,311,320,2012,01378
268,1004,513,491,2012,01379
269,40327,21011,19316,2012,01420
270,6077,3052,3025,2012,01430
271,3066,1469,1597,2012,01431
272,7105,3409,3696,2012,01432
273,1564,1362,202,2012,01434
274,3641,1587,2054,2012,01436
275,313,104,209,2012,01438
276,20393,10208,10185,2012,01440
277,10687,5455,5232,2012,01450
278,4915,2457,2458,2012,01451
279,4366,2261,2105,2012,01452
280,41113,19951,21162,2012,01453
281,8934,4324,4610,2012,01460
282,10356,5001,5355,2012,01462
283,11537,5744,5793,2012,01463
284,7352,4112,3240,2012,01464
285,401,202,199,2012,01467
286,3880,1990,1890,2012,01468
287,6822,3324,3498,2012,01469
288,7282,3642,3640,2012,01473
289,2159,1166,993,2012,01474
290,10333,5302,5031,2012,01475
291,16080,7498,8582,2012,01501
292,2856,1442,1414,2012,01503
293,9030,4582,4448,2012,01504
294,4341,2213,2128,2012,01505
295,3378,1662,1716,2012,01506
296,12947,6560,6387,2012,01507
297,13618,6840,6778,2012,01510
298,2152,1028,1124,2012,01515
299,8466,4550,3916,2012,01516
300,3089,1420,1669,2012,01518
301,6386,3200,3186,2012,01519
302,14333,7049,7284,2012,01520
303,2477,1367,1110,2012,01521
304,2994,1363,1631,2012,01522
305,7395,4158,3237,2012,01523
306,7029,3418,3611,2012,01524
307,136,80,56,2012,01525
308,13257,6347,6910,2012,01527
309,3168,1597,1571,2012,01529
310,1084,515,569,2012,01531
311,14407,7224,7183,2012,01532
312,5168,2458,2710,2012,01534
313,4681,2373,2308,2012,01535
314,7156,3569,3587,2012,01536
315,2334,1224,1110,2012,01537
316,11237,5558,5679,2012,01540
317,3423,1701,1722,2012,01541
318,1655,749,906,2012,01542
319,7967,4369,3598,2012,01543
320,35413,17704,17709,2012,01545
321,16775,7994,8781,2012,01550
322,4290,1982,2308,2012,01560
323,293,162,131,2012,01561
324,11713,5813,5900,2012,01562
325,7808,3793,4015,2012,01564
326,6141,3033,3108,2012,01566
327,7367,3530,3837,2012,01568
328,13422,6664,6758,2012,01569
329,16760,7925,8835,2012,01570
330,11401,5809,5592,2012,01571
331,18345,9139,9206,2012,01581
332,7627,4770,2857,2012,01583
333,4481,2246,2235,2012,01585
334,10411,5093,5318,2012,01588
335,8836,4248,4588,2012,01590
336,23185,10680,12505,2012,01602
337,19123,8864,10259,2012,01603
338,35844,17264,18580,2012,01604
339,26247,11766,14481,2012,01605
340,19899,9433,10466,2012,01606
341,8265,3927,4338,2012,01607
342,3767,1750,2017,2012,01608
343,21571,10538,11033,2012,01609
344,23826,11579,12247,2012,01610
345,2446,1274,1172,2012,01611
346,4846,2465,2381,2012,01612
347,31144,14976,16168,2012,01701
348,37700,17763,19937,2012,01702
349,367,156,211,2012,01718
350,5017,2562,2455,2012,01719
351,21382,10625,10757,2012,01720
352,16587,7916,8671,2012,01721
353,13515,6546,6969,2012,01730
354,1865,1005,860,2012,01731
355,4905,2475,2430,2012,01740
356,4870,2322,2548,2012,01741
357,18309,9435,8874,2012,01742
358,365,206,159,2012,01745
359,13668,6735,6933,2012,01746
360,5911,3031,2880,2012,01747
361,14982,7531,7451,2012,01748
362,19077,9460,9617,2012,01749
363,38491,19279,19212,2012,01752
364,10151,5071,5080,2012,01754
365,5827,2739,3088,2012,01756
366,28120,13824,14296,2012,01757
367,32821,15992,16829,2012,01760
368,4128,2029,2099,2012,01770
369,9380,4455,4925,2012,01772
370,4672,2228,2444,2012,01773
371,6618,3262,3356,2012,01775
372,17712,8723,8989,2012,01776
373,13136,6324,6812,2012,01778
374,38732,18937,19795,2012,01801
375,24372,11797,12575,2012,01803
376,33385,15905,17480,2012,01810
377,30569,14966,15603,2012,01821
378,24603,11965,12638,2012,01824
379,29555,14855,14700,2012,01826
380,3190,1536,1654,2012,01827
381,25229,12196,13033,2012,01830
382,22324,10618,11706,2012,01832
383,8203,4095,4108,2012,01833
384,6530,3180,3350,2012,01834
385,13400,6500,6900,2012,01835
386,4493,2239,2254,2012,01840
387,47547,23083,24464,2012,01841
388,24291,11476,12815,2012,01843
389,47238,22804,24434,2012,01844
390,28114,13796,14318,2012,01845
391,15924,7508,8416,2012,01850
392,29404,14446,14958,2012,01851
393,33316,16441,16875,2012,01852
394,28113,13175,14938,2012,01854
395,6368,3112,3256,2012,01860
396,10385,5173,5212,2012,01862
397,9328,4574,4754,2012,01863
398,14919,7651,7268,2012,01864
399,24252,11476,12776,2012,01867
400,28634,13674,14960,2012,01876
401,11484,5866,5618,2012,01879
402,24906,12024,12882,2012,01880
403,22107,11069,11038,2012,01886
404,22392,11041,11351,2012,01887
405,21437,10120,11317,2012,01890
406,2147,815,1332,2012,01901
407,44654,21579,23075,2012,01902
408,18765,9211,9554,2012,01904
409,24779,11856,12923,2012,01905
410,26761,12376,14385,2012,01906
411,14011,6412,7599,2012,01907
412,3438,1488,1950,2012,01908
413,16344,7906,8438,2012,01913
414,39748,18695,21053,2012,01915
415,7990,4071,3919,2012,01921
416,3013,1489,1524,2012,01922
417,26507,12583,13924,2012,01923
418,3520,1741,1779,2012,01929
419,28937,13451,15486,2012,01930
420,61,45,16,2012,01937
421,13271,6473,6798,2012,01938
422,12019,5976,6043,2012,01940
423,5158,2676,2482,2012,01944
424,19879,9558,10321,2012,01945
425,8992,5258,3734,2012,01949
426,17460,8188,9272,2012,01950
427,3673,1886,1787,2012,01951
428,8289,4018,4271,2012,01952
429,51036,24146,26890,2012,01960
430,7018,3280,3738,2012,01966
431,5857,2857,3000,2012,01969
432,41500,19598,21902,2012,01970
433,7942,3957,3985,2012,01982
434,6127,3040,3087,2012,01983
435,4892,2279,2613,2012,01984
436,4263,2267,1996,2012,01985
437,16304,7897,8407,2012,02019
438,21596,10163,11433,2012,02021
439,7756,3844,3912,2012,02025
440,24716,12243,12473,2012,02026
441,5608,2928,2680,2012,02030
442,3536,1754,1782,2012,02032
443,16864,8304,8560,2012,02035
444,31760,15836,15924,2012,02038
445,22136,10479,11657,2012,02043
446,10342,4647,5695,2012,02045
447,136,70,66,2012,02047
448,23191,11849,11342,2012,02048
449,25485,12617,12868,2012,02050
450,12067,6104,5963,2012,02052
451,12742,6168,6574,2012,02053
452,7905,4038,3867,2012,02054
453,11142,6755,4387,2012,02056
454,10501,5349,5152,2012,02061
455,28580,14082,14498,2012,02062
456,17708,8376,9332,2012,02066
457,17399,8290,9109,2012,02067
458,1947,1473,474,2012,02071
459,27359,12853,14506,2012,02072
460,18899,8570,10329,2012,02081
461,14616,7063,7553,2012,02090
462,10960,5729,5231,2012,02093
463,4155,2039,2116,2012,02108
464,4277,2057,2220,2012,02109
465,1486,829,657,2012,02110
466,7616,4004,3612,2012,02111
467,7276,3448,3828,2012,02113
468,11933,5848,6085,2012,02114
469,29178,14430,14748,2012,02115
470,21318,10166,11152,2012,02116
471,26779,14732,12047,2012,02118
472,24237,11212,13025,2012,02119
473,13217,6247,6970,2012,02120
474,26801,12019,14782,2012,02121
475,25437,12081,13356,2012,02122
476,49867,23297,26570,2012,02124
477,31996,15897,16099,2012,02125
478,27335,12213,15122,2012,02126
479,32547,14525,18022,2012,02127
480,41680,22363,19317,2012,02128
481,17052,7976,9076,2012,02129
482,36866,17335,19531,2012,02130
483,30370,14086,16284,2012,02131
484,27163,13150,14013,2012,02132
485,20478,10589,9889,2012,02134
486,38839,17534,21305,2012,02135
487,29219,13919,15300,2012,02136
488,35661,16919,18742,2012,02138
489,35945,17691,18254,2012,02139
490,17924,8428,9496,2012,02140
491,12703,6377,6326,2012,02141
492,2805,1560,1245,2012,02142
493,24965,12340,12625,2012,02143
494,24399,11407,12992,2012,02144
495,24153,12034,12119,2012,02145
496,59402,28848,30554,2012,02148
497,41607,20981,20626,2012,02149
498,35527,17990,17537,2012,02150
499,51729,26481,25248,2012,02151
500,17584,8286,9298,2012,02152
501,58567,27832,30735,2012,02155
502,1842,779,1063,2012,02163
503,54043,26267,27776,2012,02169
504,19962,9335,10627,2012,02170
505,18073,8668,9405,2012,02171
506,27043,13237,13806,2012,02176
507,21414,10232,11182,2012,02180
508,35731,17014,18717,2012,02184
509,26954,13071,13883,2012,02186
510,14206,6750,7456,2012,02188
511,14807,7007,7800,2012,02189
512,16176,7895,8281,2012,02190
513,8744,4079,4665,2012,02191
514,1290,631,659,2012,02199
515,0,0,0,2012,02203
516,1905,1102,803,2012,02210
517,23719,10274,13445,2012,02215
518,60265,28827,31438,2012,02301
519,33651,16368,17283,2012,02302
520,4349,2056,2293,2012,02322
521,26687,13716,12971,2012,02324
522,11497,5447,6050,2012,02330
523,15040,7136,7904,2012,02332
524,13794,6725,7069,2012,02333
525,7524,3742,3782,2012,02338
526,13902,7176,6726,2012,02339
527,10209,4900,5309,2012,02341
528,10595,5079,5516,2012,02343
529,23037,11092,11945,2012,02346
530,10674,5085,5589,2012,02347
531,15930,7513,8417,2012,02351
532,12730,6225,6505,2012,02356
533,1010,497,513,2012,02357
534,17831,8862,8969,2012,02359
535,56425,28028,28397,2012,02360
536,12609,6086,6523,2012,02364
537,149,149,0,2012,02366
538,2817,1295,1522,2012,02367
539,32577,14974,17603,2012,02368
540,17518,8337,9181,2012,02370
541,9480,4484,4996,2012,02375
542,6907,3435,3472,2012,02379
543,14493,7093,7400,2012,02382
544,13927,6601,7326,2012,02420
545,17600,8685,8915,2012,02421
546,20853,9127,11726,2012,02445
547,28807,12308,16499,2012,02446
548,16573,8241,8332,2012,02451
549,14434,6983,7451,2012,02452
550,29829,14837,14992,2012,02453
551,1343,510,833,2012,02457
552,11362,5256,6106,2012,02458
553,18210,8709,9501,2012,02459
554,8639,3901,4738,2012,02460
555,6856,3176,3680,2012,02461
556,1292,508,784,2012,02462
557,3112,1501,1611,2012,02464
558,11822,5648,6174,2012,02465
559,8591,4039,4552,2012,02466
560,22796,10044,12752,2012,02467
561,5251,2666,2585,2012,02468
562,32274,15476,16798,2012,02472
563,26079,12355,13724,2012,02474
564,16873,8271,8602,2012,02476
565,24691,11320,13371,2012,02478
566,16332,6906,9426,2012,02481
567,10513,4578,5935,2012,02482
568,19950,9854,10096,2012,02492
569,11430,5517,5913,2012,02493
570,9055,4200,4855,2012,02494
571,11592,5784,5808,2012,02532
572,982,522,460,2012,02534
573,1240,625,615,2012,02535
574,19524,9563,9961,2012,02536
575,6256,2951,3305,2012,02537
576,3162,1598,1564,2012,02538
577,4086,2267,1819,2012,02539
578,8521,4115,4406,2012,02540
579,1284,693,591,2012,02542
580,684,306,378,2012,02543
581,314,138,176,2012,02553
582,9847,4960,4887,2012,02554
583,2890,1234,1656,2012,02556
584,4513,2173,2340,2012,02557
585,1791,762,1029,2012,02558
586,3941,1957,1984,2012,02559
587,471,255,216,2012,02561
588,3232,1518,1714,2012,02562
589,9746,4630,5116,2012,02563
590,347,212,135,2012,02564
591,3967,2033,1934,2012,02568
592,11255,5317,5938,2012,02571
593,2606,1038,1568,2012,02575
594,3898,1914,1984,2012,02576
595,0,0,0,2012,02584
596,13402,6424,6978,2012,02601
597,2129,1160,969,2012,02630
598,9721,4596,5125,2012,02631
599,11466,5409,6057,2012,02632
600,4057,2009,2048,2012,02633
601,3366,1649,1717,2012,02635
602,82,40,42,2012,02637
603,3562,1676,1886,2012,02638
604,3240,1337,1903,2012,02639
605,501,247,254,2012,02641
606,4963,2411,2552,2012,02642
607,17,0,17,2012,02643
608,4389,2140,2249,2012,02644
609,9417,4226,5191,2012,02645
610,1878,866,1012,2012,02646
611,123,44,79,2012,02647
612,7206,3612,3594,2012,02648
613,13950,6614,7336,2012,02649
614,1183,555,628,2012,02650
615,20,10,10,2012,02651
616,1125,591,534,2012,02652
617,5950,2690,3260,2012,02653
618,3846,1723,2123,2012,02655
619,2974,1712,1262,2012,02657
620,741,344,397,2012,02659
621,5881,2807,3074,2012,02660
622,96,64,32,2012,02663
623,9562,4340,5222,2012,02664
624,528,277,251,2012,02666
625,3002,1290,1712,2012,02667
626,3178,1606,1572,2012,02668
627,183,89,94,2012,02669
628,1087,468,619,2012,02670
629,1011,473,538,2012,02671
630,91,42,49,2012,02672
631,8384,3908,4476,2012,02673
632,6155,2740,3415,2012,02675
633,4268,2179,2089,2012,02702
634,43603,21297,22306,2012,02703
635,139,58,81,2012,02713
636,3057,1441,1616,2012,02715
637,4599,2429,2170,2012,02717
638,6854,3634,3220,2012,02718
639,15893,7385,8508,2012,02719
640,30782,14426,16356,2012,02720
641,25566,12423,13143,2012,02721
642,14799,6902,7897,2012,02723
643,17147,8032,9115,2012,02724
644,2577,1228,1349,2012,02725
645,15654,7692,7962,2012,02726
646,4913,2527,2386,2012,02738
647,6070,2915,3155,2012,02739
648,43863,20727,23136,2012,02740
649,10310,5214,5096,2012,02743
650,11551,5391,6160,2012,02744
651,25005,11766,13239,2012,02745
652,14345,6744,7601,2012,02746
653,21538,11325,10213,2012,02747
654,12893,6063,6830,2012,02748
655,26997,13674,13323,2012,02760
656,8278,3886,4392,2012,02762
657,1676,866,810,2012,02763
658,4006,2036,1970,2012,02764
659,19123,9218,9905,2012,02766
660,13461,6502,6959,2012,02767
661,11570,6090,5480,2012,02769
662,5199,2578,2621,2012,02770
663,13785,6467,7318,2012,02771
664,15903,7692,8211,2012,02777
665,6411,3041,3370,2012,02779
666,48972,23158,25814,2012,02780
667,16074,7668,8406,2012,02790
668,46,19,27,2012,02791
669,582,314,268,2012,02802
670,2657,1509,1148,2012,02804
671,16352,7652,8700,2012,02806
672,863,442,421,2012,02807
673,2491,1289,1202,2012,02808
674,22792,11023,11769,2012,02809
675,1901,909,992,2012,02812
676,7823,3766,4057,2012,02813
677,7584,3648,3936,2012,02814
678,256,136,120,2012,02815
679,32646,15700,16946,2012,02816
680,6081,2969,3112,2012,02817
681,18189,8740,9449,2012,02818
682,6379,3358,3021,2012,02822
683,5381,2758,2623,2012,02825
684,450,211,239,2012,02826
685,2149,1057,1092,2012,02827
686,7590,3432,4158,2012,02828
687,6788,3474,3314,2012,02830
688,3340,1814,1526,2012,02831
689,5222,2397,2825,2012,02832
690,495,266,229,2012,02833
691,5420,2716,2704,2012,02835
692,119,55,64,2012,02836
693,3491,1695,1796,2012,02837
694,3780,1774,2006,2012,02838
695,1744,781,963,2012,02839
696,23438,10929,12509,2012,02840
697,967,863,104,2012,02841
698,16122,7828,8294,2012,02842
699,22587,10883,11704,2012,02852
700,8479,4127,4352,2012,02857
701,554,256,298,2012,02858
702,6610,3243,3367,2012,02859
703,43960,21074,22886,2012,02860
704,27434,13855,13579,2012,02861
705,19374,9624,9750,2012,02863
706,33340,16616,16724,2012,02864
707,16878,7997,8881,2012,02865
708,17222,8536,8686,2012,02871
709,105,53,52,2012,02872
710,172,96,76,2012,02873
711,6132,3084,3048,2012,02874
712,375,210,165,2012,02875
713,281,123,158,2012,02876
714,15738,7610,8128,2012,02878
715,20620,9660,10960,2012,02879
716,7651,3542,4109,2012,02881
717,14013,7022,6991,2012,02882
718,10652,5139,5513,2012,02885
719,29080,13653,15427,2012,02886
720,19805,9356,10449,2012,02888
721,28409,13751,14658,2012,02889
722,21078,9936,11142,2012,02891
723,4200,2019,2181,2012,02892
724,29487,14704,14783,2012,02893
725,552,191,361,2012,02894
726,41244,19365,21879,2012,02895
727,11651,5446,6205,2012,02896
728,1362,694,668,2012,02898
729,10096,5061,5035,2012,02903
730,28662,13243,15419,2012,02904
731,25936,12507,13429,2012,02905
732,28039,13221,14818,2012,02906
733,28015,13109,14906,2012,02907
734,37533,17847,19686,2012,02908
735,43446,22076,21370,2012,02909
736,20715,9926,10789,2012,02910
737,15939,7627,8312,2012,02911
738,1898,926,972,2012,02912
739,22291,10382,11909,2012,02914
740,16210,7494,8716,2012,02915
741,8644,4251,4393,2012,02916
742,13882,6547,7335,2012,02917
743,28887,13558,15329,2012,02919
744,38276,19730,18546,2012,02920
745,11865,5646,6219,2012,02921
746,11201,5667,5534,2012,03031
747,4993,2472,2521,2012,03032
748,4979,2637,2342,2012,03033
749,3970,1965,2005,2012,03034
750,4759,2247,2512,2012,03036
751,4229,2140,2089,2012,03037
752,33495,16301,17194,2012,03038
753,6352,3196,3156,2012,03042
754,1603,798,805,2012,03043
755,4260,2101,2159,2012,03044
756,13614,6716,6898,2012,03045
757,2756,1362,1394,2012,03046
758,1488,819,669,2012,03047
759,3696,1941,1755,2012,03048
760,7679,3987,3692,2012,03049
761,24484,11889,12595,2012,03051
762,8263,4199,4064,2012,03052
763,23967,12081,11886,2012,03053
764,25540,12405,13135,2012,03054
765,15079,7682,7397,2012,03055
766,2421,1195,1226,2012,03057
767,28847,14294,14553,2012,03060
768,27476,14060,13416,2012,03062
769,15814,7616,8198,2012,03063
770,14686,7210,7476,2012,03064
771,5287,2641,2646,2012,03070
772,5100,2721,2379,2012,03071
773,12850,6454,6396,2012,03076
774,10207,5052,5155,2012,03077
775,28824,14664,14160,2012,03079
776,1411,650,761,2012,03082
777,1571,720,851,2012,03084
778,3791,1827,1964,2012,03086
779,13603,6664,6939,2012,03087
780,3055,1551,1504,2012,03101
781,31575,15578,15997,2012,03102
782,36780,18250,18530,2012,03103
783,32844,16038,16806,2012,03104
784,13382,6303,7079,2012,03106
785,9673,4839,4834,2012,03109
786,21180,10183,10997,2012,03110
787,318,182,136,2012,03215
788,2133,1035,1098,2012,03216
789,1653,692,961,2012,03217
790,805,462,343,2012,03218
791,7360,3618,3742,2012,03220
792,1853,908,945,2012,03221
793,5692,2726,2966,2012,03222
794,3389,1671,1718,2012,03223
795,2419,1136,1283,2012,03224
796,3781,1864,1917,2012,03225
797,1034,459,575,2012,03226
798,867,400,467,2012,03227
799,5608,2981,2627,2012,03229
800,1290,647,643,2012,03230
801,370,150,220,2012,03231
802,170,91,79,2012,03233
803,4572,2326,2246,2012,03234
804,8615,4251,4364,2012,03235
805,2499,1236,1263,2012,03237
806,68,38,30,2012,03238
807,1383,720,663,2012,03240
808,797,456,341,2012,03241
809,4839,2346,2493,2012,03242
810,1210,617,593,2012,03243
811,8052,3784,4268,2012,03244
812,1671,827,844,2012,03245
813,16067,7513,8554,2012,03246
814,7140,3609,3531,2012,03249
815,1278,695,583,2012,03251
816,6265,3128,3137,2012,03253
817,4078,2123,1955,2012,03254
818,2110,1048,1062,2012,03255
819,2229,1054,1175,2012,03256
820,4411,1950,2461,2012,03257
821,2532,1363,1169,2012,03258
822,323,184,139,2012,03259
823,762,372,390,2012,03260
824,4244,2284,1960,2012,03261
825,1180,640,540,2012,03262
826,4104,2094,2010,2012,03263
827,7543,3751,3792,2012,03264
828,2366,1167,1199,2012,03266
829,1155,581,574,2012,03268
830,2958,1382,1576,2012,03269
831,302,155,147,2012,03273
832,11504,5644,5860,2012,03275
833,8414,4295,4119,2012,03276
834,3029,1624,1405,2012,03278
835,701,367,334,2012,03279
836,1071,575,496,2012,03280
837,8779,4509,4270,2012,03281
838,916,479,437,2012,03282
839,1115,609,506,2012,03284
840,2282,1202,1080,2012,03285
841,1318,643,675,2012,03287
842,4689,2358,2331,2012,03290
843,29,15,14,2012,03291
844,77,45,32,2012,03293
845,32814,16204,16610,2012,03301
846,15671,7522,8149,2012,03303
847,7571,3817,3754,2012,03304
848,5307,2639,2668,2012,03307
849,25388,11837,13551,2012,03431
850,2623,1272,1351,2012,03440
851,566,310,256,2012,03441
852,1384,661,723,2012,03442
853,917,428,489,2012,03443
854,1709,805,904,2012,03444
855,700,365,335,2012,03445
856,6248,3243,3005,2012,03446
857,2567,1318,1249,2012,03447
858,542,295,247,2012,03448
859,1722,839,883,2012,03449
860,923,444,479,2012,03450
861,4046,2076,1970,2012,03451
862,5462,2508,2954,2012,03452
863,1997,922,1075,2012,03455
864,890,463,427,2012,03456
865,776,358,418,2012,03457
866,6641,2996,3645,2012,03458
867,6001,2916,3085,2012,03461
868,1787,931,856,2012,03462
869,998,482,516,2012,03464
870,2121,1108,1013,2012,03465
871,946,426,520,2012,03466
872,2150,1112,1038,2012,03467
873,4758,2390,2368,2012,03470
874,5958,2761,3197,2012,03561
875,10009,5286,4723,2012,03570
876,2515,1252,1263,2012,03574
877,87,47,40,2012,03575
878,3206,1598,1608,2012,03576
879,447,210,237,2012,03579
880,1494,690,804,2012,03580
881,3211,1588,1623,2012,03581
882,2715,1395,1320,2012,03582
883,812,375,437,2012,03583
884,3618,1714,1904,2012,03584
885,2671,1364,1307,2012,03585
886,596,300,296,2012,03586
887,1766,852,914,2012,03588
888,1067,573,494,2012,03590
889,1334,696,638,2012,03592
890,419,231,188,2012,03593
891,726,374,352,2012,03595
892,458,211,247,2012,03597
893,3065,1587,1478,2012,03598
894,497,272,225,2012,03601
895,2604,1286,1318,2012,03602
896,5364,2593,2771,2012,03603
897,249,127,122,2012,03604
898,1212,591,621,2012,03605
899,250,138,112,2012,03607
900,2167,1078,1089,2012,03608
901,1315,671,644,2012,03609
902,761,407,354,2012,03740
903,4231,2250,1981,2012,03741
904,14036,6704,7332,2012,03743
905,1511,751,760,2012,03745
906,154,61,93,2012,03746
907,4657,2216,2441,2012,03748
908,1048,523,525,2012,03750
909,485,232,253,2012,03751
910,767,362,405,2012,03752
911,2928,1487,1441,2012,03753
912,0,0,0,2012,03754
913,10268,4833,5435,2012,03755
914,593,270,323,2012,03765
915,9379,4544,4835,2012,03766
916,1857,924,933,2012,03768
917,550,262,288,2012,03770
918,882,353,529,2012,03771
919,7729,3708,4021,2012,03773
920,1726,884,842,2012,03774
921,1451,736,715,2012,03777
922,827,469,358,2012,03779
923,283,149,134,2012,03780
924,2020,1057,963,2012,03781
925,3033,1640,1393,2012,03782
926,3859,2043,1816,2012,03784
927,2706,1391,1315,2012,03785
928,21799,10498,11301,2012,03801
929,3503,1717,1786,2012,03809
930,1737,918,819,2012,03810
931,6756,3055,3701,2012,03811
932,649,306,343,2012,03812
933,3916,2104,1812,2012,03813
934,2316,1149,1167,2012,03814
935,1352,669,683,2012,03816
936,802,469,333,2012,03817
937,3599,1824,1775,2012,03818
938,4410,2259,2151,2012,03819
939,30041,14755,15286,2012,03820
940,1997,1041,956,2012,03823
941,14695,6504,8191,2012,03824
942,8517,4233,4284,2012,03825
943,2629,1283,1346,2012,03826
944,3155,1488,1667,2012,03827
945,1468,688,780,2012,03830
946,393,203,190,2012,03832
947,20993,10293,10700,2012,03833
948,6768,3424,3344,2012,03835
949,1197,577,620,2012,03836
950,1262,677,585,2012,03837
951,1337,584,753,2012,03838
952,3959,1898,2061,2012,03839
953,3571,1757,1814,2012,03840
954,6272,3261,3011,2012,03841
955,14983,7401,7582,2012,03842
956,2287,1165,1122,2012,03844
957,869,483,386,2012,03845
958,986,507,479,2012,03846
959,258,117,141,2012,03847
960,6047,2837,3210,2012,03848
961,1440,655,785,2012,03849
962,254,108,146,2012,03850
963,3987,2094,1893,2012,03851
964,579,288,291,2012,03852
965,907,481,426,2012,03853
966,990,515,475,2012,03854
967,2627,1455,1172,2012,03855
968,1671,874,797,2012,03856
969,9002,4389,4613,2012,03857
970,4642,2207,2435,2012,03858
971,3815,1816,1999,2012,03860
972,4334,2191,2143,2012,03861
973,4323,1991,2332,2012,03862
974,1747,842,905,2012,03864
975,7630,3759,3871,2012,03865
976,20066,9420,10646,2012,03867
977,5879,2965,2914,2012,03868
978,2506,1248,1258,2012,03869
979,5299,2487,2812,2012,03870
980,11,0,11,2012,03871
981,3703,1844,1859,2012,03872
982,5634,2769,2865,2012,03873
983,8909,4754,4155,2012,03874
984,968,497,471,2012,03875
985,11816,5668,6148,2012,03878
986,1344,694,650,2012,03882
987,86,41,45,2012,03883
988,3992,2051,1941,2012,03884
989,7238,3609,3629,2012,03885
990,1969,1005,964,2012,03886
991,2086,1055,1031,2012,03887
992,278,131,147,2012,03890
993,6286,3035,3251,2012,03894
994,7291,3385,3906,2012,03901
995,2042,1014,1028,2012,03902
996,6224,3225,2999,2012,03903
997,8114,3643,4471,2012,03904
998,1424,625,799,2012,03905
999,4588,2168,2420,2012,03906
1000,1183,634,549,2012,03907
1001,7230,3413,3817,2012,03908
1002,10369,4932,5437,2012,03909
1003,113,75,38,2012,03910
1004,101,49,52,2012,03911
1005,2445,1280,1165,2012,04001
1006,7362,3954,3408,2012,04002
1007,674,348,326,2012,04003
1008,23516,11564,11952,2012,04005
1009,34,6,28,2012,04006
1010,2754,1435,1319,2012,04008
1011,5212,2611,2601,2012,04009
1012,1317,666,651,2012,04010
1013,20376,9492,10884,2012,04011
1014,3825,1742,2083,2012,04015
1015,285,130,155,2012,04017
1016,69,42,27,2012,04019
1017,1482,714,768,2012,04020
1018,5847,2696,3151,2012,04021
1019,1013,526,487,2012,04022
1020,596,305,291,2012,04024
1021,6024,2952,3072,2012,04027
1022,1605,803,802,2012,04029
1023,2053,1088,965,2012,04030
1024,7946,3625,4321,2012,04032
1025,3838,1704,2134,2012,04037
1026,16395,8017,8378,2012,04038
1027,7287,3976,3311,2012,04039
1028,3064,1569,1495,2012,04040
1029,1808,938,870,2012,04041
1030,4299,2190,2109,2012,04042
1031,10869,5156,5713,2012,04043
1032,7554,3645,3909,2012,04046
1033,1494,758,736,2012,04047
1034,2937,1534,1403,2012,04048
1035,3649,1891,1758,2012,04049
1036,310,159,151,2012,04050
1037,1054,519,535,2012,04051
1038,3761,2059,1702,2012,04055
1039,167,71,96,2012,04056
1040,17,17,0,2012,04057
1041,3707,1905,1802,2012,04061
1042,17026,8640,8386,2012,04062
1043,278,119,159,2012,04063
1044,8392,4010,4382,2012,04064
1045,393,180,213,2012,04066
1046,1692,853,839,2012,04068
1047,1439,689,750,2012,04069
1048,5025,2584,2441,2012,04071
1049,18561,8811,9750,2012,04072
1050,16348,7592,8756,2012,04073
1051,18809,9140,9669,2012,04074
1052,2672,1326,1346,2012,04076
1053,3721,1755,1966,2012,04079
1054,4537,2040,2497,2012,04083
1055,8359,4299,4060,2012,04084
1056,1523,604,919,2012,04085
1057,8819,4234,4585,2012,04086
1058,1901,1093,808,2012,04087
1059,1964,913,1051,2012,04088
1060,9662,4780,4882,2012,04090
1061,989,479,510,2012,04091
1062,17501,8212,9289,2012,04092
1063,8052,3964,4088,2012,04093
1064,1187,621,566,2012,04095
1065,8390,4054,4336,2012,04096
1066,3578,1608,1970,2012,04097
1067,17844,8770,9074,2012,04101
1068,16610,8058,8552,2012,04102
1069,30639,14825,15814,2012,04103
1070,11191,5557,5634,2012,04105
1071,25194,11650,13544,2012,04106
1072,8990,4374,4616,2012,04107
1073,1000,474,526,2012,04108
1074,73,41,32,2012,04109
1075,1389,729,660,2012,04110
1076,23104,11400,11704,2012,04210
1077,487,244,243,2012,04216
1078,3112,1586,1526,2012,04217
1079,1511,779,732,2012,04219
1080,2923,1520,1403,2012,04220
1081,1176,616,560,2012,04221
1082,3853,1923,1930,2012,04222
1083,3061,1467,1594,2012,04224
1084,157,70,87,2012,04226
1085,48,24,24,2012,04227
1086,26,13,13,2012,04228
1087,195,104,91,2012,04231
1088,242,86,156,2012,04234
1089,4348,2136,2212,2012,04236
1090,135,74,61,2012,04237
1091,1334,736,598,2012,04238
1092,4859,2377,2482,2012,04239
1093,36588,17805,18783,2012,04240
1094,4111,2061,2050,2012,04250
1095,4912,2486,2426,2012,04252
1096,2145,1114,1031,2012,04253
1097,3161,1526,1635,2012,04254
1098,915,502,413,2012,04255
1099,3038,1480,1558,2012,04256
1100,2701,1357,1344,2012,04257
1101,2601,1328,1273,2012,04258
1102,3299,1564,1735,2012,04259
1103,5533,2799,2734,2012,04260
1104,369,175,194,2012,04261
1105,1972,1007,965,2012,04263
1106,829,451,378,2012,04265
1107,84,63,21,2012,04267
1108,5023,2319,2704,2012,04268
1109,5929,2849,3080,2012,04270
1110,0,0,0,2012,04271
1111,5368,2512,2856,2012,04274
1112,389,205,184,2012,04275
1113,5873,2906,2967,2012,04276
1114,6827,3206,3621,2012,04280
1115,5174,2851,2323,2012,04281
1116,5712,2853,2859,2012,04282
1117,1002,480,522,2012,04284
1118,414,197,217,2012,04285
1119,103,48,55,2012,04286
1120,3203,1683,1520,2012,04287
1121,1972,1014,958,2012,04289
1122,1545,772,773,2012,04290
1123,1059,490,569,2012,04292
1124,4049,1954,2095,2012,04294
1125,26092,12579,13513,2012,04330
1126,1759,899,860,2012,04342
1127,82,31,51,2012,04343
1128,2921,1437,1484,2012,04344
1129,11663,5659,6004,2012,04345
1130,1726,811,915,2012,04346
1131,2538,1316,1222,2012,04347
1132,3059,1486,1573,2012,04348
1133,1224,601,623,2012,04349
1134,3596,1741,1855,2012,04350
1135,2573,1320,1253,2012,04351
1136,1548,769,779,2012,04352
1137,2357,1178,1179,2012,04353
1138,1533,763,770,2012,04354
1139,2581,1183,1398,2012,04355
1140,3413,1662,1751,2012,04357
1141,4261,2151,2110,2012,04358
1142,356,170,186,2012,04359
1143,560,244,316,2012,04360
1144,2564,1288,1276,2012,04363
1145,6025,2833,3192,2012,04364
1146,45087,21584,23503,2012,04401
1147,692,365,327,2012,04406
1148,156,75,81,2012,04408
1149,1158,542,616,2012,04410
1150,1553,759,794,2012,04411
1151,9452,4573,4879,2012,04412
1152,164,78,86,2012,04413
1153,1442,739,703,2012,04414
1154,226,116,110,2012,04415
1155,5493,2735,2758,2012,04416
1156,366,161,205,2012,04417
1157,1519,791,728,2012,04418
1158,2775,1376,1399,2012,04419
1159,1673,1026,647,2012,04421
1160,1494,872,622,2012,04422
1161,801,436,365,2012,04424
1162,4600,2133,2467,2012,04426
1163,2807,1384,1423,2012,04427
1164,3296,1669,1627,2012,04428
1165,4890,2469,2421,2012,04429
1166,1839,813,1026,2012,04430
1167,91,38,53,2012,04431
1168,1352,648,704,2012,04434
1169,1053,508,545,2012,04435
1170,1346,602,744,2012,04438
1171,2020,963,1057,2012,04441
1172,63,32,31,2012,04442
1173,2422,1205,1217,2012,04443
1174,8699,4436,4263,2012,04444
1175,1462,756,706,2012,04448
1176,1338,661,677,2012,04449
1177,1198,634,564,2012,04450
1178,251,147,104,2012,04451
1179,800,378,422,2012,04453
1180,86,40,46,2012,04454
1181,1231,689,542,2012,04455
1182,2835,1435,1400,2012,04456
1183,5738,2900,2838,2012,04457
1184,990,563,427,2012,04459
1185,1413,771,642,2012,04460
1186,3056,1518,1538,2012,04461
1187,4835,2562,2273,2012,04462
1188,2700,1380,1320,2012,04463
1189,622,318,304,2012,04464
1190,9626,4444,5182,2012,04468
1191,2637,1463,1174,2012,04469
1192,485,271,214,2012,04471
1193,2040,1014,1026,2012,04472
1194,7741,3872,3869,2012,04473
1195,3737,1789,1948,2012,04474
1196,493,236,257,2012,04475
1197,1086,474,612,2012,04476
1198,333,197,136,2012,04478
1199,1460,734,726,2012,04479
1200,492,249,243,2012,04481
1201,320,152,168,2012,04485
1202,835,446,389,2012,04487
1203,1239,607,632,2012,04488
1204,213,116,97,2012,04489
1205,220,114,106,2012,04490
1206,120,68,52,2012,04491
1207,169,78,91,2012,04492
1208,1927,984,943,2012,04493
1209,364,209,155,2012,04495
1210,3766,1886,1880,2012,04496
1211,407,211,196,2012,04497
1212,10968,5077,5891,2012,04530
1213,616,305,311,2012,04535
1214,2058,987,1071,2012,04537
1215,2041,1012,1029,2012,04538
1216,1054,571,483,2012,04539
1217,138,69,69,2012,04541
1218,2170,952,1218,2012,04543
1219,706,377,329,2012,04544
1220,1199,594,605,2012,04547
1221,935,442,493,2012,04548
1222,784,396,388,2012,04551
1223,1814,835,979,2012,04553
1224,727,297,430,2012,04554
1225,1699,815,884,2012,04555
1226,1082,485,597,2012,04556
1227,305,101,204,2012,04558
1228,2228,1086,1142,2012,04562
1229,1343,687,656,2012,04563
1230,524,286,238,2012,04564
1231,531,239,292,2012,04568
1232,0,0,0,2012,04570
1233,352,208,144,2012,04571
1234,5062,2416,2646,2012,04572
1235,433,204,229,2012,04573
1236,1468,788,680,2012,04574
1237,109,58,51,2012,04575
1238,539,261,278,2012,04576
1239,4487,2512,1975,2012,04578
1240,3074,1548,1526,2012,04579
1241,12651,6023,6628,2012,04605
1242,1252,603,649,2012,04606
1243,1115,568,547,2012,04607
1244,5062,2351,2711,2012,04609
1245,453,231,222,2012,04611
1246,674,322,352,2012,04612
1247,187,96,91,2012,04613
1248,2527,1094,1433,2012,04614
1249,981,486,495,2012,04616
1250,904,476,428,2012,04617
1251,3132,1431,1701,2012,04619
1252,1391,662,729,2012,04622
1253,1271,699,572,2012,04623
1254,201,83,118,2012,04624
1255,19,10,9,2012,04625
1256,560,311,249,2012,04626
1257,1478,749,729,2012,04627
1258,705,347,358,2012,04628
1259,154,13,141,2012,04629
1260,1267,632,635,2012,04630
1261,1458,670,788,2012,04631
1262,1873,951,922,2012,04634
1263,73,37,36,2012,04635
1264,142,71,71,2012,04637
1265,1973,1006,967,2012,04640
1266,79,28,51,2012,04642
1267,1060,498,562,2012,04643
1268,168,61,107,2012,04644
1269,93,56,37,2012,04645
1270,79,25,54,2012,04646
1271,511,237,274,2012,04648
1272,1308,635,673,2012,04649
1273,187,93,94,2012,04650
1274,1815,861,954,2012,04652
1275,439,194,245,2012,04653
1276,3422,1678,1744,2012,04654
1277,1161,675,486,2012,04655
1278,337,163,174,2012,04657
1279,1373,653,720,2012,04658
1280,1349,670,679,2012,04660
1281,442,217,225,2012,04662
1282,1210,620,590,2012,04664
1283,1215,625,590,2012,04666
1284,1546,752,794,2012,04667
1285,1727,883,844,2012,04668
1286,167,80,87,2012,04669
1287,579,308,271,2012,04671
1288,150,69,81,2012,04673
1289,662,340,322,2012,04674
1290,295,126,169,2012,04675
1291,1076,576,500,2012,04676
1292,206,104,102,2012,04677
1293,1848,845,1003,2012,04679
1294,1031,474,557,2012,04680
1295,1192,628,564,2012,04681
1296,61,22,39,2012,04683
1297,1736,923,813,2012,04684
1298,386,200,186,2012,04685
1299,90,53,37,2012,04686
1300,493,243,250,2012,04691
1301,450,243,207,2012,04693
1302,2207,1054,1153,2012,04694
1303,10210,5026,5184,2012,04730
1304,1804,968,836,2012,04732
1305,259,164,95,2012,04733
1306,751,382,369,2012,04734
1307,622,315,307,2012,04735
1308,9813,4727,5086,2012,04736
1309,937,452,485,2012,04739
1310,1249,640,609,2012,04740
1311,0,0,0,2012,04741
1312,3478,1720,1758,2012,04742
1313,4608,2261,2347,2012,04743
1314,1057,519,538,2012,04745
1315,481,242,239,2012,04746
1316,1534,797,737,2012,04747
1317,2508,1224,1284,2012,04750
1318,3563,1721,1842,2012,04756
1319,2775,1397,1378,2012,04757
1320,1617,840,777,2012,04758
1321,725,363,362,2012,04760
1322,441,209,232,2012,04761
1323,576,286,290,2012,04762
1324,748,372,376,2012,04763
1325,41,21,20,2012,04764
1326,1407,736,671,2012,04765
1327,366,169,197,2012,04766
1328,384,177,207,2012,04768
1329,9638,4521,5117,2012,04769
1330,771,376,395,2012,04772
1331,505,258,247,2012,04773
1332,664,354,310,2012,04774
1333,844,404,440,2012,04776
1334,420,224,196,2012,04777
1335,297,170,127,2012,04779
1336,856,470,386,2012,04780
1337,509,285,224,2012,04781
1338,326,161,165,2012,04783
1339,2994,1435,1559,2012,04785
1340,1980,914,1066,2012,04786
1341,621,280,341,2012,04787
1342,7314,3471,3843,2012,04841
1343,4883,2174,2709,2012,04843
1344,1635,797,838,2012,04847
1345,626,292,334,2012,04848
1346,3621,1746,1875,2012,04849
1347,41,19,22,2012,04851
1348,34,22,12,2012,04852
1349,456,228,228,2012,04853
1350,1667,818,849,2012,04854
1351,355,154,201,2012,04855
1352,3344,1548,1796,2012,04856
1353,1390,688,702,2012,04858
1354,476,251,225,2012,04859
1355,1788,837,951,2012,04860
1356,2820,1370,1450,2012,04861
1357,3732,1914,1818,2012,04862
1358,1126,691,435,2012,04863
1359,4718,2741,1977,2012,04864
1360,26281,12738,13543,2012,04901
1361,1926,915,1011,2012,04910
1362,1988,1100,888,2012,04911
1363,1131,504,627,2012,04912
1364,8780,4076,4704,2012,04915
1365,2908,1491,1417,2012,04917
1366,270,118,152,2012,04918
1367,1730,894,836,2012,04920
1368,1546,756,790,2012,04921
1369,1118,569,549,2012,04922
1370,554,276,278,2012,04923
1371,2169,1021,1148,2012,04924
1372,81,40,41,2012,04925
1373,69,54,15,2012,04926
1374,3470,1745,1725,2012,04927
1375,2138,1032,1106,2012,04928
1376,863,449,414,2012,04929
1377,4433,1977,2456,2012,04930
1378,1185,588,597,2012,04932
1379,70,33,37,2012,04933
1380,251,137,114,2012,04936
1381,6527,3300,3227,2012,04937
1382,9831,4788,5043,2012,04938
1383,985,484,501,2012,04939
1384,39,0,39,2012,04940
1385,1657,790,867,2012,04941
1386,1178,633,545,2012,04942
1387,1688,821,867,2012,04943
1388,30,16,14,2012,04944
1389,1184,582,602,2012,04945
1390,1799,869,930,2012,04947
1391,747,358,389,2012,04949
1392,4818,2287,2531,2012,04950
1393,950,449,501,2012,04951
1394,1869,943,926,2012,04952
1395,3205,1513,1692,2012,04953
1396,1399,697,702,2012,04955
1397,676,323,353,2012,04956
1398,4161,2238,1923,2012,04957
1399,1933,921,1012,2012,04958
1400,964,487,477,2012,04961
1401,119,65,54,2012,04962
1402,7224,3519,3705,2012,04963
1403,158,78,80,2012,04964
1404,2099,1011,1088,2012,04965
1405,1864,928,936,2012,04966
1406,4235,1994,2241,2012,04967
1407,1155,582,573,2012,04969
1408,1608,835,773,2012,04970
1409,1922,929,993,2012,04971
1410,1529,849,680,2012,04973
1411,2634,1458,1176,2012,04974
1412,151,107,44,2012,04975
1413,9993,4829,5164,2012,04976
1414,936,440,496,2012,04978
1415,1105,543,562,2012,04979
1416,2293,1165,1128,2012,04981
1417,629,318,311,2012,04982
1418,1605,809,796,2012,04983
1419,568,285,283,2012,04984
1420,72,32,40,2012,04985
1421,1667,860,807,2012,04986
1422,848,411,437,2012,04987
1423,2311,1060,1251,2012,04988
1424,4235,2063,2172,2012,04989
1425,156,57,99,2012,04992
1426,9301,4470,4831,2012,05001
1427,130,79,51,2012,05031
1428,3068,1448,1620,2012,05032
1429,2742,1336,1406,2012,05033
1430,184,74,110,2012,05034
1431,512,261,251,2012,05035
1432,906,486,420,2012,05036
1433,561,283,278,2012,05037
1434,1412,692,720,2012,05038
1435,917,489,428,2012,05039
1436,505,256,249,2012,05040
1437,720,312,408,2012,05041
1438,622,320,302,2012,05042
1439,888,475,413,2012,05043
1440,2065,995,1070,2012,05045
1441,1088,514,574,2012,05046
1442,2644,1437,1207,2012,05048
1443,202,112,90,2012,05050
1444,1629,823,806,2012,05051
1445,187,81,106,2012,05052
1446,378,151,227,2012,05053
1447,3423,1635,1788,2012,05055
1448,445,247,198,2012,05056
1449,249,118,131,2012,05058
1450,773,358,415,2012,05059
1451,4223,2134,2089,2012,05060
1452,1416,830,586,2012,05061
1453,671,326,345,2012,05062
1454,1173,592,581,2012,05065
1455,244,118,126,2012,05067
1456,3093,1552,1541,2012,05068
1457,541,232,309,2012,05069
1458,512,269,243,2012,05070
1459,455,206,249,2012,05071
1460,520,290,230,2012,05072
1461,1072,492,580,2012,05075
1462,515,271,244,2012,05076
1463,1151,547,604,2012,05077
1464,673,366,307,2012,05079
1465,497,230,267,2012,05081
1466,114,58,56,2012,05083
1467,17,7,10,2012,05084
1468,819,406,413,2012,05086
1469,4953,2556,2397,2012,05089
1470,3257,1406,1851,2012,05091
1471,4666,2236,2430,2012,05101
1472,61,19,42,2012,05141
1473,797,383,414,2012,05142
1474,4186,1944,2242,2012,05143
1475,663,370,293,2012,05146
1476,1125,566,559,2012,05148
1477,2145,1071,1074,2012,05149
1478,864,410,454,2012,05150
1479,1332,660,672,2012,05151
1480,457,233,224,2012,05152
1481,706,359,347,2012,05153
1482,757,312,445,2012,05154
1483,605,266,339,2012,05155
1484,9324,4819,4505,2012,05156
1485,1331,611,720,2012,05158
1486,588,315,273,2012,05161
1487,14524,7216,7308,2012,05201
1488,3497,1616,1881,2012,05250
1489,1439,687,752,2012,05251
1490,248,107,141,2012,05252
1491,596,325,271,2012,05253
1492,420,216,204,2012,05254
1493,3944,1834,2110,2012,05255
1494,2796,1248,1548,2012,05257
1495,279,151,128,2012,05260
1496,2911,1472,1439,2012,05261
1497,2663,1238,1425,2012,05262
1498,16793,8070,8723,2012,05301
1499,659,312,347,2012,05340
1500,471,229,242,2012,05341
1501,537,271,266,2012,05342
1502,774,364,410,2012,05343
1503,2256,1142,1114,2012,05345
1504,4783,2399,2384,2012,05346
1505,799,426,373,2012,05350
1506,819,413,406,2012,05352
1507,973,483,490,2012,05353
1508,2138,1054,1084,2012,05354
1509,599,312,287,2012,05355
1510,893,465,428,2012,05356
1511,225,99,126,2012,05358
1512,569,280,289,2012,05359
1513,238,122,116,2012,05360
1514,946,540,406,2012,05361
1515,132,53,79,2012,05362
1516,2518,1344,1174,2012,05363
1517,27970,14017,13953,2012,05401
1518,17751,8689,9062,2012,05403
1519,7035,3430,3605,2012,05404
1520,4136,1727,2409,2012,05405
1521,10302,4906,5396,2012,05408
1522,1649,686,963,2012,05439
1523,1785,920,865,2012,05440
1524,1076,535,541,2012,05441
1525,327,151,176,2012,05442
1526,6503,3140,3363,2012,05443
1527,1790,839,951,2012,05444
1528,3756,1950,1806,2012,05445
1529,15743,7662,8081,2012,05446
1530,94,48,46,2012,05447
1531,1090,608,482,2012,05448
1532,4808,2605,2203,2012,05450
1533,19810,9520,10290,2012,05452
1534,4845,2356,2489,2012,05454
1535,1143,603,540,2012,05455
1536,1467,825,642,2012,05456
1537,1433,775,658,2012,05457
1538,2221,1146,1075,2012,05458
1539,2269,1034,1235,2012,05459
1540,4505,2248,2257,2012,05461
1541,1935,986,949,2012,05462
1542,510,244,266,2012,05463
1543,2747,1369,1378,2012,05464
1544,5279,2654,2625,2012,05465
1545,13065,6211,6854,2012,05468
1546,658,322,336,2012,05471
1547,1623,823,800,2012,05472
1548,1474,768,706,2012,05473
1549,871,443,428,2012,05474
1550,3401,1623,1778,2012,05476
1551,4486,2225,2261,2012,05477
1552,13870,6649,7221,2012,05478
1553,0,0,0,2012,05481
1554,7315,3697,3618,2012,05482
1555,1455,670,785,2012,05483
1556,62,32,30,2012,05485
1557,1645,773,872,2012,05486
1558,1539,793,746,2012,05487
1559,8003,4034,3969,2012,05488
1560,3102,1553,1549,2012,05489
1561,5854,3032,2822,2012,05491
1562,795,434,361,2012,05492
1563,1853,939,914,2012,05494
1564,9351,4554,4797,2012,05495
1565,11767,5474,6293,2012,05602
1566,268,109,159,2012,05640
1567,17622,8714,8908,2012,05641
1568,1189,612,577,2012,05647
1569,425,210,215,2012,05648
1570,845,463,382,2012,05649
1571,1048,560,488,2012,05650
1572,1655,742,913,2012,05651
1573,854,461,393,2012,05652
1574,438,226,212,2012,05653
1575,577,246,331,2012,05654
1576,2880,1436,1444,2012,05655
1577,3512,1800,1712,2012,05656
1578,41,22,19,2012,05657
1579,1557,770,787,2012,05658
1580,1607,768,839,2012,05660
1581,5653,2992,2661,2012,05661
1582,6771,3711,3060,2012,05663
1583,0,0,0,2012,05664
1584,2287,1158,1129,2012,05667
1585,537,250,287,2012,05669
1586,4319,1926,2393,2012,05672
1587,2443,1226,1217,2012,05673
1588,1494,826,668,2012,05674
1589,987,530,457,2012,05675
1590,5091,2372,2719,2012,05676
1591,2060,1045,1015,2012,05677
1592,99,51,48,2012,05678
1593,3367,1523,1844,2012,05679
1594,2074,1076,998,2012,05680
1595,402,190,212,2012,05681
1596,1270,645,625,2012,05682
1597,20404,9355,11049,2012,05701
1598,240,116,124,2012,05730
1599,802,429,373,2012,05732
1600,5894,2949,2945,2012,05733
1601,1322,704,618,2012,05734
1602,4049,2223,1826,2012,05735
1603,892,495,397,2012,05736
1604,814,415,399,2012,05737
1605,1136,662,474,2012,05738
1606,1508,756,752,2012,05739
1607,0,0,0,2012,05740
1608,693,358,335,2012,05742
1609,4314,2265,2049,2012,05743
1610,568,285,283,2012,05744
1611,304,156,148,2012,05747
1612,403,216,187,2012,05748
1613,798,393,405,2012,05751
1614,10484,5091,5393,2012,05753
1615,770,373,397,2012,05757
1616,736,370,366,2012,05758
1617,1617,856,761,2012,05759
1618,1037,492,545,2012,05760
1619,1108,521,587,2012,05761
1620,580,293,287,2012,05762
1621,2651,1427,1224,2012,05763
1622,3448,1600,1848,2012,05764
1623,1788,858,930,2012,05765
1624,544,273,271,2012,05766
1625,959,465,494,2012,05767
1626,1230,598,632,2012,05769
1627,1059,545,514,2012,05770
1628,640,341,299,2012,05772
1629,2215,1095,1120,2012,05773
1630,1449,761,688,2012,05774
1631,633,300,333,2012,05775
1632,729,357,372,2012,05776
1633,3666,1881,1785,2012,05777
1634,728,355,373,2012,05778
1635,9639,4714,4925,2012,05819
1636,651,339,312,2012,05820
1637,1252,607,645,2012,05821
1638,1750,889,861,2012,05822
1639,1080,540,540,2012,05824
1640,292,156,136,2012,05825
1641,998,480,518,2012,05826
1642,286,147,139,2012,05827
1643,2049,976,1073,2012,05828
1644,1763,819,944,2012,05829
1645,1836,896,940,2012,05830
1646,836,444,392,2012,05832
1647,193,115,78,2012,05833
1648,1184,625,559,2012,05836
1649,394,219,175,2012,05837
1650,757,349,408,2012,05839
1651,376,187,189,2012,05841
1652,592,290,302,2012,05842
1653,2570,1289,1281,2012,05843
1654,1024,545,479,2012,05845
1655,954,437,517,2012,05846
1656,915,507,408,2012,05847
1657,157,124,33,2012,05850
1658,6505,3190,3315,2012,05851
1659,798,390,408,2012,05853
1660,7204,3452,3752,2012,05855
1661,1463,733,730,2012,05857
1662,472,237,235,2012,05858
1663,1954,1001,953,2012,05859
1664,2518,1257,1261,2012,05860
1665,347,161,186,2012,05862
1666,545,286,259,2012,05866
1667,921,467,454,2012,05867
1668,319,182,137,2012,05868
1669,1625,823,802,2012,05871
1670,664,370,294,2012,05872
1671,569,297,272,2012,05873
1672,581,284,297,2012,05874
1673,479,277,202,2012,05875
1674,5,3,2,2012,05901
1675,163,67,96,2012,05902
1676,1070,556,514,2012,05903
1677,253,128,125,2012,05904
1678,721,354,367,2012,05905
1679,1335,721,614,2012,05906
1680,174,86,88,2012,05907
1681,18410,8880,9530,2012,06001
1682,20470,9250,11220,2012,06002
1683,60478,29601,30877,2012,06010
1684,9317,4712,4605,2012,06013
1685,6332,2930,3402,2012,06016
1686,2690,1305,1385,2012,06018
1687,10149,4713,5436,2012,06019
1688,0,0,0,2012,06020
1689,345,169,176,2012,06021
1690,94,34,60,2012,06022
1691,1004,543,461,2012,06023
1692,768,373,395,2012,06024
1693,4929,2549,2380,2012,06026
1694,1481,754,727,2012,06027
1695,15466,7777,7689,2012,06029
1696,1273,626,647,2012,06031
1697,17880,8691,9189,2012,06032
1698,28563,13806,14757,2012,06033
1699,7697,4033,3664,2012,06035
1700,18970,9282,9688,2012,06037
1701,1970,804,1166,2012,06039
1702,35974,17641,18333,2012,06040
1703,22104,10781,11323,2012,06042
1704,4990,2516,2474,2012,06043
1705,30568,14561,16007,2012,06051
1706,7661,3600,4061,2012,06052
1707,34893,16272,18621,2012,06053
1708,6704,3429,3275,2012,06057
1709,1554,725,829,2012,06058
1710,0,0,0,2012,06059
1711,2532,1186,1346,2012,06060
1712,220,118,102,2012,06061
1713,17726,8347,9379,2012,06062
1714,3185,1563,1622,2012,06063
1715,1015,478,537,2012,06065
1716,29188,14379,14809,2012,06066
1717,19631,9750,9881,2012,06067
1718,1582,634,948,2012,06068
1719,2478,1254,1224,2012,06069
1720,15116,7374,7742,2012,06070
1721,11598,6616,4982,2012,06071
1722,5838,2959,2879,2012,06073
1723,25684,13115,12569,2012,06074
1724,12771,6187,6584,2012,06076
1725,12395,7099,5296,2012,06078
1726,1415,601,814,2012,06081
1727,44699,23373,21326,2012,06082
1728,15063,7848,7215,2012,06084
1729,7020,3440,3580,2012,06085
1730,4864,2196,2668,2012,06088
1731,2733,1426,1307,2012,06089
1732,1212,597,615,2012,06090
1733,178,86,92,2012,06091
1734,4271,2110,2161,2012,06092
1735,3297,1640,1657,2012,06093
1736,29088,13979,15109,2012,06095
1737,12500,5835,6665,2012,06096
1738,12255,5978,6277,2012,06098
1739,1325,728,597,2012,06103
1740,20759,10293,10466,2012,06105
1741,37516,18192,19324,2012,06106
1742,18551,8697,9854,2012,06107
1743,24173,11834,12339,2012,06108
1744,26670,12453,14217,2012,06109
1745,12690,6106,6584,2012,06110
1746,30520,14074,16446,2012,06111
1747,22578,10160,12418,2012,06112
1748,28656,13628,15028,2012,06114
1749,17951,8194,9757,2012,06117
1750,26998,12403,14595,2012,06118
1751,14965,6743,8222,2012,06119
1752,13092,6527,6565,2012,06120
1753,0,0,0,2012,06160
1754,19578,9291,10287,2012,06226
1755,4054,2031,2023,2012,06231
1756,3185,1593,1592,2012,06232
1757,8194,4329,3865,2012,06234
1758,2324,1205,1119,2012,06235
1759,5464,2484,2980,2012,06237
1760,12445,6208,6237,2012,06238
1761,10941,5362,5579,2012,06239
1762,6861,3429,3432,2012,06241
1763,1448,753,695,2012,06242
1764,0,0,0,2012,06243
1765,2732,1359,1373,2012,06247
1766,5595,2791,2804,2012,06248
1767,7289,3980,3309,2012,06249
1768,5908,2748,3160,2012,06250
1769,1984,1005,979,2012,06254
1770,4852,2367,2485,2012,06255
1771,2523,1299,1224,2012,06256
1772,4473,2209,2264,2012,06259
1773,9516,4566,4950,2012,06260
1774,567,222,345,2012,06262
1775,202,112,90,2012,06263
1776,154,86,68,2012,06264
1777,693,415,278,2012,06266
1778,11044,5982,5062,2012,06268
1779,9009,3997,5012,2012,06269
1780,3913,1919,1994,2012,06277
1781,4386,2186,2200,2012,06278
1782,6042,3506,2536,2012,06279
1783,2899,1409,1490,2012,06280
1784,7092,3495,3597,2012,06281
1785,985,440,545,2012,06282
1786,27675,13255,14420,2012,06320
1787,3395,1646,1749,2012,06330
1788,5111,2740,2371,2012,06331
1789,260,163,97,2012,06332
1790,6485,3073,3412,2012,06333
1791,2592,1257,1335,2012,06334
1792,6608,3182,3426,2012,06335
1793,32,25,7,2012,06336
1794,8373,4290,4083,2012,06339
1795,31594,16740,14854,2012,06340
1796,19,10,9,2012,06350
1797,16262,8073,8189,2012,06351
1798,252,164,88,2012,06353
1799,5973,2898,3075,2012,06354
1800,12499,6141,6358,2012,06355
1801,12683,6187,6496,2012,06357
1802,5309,2707,2602,2012,06359
1803,37295,17885,19410,2012,06360
1804,4736,2469,2267,2012,06365
1805,7306,3504,3802,2012,06370
1806,9843,4991,4852,2012,06371
1807,290,111,179,2012,06373
1808,8497,4206,4291,2012,06374
1809,4276,2090,2186,2012,06375
1810,116,67,49,2012,06376
1811,2878,1626,1252,2012,06377
1812,5366,2564,2802,2012,06378
1813,9196,4509,4687,2012,06379
1814,2909,1372,1537,2012,06380
1815,11795,6668,5127,2012,06382
1816,2777,1418,1359,2012,06384
1817,15395,7444,7951,2012,06385
1818,387,208,179,2012,06387
1819,99,65,34,2012,06389
1820,307,137,170,2012,06390
1821,19188,9202,9986,2012,06401
1822,5946,3144,2802,2012,06403
1823,27952,13316,14636,2012,06405
1824,728,429,299,2012,06409
1825,29132,15102,14030,2012,06410
1826,4090,2087,2003,2012,06412
1827,13207,6422,6785,2012,06413
1828,431,309,122,2012,06414
1829,16532,8121,8411,2012,06415
1830,14059,6797,7262,2012,06416
1831,4636,2348,2288,2012,06417
1832,12858,6260,6598,2012,06418
1833,6512,3269,3243,2012,06419
1834,4161,2103,2058,2012,06420
1835,7368,3936,3432,2012,06422
1836,5087,2570,2517,2012,06423
1837,12456,6503,5953,2012,06424
1838,3228,1471,1757,2012,06426
1839,22353,10707,11646,2012,06437
1840,2764,1362,1402,2012,06438
1841,5330,2556,2774,2012,06441
1842,2726,1156,1570,2012,06442
1843,18264,8856,9408,2012,06443
1844,191,57,134,2012,06444
1845,6382,3075,3307,2012,06447
1846,36756,18419,18337,2012,06450
1847,23918,11433,12485,2012,06451
1848,3480,1691,1789,2012,06455
1849,280,152,128,2012,06456
1850,47530,22698,24832,2012,06457
1851,37953,18413,19540,2012,06460
1852,14873,7466,7407,2012,06461
1853,45,33,12,2012,06467
1854,19529,9591,9938,2012,06468
1855,3535,1676,1859,2012,06469
1856,16237,8165,8072,2012,06470
1857,7663,3708,3955,2012,06471
1858,6816,3498,3318,2012,06472
1859,24200,11748,12452,2012,06473
1860,10268,4902,5366,2012,06475
1861,13919,6798,7121,2012,06477
1862,12602,5861,6741,2012,06478
1863,10585,5279,5306,2012,06479
1864,9500,4635,4865,2012,06480
1865,946,435,511,2012,06481
1866,11306,5607,5699,2012,06482
1867,16487,7828,8659,2012,06483
1868,39641,18852,20789,2012,06484
1869,19841,9572,10269,2012,06488
1870,32217,15555,16662,2012,06489
1871,45168,22185,22983,2012,06492
1872,6980,3281,3699,2012,06498
1873,2496,1343,1153,2012,06510
1874,54837,25703,29134,2012,06511
1875,29016,14194,14822,2012,06512
1876,38749,18441,20308,2012,06513
1877,26917,12144,14773,2012,06514
1878,17780,8216,9564,2012,06515
1879,55386,26256,29130,2012,06516
1880,14683,6816,7867,2012,06517
1881,19135,8868,10267,2012,06518
1882,16045,7718,8327,2012,06519
1883,5524,2861,2663,2012,06524
1884,8990,4509,4481,2012,06525
1885,28764,13709,15055,2012,06604
1886,23603,11090,12513,2012,06605
1887,48725,24162,24563,2012,06606
1888,7533,3366,4167,2012,06607
1889,13772,6421,7351,2012,06608
1890,22049,10465,11584,2012,06610
1891,36008,17539,18469,2012,06611
1892,7501,3601,3900,2012,06612
1893,33295,16044,17251,2012,06614
1894,18145,8613,9532,2012,06615
1895,3431,1468,1963,2012,06702
1896,24832,11494,13338,2012,06704
1897,26838,12597,14241,2012,06705
1898,14738,7106,7632,2012,06706
1899,29875,14571,15304,2012,06708
1900,10371,4706,5665,2012,06710
1901,9450,4730,4720,2012,06712
1902,16638,7653,8985,2012,06716
1903,1251,549,702,2012,06750
1904,3528,1714,1814,2012,06751
1905,1704,848,856,2012,06752
1906,1846,951,895,2012,06754
1907,1133,560,573,2012,06755
1908,2803,1376,1427,2012,06756
1909,2162,1037,1125,2012,06757
1910,435,245,190,2012,06758
1911,6081,2947,3134,2012,06759
1912,7522,3780,3742,2012,06762
1913,2029,1032,997,2012,06763
1914,31907,16061,15846,2012,06770
1915,26750,13517,13233,2012,06776
1916,1616,888,728,2012,06777
1917,1363,706,657,2012,06778
1918,8377,3874,4503,2012,06779
1919,2379,1237,1142,2012,06782
1920,2313,1199,1114,2012,06783
1921,3803,1836,1967,2012,06784
1922,809,322,487,2012,06785
1923,9814,5052,4762,2012,06786
1924,7865,3820,4045,2012,06787
1925,36152,17486,18666,2012,06790
1926,5752,2878,2874,2012,06791
1927,1111,528,583,2012,06793
1928,1188,557,631,2012,06794
1929,14084,6947,7137,2012,06795
1930,984,478,506,2012,06796
1931,9934,4974,4960,2012,06798
1932,18673,9270,9403,2012,06801
1933,16515,8000,8515,2012,06804
1934,6854,3327,3527,2012,06807
1935,49146,24631,24515,2012,06810
1936,31914,14788,17126,2012,06811
1937,13932,6920,7012,2012,06812
1938,20758,10219,10539,2012,06820
1939,34374,16387,17987,2012,06824
1940,20648,9472,11176,2012,06825
1941,24315,11516,12799,2012,06830
1942,14526,7199,7327,2012,06831
1943,19794,9868,9926,2012,06840
1944,20120,9618,10502,2012,06850
1945,28616,14211,14405,2012,06851
1946,3975,1922,2053,2012,06853
1947,25788,12812,12976,2012,06854
1948,7047,3554,3493,2012,06855
1949,2,2,0,2012,06856
1950,7268,3638,3630,2012,06870
1951,24747,12254,12493,2012,06877
1952,8571,4377,4194,2012,06878
1953,26790,12817,13973,2012,06880
1954,10203,5118,5085,2012,06883
1955,4429,2137,2292,2012,06890
1956,9049,4397,4652,2012,06896
1957,18343,8824,9519,2012,06897
1958,7435,3796,3639,2012,06901
1959,65817,32915,32902,2012,06902
1960,14480,7155,7325,2012,06903
1961,18356,8773,9583,2012,06905
1962,8499,4095,4404,2012,06906
1963,8185,3985,4200,2012,06907
1964,16598,9275,7323,2012,07001
1965,63164,30654,32510,2012,07002
1966,47309,22334,24975,2012,07003
1967,7347,3511,3836,2012,07004
1968,15353,7073,8280,2012,07005
1969,24976,11483,13493,2012,07006
1970,23135,11352,11783,2012,07008
1971,12432,5732,6700,2012,07009
1972,23618,11655,11963,2012,07010
1973,39904,20242,19662,2012,07011
1974,12588,6313,6275,2012,07012
1975,25317,12171,13146,2012,07013
1976,4816,2140,2676,2012,07014
1977,22659,10843,11816,2012,07016
1978,34983,15281,19702,2012,07017
1979,29536,12680,16856,2012,07018
1980,11425,5374,6051,2012,07020
1981,2129,1037,1092,2012,07021
1982,13888,7104,6784,2012,07022
1983,7313,3687,3626,2012,07023
1984,35431,16524,18907,2012,07024
1985,30570,14365,16205,2012,07026
1986,4295,2197,2098,2012,07027
1987,7607,3668,3939,2012,07028
1988,15980,8076,7904,2012,07029
1989,49898,24867,25031,2012,07030
1990,15407,7869,7538,2012,07031
1991,40744,20944,19800,2012,07032
1992,7907,3869,4038,2012,07033
1993,9773,4700,5073,2012,07034
1994,10598,5320,5278,2012,07035
1995,41851,19419,22432,2012,07036
1996,29269,14268,15001,2012,07039
1997,23897,11625,12272,2012,07040
1998,7090,3387,3703,2012,07041
1999,25661,12157,13504,2012,07042
2000,12918,5943,6975,2012,07043
2001,13626,6249,7377,2012,07044
2002,10066,4737,5329,2012,07045
2003,4206,2198,2008,2012,07046
2004,60772,29454,31318,2012,07047
2005,30002,14559,15443,2012,07050
2006,46153,21689,24464,2012,07052
2007,28729,14035,14694,2012,07054
2008,69727,34813,34914,2012,07055
2009,11410,5678,5732,2012,07057
2010,6091,3080,3011,2012,07058
2011,15412,7850,7562,2012,07059
2012,44219,22917,21302,2012,07060
2013,12712,5876,6836,2012,07062
2014,14606,7259,7347,2012,07063
2015,3571,1815,1756,2012,07064
2016,27369,13232,14137,2012,07065
2017,14768,7019,7749,2012,07066
2018,17794,8644,9150,2012,07067
2019,5812,2796,3016,2012,07068
2020,6015,2947,3068,2012,07069
2021,18084,8478,9606,2012,07070
2022,20621,9683,10938,2012,07071
2023,6161,3009,3152,2012,07072
2024,8909,4460,4449,2012,07073
2025,2711,1255,1456,2012,07074
2026,7892,4091,3801,2012,07075
2027,23370,11161,12209,2012,07076
2028,2662,1343,1319,2012,07077
2029,12966,6292,6674,2012,07078
2030,16472,7980,8492,2012,07079
2031,23397,11802,11595,2012,07080
2032,16030,8020,8010,2012,07081
2033,4783,2436,2347,2012,07082
2034,52899,24794,28105,2012,07083
2035,12764,6758,6006,2012,07086
2036,66924,33296,33628,2012,07087
2037,3581,1747,1834,2012,07088
2038,30382,14839,15543,2012,07090
2039,6714,3651,3063,2012,07092
2040,60982,30361,30621,2012,07093
2041,16809,8303,8506,2012,07094
2042,20596,10294,10302,2012,07095
2043,12777,7430,5347,2012,07102
2044,30773,13838,16935,2012,07103
2045,50519,24612,25907,2012,07104
2046,49344,28204,21140,2012,07105
2047,31643,13941,17702,2012,07106
2048,37269,18038,19231,2012,07107
2049,24235,11051,13184,2012,07108
2050,35778,17796,17982,2012,07109
2051,28311,13332,14979,2012,07110
2052,54205,24987,29218,2012,07111
2053,25543,11797,13746,2012,07112
2054,14517,8851,5666,2012,07114
2055,24704,11674,13030,2012,07201
2056,41910,20872,21038,2012,07202
2057,21103,9981,11122,2012,07203
2058,13310,6526,6784,2012,07204
2059,21413,10388,11025,2012,07205
2060,26005,12507,13498,2012,07206
2061,32176,16096,16080,2012,07208
2062,37055,19101,17954,2012,07302
2063,39886,19272,20614,2012,07304
2064,62432,28536,33896,2012,07305
2065,52437,27046,25391,2012,07306
2066,43626,21879,21747,2012,07307
2067,12397,6253,6144,2012,07310
2068,324,189,135,2012,07311
2069,6549,3152,3397,2012,07401
2070,7654,3743,3911,2012,07403
2071,17778,8828,8950,2012,07405
2072,19461,9000,10461,2012,07407
2073,32479,15600,16879,2012,07410
2074,5778,2925,2853,2012,07416
2075,10596,5321,5275,2012,07417
2076,2022,1083,939,2012,07418
2077,9422,4537,4885,2012,07419
2078,4591,1991,2600,2012,07420
2079,6935,3438,3497,2012,07421
2080,6276,3307,2969,2012,07422
2081,4085,2041,2044,2012,07423
2082,26236,12147,14089,2012,07424
2083,25840,12082,13758,2012,07430
2084,7131,3378,3753,2012,07432
2085,2177,1040,1137,2012,07435
2086,12763,6338,6425,2012,07436
2087,11720,6046,5674,2012,07438
2088,2407,1224,1183,2012,07439
2089,5043,2404,2639,2012,07440
2090,11074,5416,5658,2012,07442
2091,10426,4426,6000,2012,07444
2092,14528,7258,7270,2012,07446
2093,25063,12134,12929,2012,07450
2094,11631,5823,5808,2012,07452
2095,12234,6157,6077,2012,07456
2096,3659,1778,1881,2012,07457
2097,11351,5662,5689,2012,07458
2098,3338,1633,1705,2012,07460
2099,19774,9880,9894,2012,07461
2100,7111,3655,3456,2012,07462
2101,9678,4632,5046,2012,07463
2102,6471,3143,3328,2012,07465
2103,54641,26544,28097,2012,07470
2104,16667,8130,8537,2012,07480
2105,16729,8272,8457,2012,07481
2106,0,0,0,2012,07495
2107,31448,15306,16142,2012,07501
2108,14229,6710,7519,2012,07502
2109,20027,9715,10312,2012,07503
2110,12866,6098,6768,2012,07504
2111,1750,815,935,2012,07505
2112,18753,9142,9611,2012,07506
2113,22595,10652,11943,2012,07508
2114,10784,4948,5836,2012,07512
2115,11601,6026,5575,2012,07513
2116,19321,8830,10491,2012,07514
2117,21910,10482,11428,2012,07522
2118,12503,5953,6550,2012,07524
2119,43126,21120,22006,2012,07601
2120,8200,4022,4178,2012,07603
2121,11830,5737,6093,2012,07604
2122,8998,4467,4531,2012,07605
2123,2282,1104,1178,2012,07606
2124,9547,4476,5071,2012,07607
2125,80,39,41,2012,07608
2126,2006,965,1041,2012,07620
2127,26606,12897,13709,2012,07621
2128,8397,4163,4234,2012,07624
2129,8393,3908,4485,2012,07626
2130,4909,2283,2626,2012,07627
2131,17505,8383,9122,2012,07628
2132,7471,3447,4024,2012,07630
2133,27153,12547,14606,2012,07631
2134,5349,2580,2769,2012,07632
2135,4715,2398,2317,2012,07640
2136,3382,1736,1646,2012,07641
2137,10230,5024,5206,2012,07642
2138,10635,5187,5448,2012,07643
2139,24176,11544,12632,2012,07644
2140,7809,3891,3918,2012,07645
2141,16362,8033,8329,2012,07646
2142,5151,2467,2684,2012,07647
2143,5729,2912,2817,2012,07648
2144,7997,3808,4189,2012,07649
2145,19500,10031,9469,2012,07650
2146,26301,12376,13925,2012,07652
2147,8737,4029,4708,2012,07656
2148,11081,5039,6042,2012,07657
2149,12761,6217,6544,2012,07660
2150,11340,5511,5829,2012,07661
2151,5534,2798,2736,2012,07662
2152,13734,6656,7078,2012,07663
2153,39781,18379,21402,2012,07666
2154,14789,7056,7733,2012,07670
2155,26368,12616,13752,2012,07675
2156,9056,4276,4780,2012,07676
2157,5750,2854,2896,2012,07677
2158,23669,11562,12107,2012,07701
2159,3822,1940,1882,2012,07702
2160,436,241,195,2012,07703
2161,6102,2817,3285,2012,07704
2162,1489,746,743,2012,07711
2163,39365,18645,20720,2012,07712
2164,8664,4124,4540,2012,07716
2165,1972,890,1082,2012,07717
2166,5947,2719,3228,2012,07718
2167,22437,11099,11338,2012,07719
2168,4335,2115,2220,2012,07720
2169,2942,1494,1448,2012,07721
2170,10173,4998,5175,2012,07722
2171,1245,687,558,2012,07723
2172,21720,10420,11300,2012,07724
2173,41943,19977,21966,2012,07726
2174,6450,3313,3137,2012,07727
2175,56369,28307,28062,2012,07728
2176,17365,8547,8818,2012,07730
2177,38140,19096,19044,2012,07731
2178,5163,2603,2560,2012,07732
2179,16530,7958,8572,2012,07733
2180,13310,6037,7273,2012,07734
2181,20289,10047,10242,2012,07735
2182,4071,1929,2142,2012,07737
2183,6299,3186,3113,2012,07738
2184,5970,2943,3027,2012,07739
2185,31012,16154,14858,2012,07740
2186,19616,9711,9905,2012,07746
2187,30444,14461,15983,2012,07747
2188,28158,13954,14204,2012,07748
2189,3298,1521,1777,2012,07750
2190,18883,8909,9974,2012,07751
2191,36740,16545,20195,2012,07753
2192,6650,3074,3576,2012,07755
2193,3235,1286,1949,2012,07756
2194,5519,2939,2580,2012,07757
2195,5404,2593,2811,2012,07758
2196,9318,4670,4648,2012,07760
2197,8525,4140,4385,2012,07762
2198,8238,3897,4341,2012,07764
2199,25878,13484,12394,2012,07801
2200,3669,1770,1899,2012,07803
2201,0,0,0,2012,07820
2202,9420,4701,4719,2012,07821
2203,857,488,369,2012,07822
2204,7813,3867,3946,2012,07823
2205,9720,4928,4792,2012,07825
2206,6143,3185,2958,2012,07826
2207,4343,2301,2042,2012,07827
2208,14078,6973,7105,2012,07828
2209,6916,3439,3477,2012,07830
2210,3510,1798,1712,2012,07832
2211,108,68,40,2012,07833
2212,17630,8748,8882,2012,07834
2213,12882,6642,6240,2012,07836
2214,3741,1980,1761,2012,07838
2215,29658,14312,15346,2012,07840
2216,134,59,75,2012,07842
2217,12326,6053,6273,2012,07843
2218,95,40,55,2012,07846
2219,1186,521,665,2012,07847
2220,4926,2437,2489,2012,07848
2221,8926,4545,4381,2012,07849
2222,7293,3900,3393,2012,07850
2223,132,91,41,2012,07851
2224,4257,2030,2227,2012,07852
2225,12952,6505,6447,2012,07853
2226,3542,1492,2050,2012,07856
2227,3319,1586,1733,2012,07857
2228,26585,12729,13856,2012,07860
2229,4260,2138,2122,2012,07863
2230,2316,1122,1194,2012,07865
2231,21859,10752,11107,2012,07866
2232,25403,12628,12775,2012,07869
2233,89,58,31,2012,07870
2234,21013,10642,10371,2012,07871
2235,8550,3994,4556,2012,07874
2236,10322,5064,5258,2012,07876
2237,1232,626,606,2012,07878
2238,70,35,35,2012,07880
2239,5,2,3,2012,07881
2240,14201,6861,7340,2012,07882
2241,9883,5120,4763,2012,07885
2242,22712,11108,11604,2012,07901
2243,26310,12652,13658,2012,07920
2244,7855,3414,4441,2012,07921
2245,12126,5549,6577,2012,07922
2246,7572,3976,3596,2012,07924
2247,102,51,51,2012,07926
2248,3599,1866,1733,2012,07927
2249,19137,9005,10132,2012,07928
2250,8320,4015,4305,2012,07930
2251,3593,1721,1872,2012,07931
2252,10459,4654,5805,2012,07932
2253,3563,1986,1577,2012,07933
2254,1493,735,758,2012,07934
2255,399,198,201,2012,07935
2256,11222,5423,5799,2012,07936
2257,294,248,46,2012,07939
2258,16779,7956,8823,2012,07940
2259,9722,4700,5022,2012,07945
2260,3300,1658,1642,2012,07946
2261,19129,9317,9812,2012,07950
2262,43712,21125,22587,2012,07960
2263,0,0,0,2012,07961
2264,240,79,161,2012,07970
2265,12085,6029,6056,2012,07974
2266,752,366,386,2012,07976
2267,627,304,323,2012,07977
2268,611,298,313,2012,07979
2269,1877,1028,849,2012,07980
2270,9045,4454,4591,2012,07981
2271,864,388,476,2012,08001
2272,22250,10181,12069,2012,08002
2273,30888,15071,15817,2012,08003
2274,12339,6234,6105,2012,08004
2275,22118,10310,11808,2012,08005
2276,526,247,279,2012,08006
2277,5413,2488,2925,2012,08007
2278,7134,3402,3732,2012,08008
2279,12581,6112,6469,2012,08009
2280,11517,5511,6006,2012,08010
2281,71,44,27,2012,08011
2282,39281,19066,20215,2012,08012
2283,414,246,168,2012,08014
2284,20820,10467,10353,2012,08015
2285,33089,15902,17187,2012,08016
2286,891,502,389,2012,08019
2287,2465,1028,1437,2012,08020
2288,45041,22285,22756,2012,08021
2289,8780,4410,4370,2012,08022
2290,483,156,327,2012,08023
2291,2309,1071,1238,2012,08026
2292,4881,2258,2623,2012,08027
2293,20145,9714,10431,2012,08028
2294,4970,2384,2586,2012,08029
2295,13279,6506,6773,2012,08030
2296,11585,5590,5995,2012,08031
2297,15978,7881,8097,2012,08033
2298,17725,8606,9119,2012,08034
2299,7584,3564,4020,2012,08035
2300,5519,2536,2983,2012,08036
2301,24173,12100,12073,2012,08037
2302,140,73,67,2012,08038
2303,58,17,41,2012,08039
2304,1235,644,591,2012,08041
2305,151,73,78,2012,08042
2306,29225,13768,15457,2012,08043
2307,2928,1285,1643,2012,08045
2308,31760,14464,17296,2012,08046
2309,12471,6244,6227,2012,08048
2310,5381,2715,2666,2012,08049
2311,24374,11738,12636,2012,08050
2312,10917,4944,5973,2012,08051
2313,19273,9537,9736,2012,08052
2314,45555,22458,23097,2012,08053
2315,41865,19354,22511,2012,08054
2316,27253,13397,13856,2012,08055
2317,4372,2208,2164,2012,08056
2318,20819,10125,10694,2012,08057
2319,5679,2842,2837,2012,08059
2320,24955,11179,13776,2012,08060
2321,2733,1274,1459,2012,08061
2322,15645,7746,7899,2012,08062
2323,3151,1511,1640,2012,08063
2324,200,90,110,2012,08064
2325,7411,3565,3846,2012,08065
2326,8612,3868,4744,2012,08066
2327,1916,902,1014,2012,08067
2328,7031,3261,3770,2012,08068
2329,13064,6321,6743,2012,08069
2330,12955,6275,6680,2012,08070
2331,9595,4625,4970,2012,08071
2332,152,85,67,2012,08072
2333,252,101,151,2012,08073
2334,11,5,6,2012,08074
2335,29156,14118,15038,2012,08075
2336,18505,9056,9449,2012,08077
2337,8437,4203,4234,2012,08078
2338,10918,5021,5897,2012,08079
2339,36201,17641,18560,2012,08080
2340,50544,24588,25956,2012,08081
2341,9521,4350,5171,2012,08083
2342,7048,3605,3443,2012,08084
2343,18855,9391,9464,2012,08085
2344,7425,3588,3837,2012,08086
2345,24029,11768,12261,2012,08087
2346,24402,12206,12196,2012,08088
2347,4408,2277,2131,2012,08089
2348,8746,4369,4377,2012,08090
2349,5371,2555,2816,2012,08091
2350,3491,1646,1845,2012,08092
2351,10432,4973,5459,2012,08093
2352,39604,19462,20142,2012,08094
2353,117,73,44,2012,08095
2354,35155,17264,17891,2012,08096
2355,3154,1620,1534,2012,08097
2356,8963,4505,4458,2012,08098
2357,7380,3841,3539,2012,08102
2358,15029,7386,7643,2012,08103
2359,24420,10198,14222,2012,08104
2360,29577,14616,14961,2012,08105
2361,9925,4708,5217,2012,08106
2362,13955,6619,7336,2012,08107
2363,17664,8709,8955,2012,08108
2364,22720,10914,11806,2012,08109
2365,18322,8889,9433,2012,08110
2366,10172,5265,4907,2012,08201
2367,2166,1132,1034,2012,08202
2368,9622,4682,4940,2012,08203
2369,18296,8713,9583,2012,08204
2370,26823,12718,14105,2012,08205
2371,17188,8504,8684,2012,08210
2372,161,81,80,2012,08212
2373,13857,6867,6990,2012,08215
2374,14,7,7,2012,08217
2375,7109,3452,3657,2012,08221
2376,3996,2051,1945,2012,08223
2377,689,312,377,2012,08224
2378,8670,4134,4536,2012,08225
2379,11790,5526,6264,2012,08226
2380,5739,2778,2961,2012,08230
2381,19015,8830,10185,2012,08232
2382,42343,20407,21936,2012,08234
2383,3737,1573,2164,2012,08240
2384,980,500,480,2012,08241
2385,2913,1414,1499,2012,08242
2386,1994,976,1018,2012,08243
2387,10898,5232,5666,2012,08244
2388,198,112,86,2012,08246
2389,819,375,444,2012,08247
2390,118,54,64,2012,08248
2391,10234,4957,5277,2012,08251
2392,13770,6748,7022,2012,08260
2393,8329,4225,4104,2012,08270
2394,48348,26445,21903,2012,08302
2395,1970,966,1004,2012,08310
2396,2217,1155,1062,2012,08311
2397,8003,3943,4060,2012,08312
2398,2807,2586,221,2012,08314
2399,430,293,137,2012,08316
2400,1480,714,766,2012,08317
2401,12050,6022,6028,2012,08318
2402,1333,661,672,2012,08319
2403,0,0,0,2012,08320
2404,148,59,89,2012,08321
2405,10049,4794,5255,2012,08322
2406,924,454,470,2012,08323
2407,830,400,430,2012,08324
2408,1728,890,838,2012,08326
2409,2328,1933,395,2012,08327
2410,1753,715,1038,2012,08328
2411,213,90,123,2012,08329
2412,28046,13995,14051,2012,08330
2413,36316,17575,18741,2012,08332
2414,818,390,428,2012,08340
2415,2114,895,1219,2012,08341
2416,5507,2862,2645,2012,08343
2417,5600,2606,2994,2012,08344
2418,734,339,395,2012,08345
2419,929,455,474,2012,08346
2420,378,163,215,2012,08348
2421,2501,1384,1117,2012,08349
2422,651,328,323,2012,08350
2423,567,307,260,2012,08352
2424,629,304,325,2012,08353
2425,43373,20843,22530,2012,08360
2426,18053,8672,9381,2012,08361
2427,39680,19262,20418,2012,08401
2428,6459,2826,3633,2012,08402
2429,1060,528,532,2012,08403
2430,10785,5592,5193,2012,08406
2431,6366,3091,3275,2012,08501
2432,11057,5508,5549,2012,08502
2433,17087,8452,8635,2012,08505
2434,5056,2262,2794,2012,08510
2435,1188,568,620,2012,08511
2436,10139,4719,5420,2012,08512
2437,4406,2100,2306,2012,08514
2438,6907,4692,2215,2012,08515
2439,5204,2512,2692,2012,08518
2440,27486,13907,13579,2012,08520
2441,4403,2176,2227,2012,08525
2442,54268,26850,27418,2012,08527
2443,234,118,116,2012,08528
2444,8293,4440,3853,2012,08530
2445,6983,3540,3443,2012,08533
2446,13037,6304,6733,2012,08534
2447,5411,2675,2736,2012,08535
2448,19968,9595,10373,2012,08536
2449,47204,22497,24707,2012,08540
2450,4755,2650,2105,2012,08542
2451,19258,9385,9873,2012,08550
2452,5756,3114,2642,2012,08551
2453,546,305,241,2012,08553
2454,4087,1865,2222,2012,08554
2455,828,429,399,2012,08555
2456,6629,3197,3432,2012,08558
2457,5323,2605,2718,2012,08559
2458,2969,1602,1367,2012,08560
2459,0,0,0,2012,08561
2460,5924,2808,3116,2012,08562
2461,637,246,391,2012,08608
2462,13908,7607,6301,2012,08609
2463,30255,14496,15759,2012,08610
2464,27125,14744,12381,2012,08611
2465,37681,16928,20753,2012,08618
2466,22363,10550,11813,2012,08619
2467,12832,6315,6517,2012,08620
2468,9441,5070,4371,2012,08628
2469,12634,6238,6396,2012,08629
2470,23258,11630,11628,2012,08638
2471,6581,5437,1144,2012,08640
2472,4114,2607,1507,2012,08641
2473,32168,15292,16876,2012,08648
2474,19514,9450,10064,2012,08690
2475,15283,6916,8367,2012,08691
2476,91423,45292,46131,2012,08701
2477,926,379,547,2012,08720
2478,20377,10380,9997,2012,08721
2479,11067,5410,5657,2012,08722
2480,31603,15175,16428,2012,08723
2481,43005,20146,22859,2012,08724
2482,4787,2414,2373,2012,08730
2483,19460,9824,9636,2012,08731
2484,1426,633,793,2012,08732
2485,2802,1390,1412,2012,08733
2486,8188,4158,4030,2012,08734
2487,3563,1633,1930,2012,08735
2488,12024,5929,6095,2012,08736
2489,980,436,544,2012,08738
2490,1908,836,1072,2012,08740
2491,2569,1232,1337,2012,08741
2492,24429,11290,13139,2012,08742
2493,3541,1688,1853,2012,08750
2494,4417,2115,2302,2012,08751
2495,2238,1101,1137,2012,08752
2496,63218,31455,31763,2012,08753
2497,25987,12125,13862,2012,08755
2498,32955,13866,19089,2012,08757
2499,7339,3771,3568,2012,08758
2500,33064,13911,19153,2012,08759
2501,8597,5145,3452,2012,08801
2502,3819,1976,1843,2012,08802
2503,2622,1348,1274,2012,08804
2504,12193,6447,5746,2012,08805
2505,38236,18050,20186,2012,08807
2506,148,91,57,2012,08808
2507,6630,2960,3670,2012,08809
2508,9108,4116,4992,2012,08810
2509,14327,6915,7412,2012,08812
2510,46298,22296,24002,2012,08816
2511,45510,23052,22458,2012,08817
2512,38759,19031,19728,2012,08820
2513,424,181,243,2012,08821
2514,30228,14625,15603,2012,08822
2515,8649,4381,4268,2012,08823
2516,11778,5942,5836,2012,08824
2517,4591,2152,2439,2012,08825
2518,5664,2888,2776,2012,08826
2519,4468,2140,2328,2012,08827
2520,2235,1050,1185,2012,08828
2521,3684,1796,1888,2012,08829
2522,18584,9215,9369,2012,08830
2523,45793,21685,24108,2012,08831
2524,2793,1335,1458,2012,08832
2525,8844,4188,4656,2012,08833
2526,10358,5386,4972,2012,08835
2527,3685,1775,1910,2012,08836
2528,15880,7925,7955,2012,08837
2529,16391,7942,8449,2012,08840
2530,38425,18450,19975,2012,08844
2531,13661,6865,6796,2012,08846
2532,8536,4499,4037,2012,08848
2533,8289,3971,4318,2012,08850
2534,17217,8322,8895,2012,08852
2535,5522,2813,2709,2012,08853
2536,56202,27957,28245,2012,08854
2537,39970,19248,20722,2012,08857
2538,133,77,56,2012,08858
2539,21646,10194,11452,2012,08859
2540,53143,25622,27521,2012,08861
2541,12129,5404,6725,2012,08863
2542,29922,14026,15896,2012,08865
2543,4939,2419,2520,2012,08867
2544,6968,3383,3585,2012,08869
2545,19723,9705,10018,2012,08872
2546,50554,23962,26592,2012,08873
2547,22026,11134,10892,2012,08876
2548,22279,10770,11509,2012,08879
2549,4653,2192,2461,2012,08880
2550,15992,8149,7843,2012,08882
2551,8283,4011,4272,2012,08884
2552,7042,3191,3851,2012,08886
2553,957,461,496,2012,08887
2554,10055,4723,5332,2012,08889
2555,0,0,0,2012,08890
2556,55189,27598,27591,2012,08901
2557,41153,20859,20294,2012,08902
2558,14074,6906,7168,2012,08904
2559,20579,9878,10701,2012,10001
2560,80323,38320,42003,2012,10002
2561,56614,26859,29755,2012,10003
2562,2780,1554,1226,2012,10004
2563,5724,2998,2726,2012,10005
2564,2696,1266,1430,2012,10006
2565,6188,3443,2745,2012,10007
2566,62397,29359,33038,2012,10009
2567,29396,13414,15982,2012,10010
2568,51853,26130,25723,2012,10011
2569,24703,12896,11807,2012,10012
2570,26090,12755,13335,2012,10013
2571,30893,14497,16396,2012,10014
2572,52624,23890,28734,2012,10016
2573,16137,7515,8622,2012,10017
2574,6147,3463,2684,2012,10018
2575,40351,19524,20827,2012,10019
2576,0,0,0,2012,10020
2577,42646,19161,23485,2012,10021
2578,29317,13315,16002,2012,10022
2579,60447,28799,31648,2012,10023
2580,58991,27848,31143,2012,10024
2581,96449,42929,53520,2012,10025
2582,36797,17212,19585,2012,10026
2583,61018,27212,33806,2012,10027
2584,45799,20281,25518,2012,10028
2585,79031,37012,42019,2012,10029
2586,29364,13552,15812,2012,10030
2587,59708,28194,31514,2012,10031
2588,61650,30309,31341,2012,10032
2589,57073,28405,28668,2012,10033
2590,41200,20943,20257,2012,10034
2591,34709,16886,17823,2012,10035
2592,22413,12687,9726,2012,10036
2593,17099,7117,9982,2012,10037
2594,20042,9400,10642,2012,10038
2595,25372,12027,13345,2012,10039
2596,43650,19636,24014,2012,10040
2597,12311,5856,6455,2012,10044
2598,32807,14673,18134,2012,10065
2599,5359,2683,2676,2012,10069
2600,24148,9851,14297,2012,10075
2601,0,0,0,2012,10103
2602,3,2,1,2012,10110
2603,0,0,0,2012,10111
2604,0,0,0,2012,10112
2605,0,0,0,2012,10115
2606,0,0,0,2012,10119
2607,59443,25949,33494,2012,10128
2608,0,0,0,2012,10152
2609,0,0,0,2012,10153
2610,0,0,0,2012,10154
2611,1590,868,722,2012,10162
2612,0,0,0,2012,10165
2613,0,0,0,2012,10167
2614,0,0,0,2012,10168
2615,0,0,0,2012,10169
2616,0,0,0,2012,10170
2617,0,0,0,2012,10171
2618,0,0,0,2012,10172
2619,0,0,0,2012,10173
2620,0,0,0,2012,10174
2621,0,0,0,2012,10177
2622,0,0,0,2012,10199
2623,0,0,0,2012,10271
2624,0,0,0,2012,10278
2625,0,0,0,2012,10279
2626,7610,3490,4120,2012,10280
2627,5507,2998,2509,2012,10282
2628,38851,19263,19588,2012,10301
2629,17090,8434,8656,2012,10302
2630,24933,11468,13465,2012,10303
2631,41845,19516,22329,2012,10304
2632,41309,19799,21510,2012,10305
2633,55692,26670,29022,2012,10306
2634,14418,7191,7227,2012,10307
2635,28782,13697,15085,2012,10308
2636,31943,16328,15615,2012,10309
2637,24454,11978,12476,2012,10310
2638,0,0,0,2012,10311
2639,61136,30541,30595,2012,10312
2640,87921,42092,45829,2012,10314
2641,45931,20463,25468,2012,10451
2642,74520,35012,39508,2012,10452
2643,79143,37647,41496,2012,10453
2644,37850,18496,19354,2012,10454
2645,38114,17622,20492,2012,10455
2646,87796,41035,46761,2012,10456
2647,69411,32718,36693,2012,10457
2648,74911,36246,38665,2012,10458
2649,47000,21631,25369,2012,10459
2650,56011,25987,30024,2012,10460
2651,51599,25079,26520,2012,10461
2652,75709,35603,40106,2012,10462
2653,69371,31390,37981,2012,10463
2654,3974,1861,2113,2012,10464
2655,43897,21191,22706,2012,10465
2656,71631,31708,39923,2012,10466
2657,96319,44940,51379,2012,10467
2658,73205,33464,39741,2012,10468
2659,71580,32632,38948,2012,10469
2660,15647,7587,8060,2012,10470
2661,21792,10570,11222,2012,10471
2662,67915,32894,35021,2012,10472
2663,58403,25675,32728,2012,10473
2664,12723,6252,6471,2012,10474
2665,41625,18299,23326,2012,10475
2666,1207,494,713,2012,10501
2667,5361,2543,2818,2012,10502
2668,263,110,153,2012,10503
2669,8215,4095,4120,2012,10504
2670,694,366,328,2012,10505
2671,5158,2517,2641,2012,10506
2672,7006,3059,3947,2012,10507
2673,20148,10224,9924,2012,10509
2674,10671,4786,5885,2012,10510
2675,2354,1155,1199,2012,10511
2676,24960,12360,12600,2012,10512
2677,12604,6140,6464,2012,10514
2678,5205,2584,2621,2012,10516
2679,679,330,349,2012,10517
2680,1561,733,828,2012,10518
2681,126,41,85,2012,10519
2682,13159,6270,6889,2012,10520
2683,10889,5236,5653,2012,10522
2684,7789,3825,3964,2012,10523
2685,4482,2276,2206,2012,10524
2686,1738,816,922,2012,10526
2687,1221,633,588,2012,10527
2688,13209,6557,6652,2012,10528
2689,11947,5513,6434,2012,10530
2690,5071,2456,2615,2012,10532
2691,7406,3312,4094,2012,10533
2692,800,395,405,2012,10535
2693,10840,5555,5285,2012,10536
2694,2239,1147,1092,2012,10537
2695,16699,8153,8546,2012,10538
2696,26647,13190,13457,2012,10541
2697,20040,9450,10590,2012,10543
2698,114,114,0,2012,10545
2699,1275,609,666,2012,10546
2700,7937,3889,4048,2012,10547
2701,2910,1506,1404,2012,10548
2702,15560,7556,8004,2012,10549
2703,36938,16469,20469,2012,10550
2704,20259,9326,10933,2012,10552
2705,10141,4623,5518,2012,10553
2706,4812,2341,2471,2012,10560
2707,31239,16127,15112,2012,10562
2708,23568,11975,11593,2012,10566
2709,20083,9628,10455,2012,10567
2710,12623,6440,6183,2012,10570
2711,38237,19037,19200,2012,10573
2712,4996,2176,2820,2012,10576
2713,5391,2135,3256,2012,10577
2714,665,254,411,2012,10578
2715,9071,4586,4485,2012,10579
2716,17342,8249,9093,2012,10580
2717,39210,19374,19836,2012,10583
2718,2090,877,1213,2012,10588
2719,8403,3754,4649,2012,10589
2720,6632,3379,3253,2012,10590
2721,22722,10892,11830,2012,10591
2722,5114,2570,2544,2012,10594
2723,8016,4423,3593,2012,10595
2724,1152,642,510,2012,10596
2725,1138,566,572,2012,10597
2726,28624,13272,15352,2012,10598
2727,10113,4447,5666,2012,10601
2728,17914,8473,9441,2012,10603
2729,11607,6080,5527,2012,10604
2730,18368,9207,9161,2012,10605
2731,16410,8329,8081,2012,10606
2732,6854,3409,3445,2012,10607
2733,62396,29996,32400,2012,10701
2734,20261,10069,10192,2012,10703
2735,30432,14371,16061,2012,10704
2736,38654,18278,20376,2012,10705
2737,8549,4232,4317,2012,10706
2738,10461,4891,5570,2012,10707
2739,21464,9905,11559,2012,10708
2740,9605,4877,4728,2012,10709
2741,25811,11905,13906,2012,10710
2742,40674,19766,20908,2012,10801
2743,12470,6021,6449,2012,10803
2744,15069,7172,7897,2012,10804
2745,17758,8583,9175,2012,10805
2746,23337,11376,11961,2012,10901
2747,0,0,0,2012,10910
2748,0,0,0,2012,10911
2749,5277,2594,2683,2012,10913
2750,310,118,192,2012,10914
2751,158,78,80,2012,10915
2752,4468,2266,2202,2012,10916
2753,1790,914,876,2012,10917
2754,11766,5874,5892,2012,10918
2755,1312,674,638,2012,10919
2756,8648,4133,4515,2012,10920
2757,4094,1939,2155,2012,10921
2758,1165,611,554,2012,10922
2759,8736,4078,4658,2012,10923
2760,12913,6094,6819,2012,10924
2761,4302,2331,1971,2012,10925
2762,2958,1490,1468,2012,10926
2763,11843,5792,6051,2012,10927
2764,4035,2033,2002,2012,10928
2765,9029,4566,4463,2012,10930
2766,988,557,431,2012,10931
2767,142,39,103,2012,10932
2768,553,223,330,2012,10933
2769,48209,23848,24361,2012,10940
2770,14006,6558,7448,2012,10941
2771,47742,23906,23836,2012,10950
2772,39271,19941,19330,2012,10952
2773,133,54,79,2012,10953
2774,22908,11514,11394,2012,10954
2775,31426,15832,15594,2012,10956
2776,3187,1753,1434,2012,10958
2777,15545,7540,8005,2012,10960
2778,5995,3218,2777,2012,10962
2779,3889,2795,1094,2012,10963
2780,1598,801,797,2012,10964
2781,14799,7235,7564,2012,10965
2782,2194,837,1357,2012,10968
2783,1534,805,729,2012,10969
2784,9164,4020,5144,2012,10970
2785,2462,1373,1089,2012,10973
2786,3141,1608,1533,2012,10974
2787,305,149,156,2012,10975
2788,2179,744,1435,2012,10976
2789,59133,29388,29745,2012,10977
2790,137,92,45,2012,10979
2791,13620,6518,7102,2012,10980
2792,5522,2621,2901,2012,10983
2793,3485,1613,1872,2012,10984
2794,90,47,43,2012,10985
2795,1923,1003,920,2012,10986
2796,3320,1643,1677,2012,10987
2797,983,536,447,2012,10988
2798,9757,4388,5369,2012,10989
2799,20526,10217,10309,2012,10990
2800,9716,4550,5166,2012,10992
2801,4559,2302,2257,2012,10993
2802,6963,3297,3666,2012,10994
2803,7286,5398,1888,2012,10996
2804,2818,1364,1454,2012,10998
2805,27104,13213,13891,2012,11001
2806,44016,20577,23439,2012,11003
2807,14178,6578,7600,2012,11004
2808,1963,694,1269,2012,11005
2809,23800,11187,12613,2012,11010
2810,6139,3015,3124,2012,11020
2811,17449,8097,9352,2012,11021
2812,9400,4778,4622,2012,11023
2813,7784,4129,3655,2012,11024
2814,17854,8485,9369,2012,11030
2815,40005,19490,20515,2012,11040
2816,541,189,352,2012,11042
2817,30397,14946,15451,2012,11050
2818,8091,3868,4223,2012,11096
2819,24405,12195,12210,2012,11101
2820,33742,17166,16576,2012,11102
2821,36724,18373,18351,2012,11103
2822,26321,12471,13850,2012,11104
2823,37438,18586,18852,2012,11105
2824,36958,17848,19110,2012,11106
2825,3272,1808,1464,2012,11109
2826,52242,25736,26506,2012,11201
2827,80202,35875,44327,2012,11203
2828,80341,40249,40092,2012,11204
2829,40125,19370,20755,2012,11205
2830,80086,38351,41735,2012,11206
2831,92054,41291,50763,2012,11207
2832,93998,43029,50969,2012,11208
2833,72434,34128,38306,2012,11209
2834,64041,29984,34057,2012,11210
2835,90510,44300,46210,2012,11211
2836,81267,34050,47217,2012,11212
2837,61495,27717,33778,2012,11213
2838,81428,39064,42364,2012,11214
2839,67195,32141,35054,2012,11215
2840,53662,24696,28966,2012,11216
2841,38398,18154,20244,2012,11217
2842,74571,36743,37828,2012,11218
2843,95069,48358,46711,2012,11219
2844,100476,51276,49200,2012,11220
2845,80254,36607,43647,2012,11221
2846,33718,16576,17142,2012,11222
2847,74700,35936,38764,2012,11223
2848,44047,19872,24175,2012,11224
2849,60179,27441,32738,2012,11225
2850,99285,45103,54182,2012,11226
2851,43396,21503,21893,2012,11228
2852,79268,38092,41176,2012,11229
2853,84707,41061,43646,2012,11230
2854,34393,16035,18358,2012,11231
2855,28703,15982,12721,2012,11232
2856,67661,30268,37393,2012,11233
2857,95390,44561,50829,2012,11234
2858,72447,33352,39095,2012,11235
2859,97084,43536,53548,2012,11236
2860,53031,27431,25600,2012,11237
2861,52033,23853,28180,2012,11238
2862,12850,4442,8408,2012,11239
2863,0,0,0,2012,11351
2864,55543,26770,28773,2012,11354
2865,83938,40701,43237,2012,11355
2866,22947,11651,11296,2012,11356
2867,40705,18876,21829,2012,11357
2868,39143,18860,20283,2012,11358
2869,0,0,0,2012,11359
2870,20688,9954,10734,2012,11360
2871,29197,13801,15396,2012,11361
2872,18220,8877,9343,2012,11362
2873,7442,3847,3595,2012,11363
2874,35106,16938,18168,2012,11364
2875,41520,19246,22274,2012,11365
2876,13593,6729,6864,2012,11366
2877,39424,19001,20423,2012,11367
2878,104486,56130,48356,2012,11368
2879,40160,20498,19662,2012,11369
2880,37755,23257,14498,2012,11370
2881,0,0,0,2012,11371
2882,62857,31598,31259,2012,11372
2883,97430,49533,47897,2012,11373
2884,42484,19977,22507,2012,11374
2885,69745,31484,38261,2012,11375
2886,87284,43389,43895,2012,11377
2887,32187,15598,16589,2012,11378
2888,35680,17142,18538,2012,11379
2889,99508,48681,50827,2012,11385
2890,19357,8953,10404,2012,11411
2891,36660,16240,20420,2012,11412
2892,39291,17856,21435,2012,11413
2893,28769,13020,15749,2012,11414
2894,19464,9478,9986,2012,11415
2895,24977,11956,13021,2012,11416
2896,30325,14731,15594,2012,11417
2897,36821,18494,18327,2012,11418
2898,48119,23592,24527,2012,11419
2899,48226,23239,24987,2012,11420
2900,41872,20877,20995,2012,11421
2901,33116,14468,18648,2012,11422
2902,31425,14769,16656,2012,11423
2903,0,0,0,2012,11424
2904,0,0,0,2012,11425
2905,18847,9348,9499,2012,11426
2906,24601,11790,12811,2012,11427
2907,19784,9982,9802,2012,11428
2908,28571,13404,15167,2012,11429
2909,101,101,0,2012,11430
2910,58705,28506,30199,2012,11432
2911,30851,13460,17391,2012,11433
2912,61853,27314,34539,2012,11434
2913,52288,25946,26342,2012,11435
2914,17316,8414,8902,2012,11436
2915,0,0,0,2012,11451
2916,18982,9294,9688,2012,11501
2917,7215,3398,3817,2012,11507
2918,2159,1043,1116,2012,11509
2919,33152,15942,17210,2012,11510
2920,5332,2619,2713,2012,11514
2921,7486,3745,3741,2012,11516
2922,10307,5067,5240,2012,11518
2923,43246,21011,22235,2012,11520
2924,27982,13191,14791,2012,11530
2925,27530,13774,13756,2012,11542
2926,13070,6450,6620,2012,11545
2927,655,233,422,2012,11547
2928,2347,957,1390,2012,11548
2929,2567,888,1679,2012,11549
2930,56347,26777,29570,2012,11550
2931,22872,11080,11792,2012,11552
2932,26430,12533,13897,2012,11553
2933,38126,18941,19185,2012,11554
2934,0,0,0,2012,11556
2935,7214,3598,3616,2012,11557
2936,8456,4065,4391,2012,11558
2937,8020,4066,3954,2012,11559
2938,6628,3217,3411,2012,11560
2939,37881,18130,19751,2012,11561
2940,22953,10729,12224,2012,11563
2941,8779,4161,4618,2012,11565
2942,33980,16391,17589,2012,11566
2943,3858,1947,1911,2012,11568
2944,1225,590,635,2012,11569
2945,26870,13118,13752,2012,11570
2946,29540,14378,15162,2012,11572
2947,16408,7696,8712,2012,11575
2948,12060,5923,6137,2012,11576
2949,12511,6156,6355,2012,11577
2950,5265,2794,2471,2012,11579
2951,40500,19570,20930,2012,11580
2952,20553,10299,10254,2012,11581
2953,44977,21660,23317,2012,11590
2954,10517,5191,5326,2012,11596
2955,12972,6401,6571,2012,11598
2956,61442,28049,33393,2012,11691
2957,16870,8062,8808,2012,11692
2958,11415,5441,5974,2012,11693
2959,21281,10389,10892,2012,11694
2960,4344,2140,2204,2012,11697
2961,26349,12283,14066,2012,11701
2962,15255,7384,7871,2012,11702
2963,16075,7913,8162,2012,11703
2964,40968,19531,21437,2012,11704
2965,7859,3602,4257,2012,11705
2966,66314,32831,33483,2012,11706
2967,6690,3078,3612,2012,11709
2968,34467,17363,17104,2012,11710
2969,9648,4312,5336,2012,11713
2970,23447,11121,12326,2012,11714
2971,4417,2037,2380,2012,11715
2972,10953,5236,5717,2012,11716
2973,57011,29185,27826,2012,11717
2974,3122,1572,1550,2012,11718
2975,2940,1314,1626,2012,11719
2976,29603,14918,14685,2012,11720
2977,6503,3065,3438,2012,11721
2978,38140,18953,19187,2012,11722
2979,2616,1313,1303,2012,11724
2980,29199,14104,15095,2012,11725
2981,19600,9622,9978,2012,11726
2982,28126,13777,14349,2012,11727
2983,28149,13238,14911,2012,11729
2984,14126,6532,7594,2012,11730
2985,29959,15292,14667,2012,11731
2986,3443,1522,1921,2012,11732
2987,18236,9266,8970,2012,11733
2988,32221,15753,16468,2012,11735
2989,18559,9744,8815,2012,11738
2990,1473,766,707,2012,11739
2991,9478,4567,4911,2012,11740
2992,27747,13279,14468,2012,11741
2993,12979,6407,6572,2012,11742
2994,42887,21035,21852,2012,11743
2995,67290,33478,33812,2012,11746
2996,19806,9375,10431,2012,11747
2997,3406,1713,1693,2012,11749
2998,14152,7116,7036,2012,11751
2999,9184,4676,4508,2012,11752
3000,11786,5564,6222,2012,11753
3001,19368,9832,9536,2012,11754
3002,12263,6289,5974,2012,11755
3003,43510,21302,22208,2012,11756
3004,45623,21689,23934,2012,11757
3005,54795,26486,28309,2012,11758
3006,22326,10565,11761,2012,11762
3007,30422,14662,15760,2012,11763
3008,13280,6503,6777,2012,11764
3009,586,297,289,2012,11765
3010,11976,5704,6272,2012,11766
3011,15081,7280,7801,2012,11767
3012,21808,10842,10966,2012,11768
3013,8673,4218,4455,2012,11769
3014,235,95,140,2012,11770
3015,9449,4747,4702,2012,11771
3016,45435,22592,22843,2012,11772
3017,26308,12768,13540,2012,11776
3018,9453,4619,4834,2012,11777
3019,12354,6042,6312,2012,11778
3020,39176,19550,19626,2012,11779
3021,14733,6985,7748,2012,11780
3022,15200,6965,8235,2012,11782
3023,21131,10119,11012,2012,11783
3024,25611,12561,13050,2012,11784
3025,6273,3137,3136,2012,11786
3026,35969,18039,17930,2012,11787
3027,16333,8044,8289,2012,11788
3028,7506,3673,3833,2012,11789
3029,17672,8926,8746,2012,11790
3030,25240,12459,12781,2012,11791
3031,9309,4686,4623,2012,11792
3032,31898,15384,16514,2012,11793
3033,3150,1686,1464,2012,11794
3034,25709,12321,13388,2012,11795
3035,3758,1844,1914,2012,11796
3036,8789,4190,4599,2012,11797
3037,15025,6896,8129,2012,11798
3038,38777,19156,19621,2012,11801
3039,28133,13383,14750,2012,11803
3040,4973,2449,2524,2012,11804
3041,27934,14945,12989,2012,11901
3042,1255,652,603,2012,11930
3043,21,0,21,2012,11931
3044,895,456,439,2012,11932
3045,7530,3714,3816,2012,11933
3046,7751,3962,3789,2012,11934
3047,3332,1484,1848,2012,11935
3048,15511,7966,7545,2012,11937
3049,1197,611,586,2012,11939
3050,4933,2428,2505,2012,11940
3051,1822,780,1042,2012,11941
3052,4597,2233,2364,2012,11942
3053,4286,2096,2190,2012,11944
3054,13997,7205,6792,2012,11946
3055,150,43,107,2012,11947
3056,995,553,442,2012,11948
3057,13539,7071,6468,2012,11949
3058,16394,8390,8004,2012,11950
3059,13110,6045,7065,2012,11951
3060,4411,2088,2323,2012,11952
3061,12258,5850,6408,2012,11953
3062,3559,1770,1789,2012,11954
3063,2814,1334,1480,2012,11955
3064,313,127,186,2012,11956
3065,661,318,343,2012,11957
3066,441,191,250,2012,11958
3067,677,293,384,2012,11959
3068,878,431,447,2012,11960
3069,11811,5589,6222,2012,11961
3070,447,247,200,2012,11962
3071,6737,3339,3398,2012,11963
3072,1960,899,1061,2012,11964
3073,664,272,392,2012,11965
3074,26818,13366,13452,2012,11967
3075,11658,5746,5912,2012,11968
3076,600,223,377,2012,11970
3077,6057,2970,3087,2012,11971
3078,900,486,414,2012,11972
3079,26,0,26,2012,11973
3080,330,184,146,2012,11975
3081,1870,984,886,2012,11976
3082,2568,1184,1384,2012,11977
3083,3150,1434,1716,2012,11978
3084,4878,2850,2028,2012,11980
3085,88,57,31,2012,12007
3086,544,316,228,2012,12008
3087,7469,3601,3868,2012,12009
3088,28711,13787,14924,2012,12010
3089,3062,1608,1454,2012,12015
3090,310,140,170,2012,12017
3091,7353,3643,3710,2012,12018
3092,15125,7440,7685,2012,12019
3093,30796,14938,15858,2012,12020
3094,964,451,513,2012,12022
3095,2262,1169,1093,2012,12023
3096,103,29,74,2012,12024
3097,5635,2810,2825,2012,12025
3098,3610,1857,1753,2012,12027
3099,1437,696,741,2012,12028
3100,1196,718,478,2012,12029
3101,139,80,59,2012,12031
3102,811,391,420,2012,12032
3103,8226,4190,4036,2012,12033
3104,732,378,354,2012,12035
3105,164,94,70,2012,12036
3106,4344,2014,2330,2012,12037
3107,81,34,47,2012,12040
3108,359,193,166,2012,12041
3109,370,193,177,2012,12042
3110,8443,4240,4203,2012,12043
3111,539,319,220,2012,12045
3112,891,467,424,2012,12046
3113,19590,9227,10363,2012,12047
3114,7291,5093,2198,2012,12051
3115,1297,667,630,2012,12052
3116,3825,2099,1726,2012,12053
3117,16934,8366,8568,2012,12054
3118,2538,1339,1199,2012,12056
3119,2059,1094,965,2012,12057
3120,1218,621,597,2012,12058
3121,1495,698,797,2012,12059
3122,1372,639,733,2012,12060
3123,9774,4608,5166,2012,12061
3124,1555,783,772,2012,12062
3125,441,195,246,2012,12063
3126,481,249,232,2012,12064
3127,41720,20279,21441,2012,12065
3128,2795,1362,1433,2012,12066
3129,1514,822,692,2012,12067
3130,3229,1581,1648,2012,12068
3131,284,195,89,2012,12069
3132,1619,792,827,2012,12070
3133,230,132,98,2012,12071
3134,2778,1442,1336,2012,12072
3135,2896,1414,1482,2012,12074
3136,2862,1421,1441,2012,12075
3137,1458,709,749,2012,12076
3138,6148,3223,2925,2012,12077
3139,23634,11244,12390,2012,12078
3140,3670,1779,1891,2012,12083
3141,4361,2013,2348,2012,12084
3142,492,133,359,2012,12085
3143,1560,742,818,2012,12086
3144,1037,532,505,2012,12087
3145,78,61,17,2012,12089
3146,5894,2674,3220,2012,12090
3147,896,418,478,2012,12092
3148,1755,1014,741,2012,12093
3149,1841,914,927,2012,12094
3150,12504,6391,6113,2012,12095
3151,2321,1026,1295,2012,12106
3152,290,143,147,2012,12108
3153,21331,10305,11026,2012,12110
3154,242,140,102,2012,12115
3155,1765,853,912,2012,12116
3156,3405,1743,1662,2012,12117
3157,14632,6853,7779,2012,12118
3158,813,398,415,2012,12120
3159,1976,1020,956,2012,12121
3160,4491,2179,2312,2012,12122
3161,5103,2537,2566,2012,12123
3162,627,283,344,2012,12124
3163,1427,711,716,2012,12125
3164,1254,634,620,2012,12130
3165,89,56,33,2012,12131
3166,196,84,112,2012,12132
3167,3631,1828,1803,2012,12134
3168,663,333,330,2012,12136
3169,1549,692,857,2012,12137
3170,3286,1597,1689,2012,12138
3171,151,59,92,2012,12139
3172,1777,906,871,2012,12140
3173,5067,2504,2563,2012,12143
3174,19941,9626,10315,2012,12144
3175,472,236,236,2012,12147
3176,4384,2021,2363,2012,12148
3177,2480,1071,1409,2012,12149
3178,736,340,396,2012,12150
3179,559,280,279,2012,12151
3180,1189,629,560,2012,12153
3181,2658,1398,1260,2012,12154
3182,2150,1029,1121,2012,12155
3183,796,358,438,2012,12156
3184,4638,2173,2465,2012,12157
3185,6354,3032,3322,2012,12158
3186,7882,3773,4109,2012,12159
3187,953,496,457,2012,12160
3188,302,198,104,2012,12161
3189,313,141,172,2012,12164
3190,160,96,64,2012,12165
3191,1353,695,658,2012,12166
3192,2580,1134,1446,2012,12167
3193,1929,887,1042,2012,12168
3194,246,146,100,2012,12169
3195,5073,2624,2449,2012,12170
3196,249,151,98,2012,12172
3197,1710,878,832,2012,12173
3198,255,143,112,2012,12174
3199,895,530,365,2012,12175
3200,419,273,146,2012,12176
3201,505,314,191,2012,12177
3202,54011,27186,26825,2012,12180
3203,14534,7291,7243,2012,12182
3204,2603,1301,1302,2012,12183
3205,6897,3475,3422,2012,12184
3206,2485,1180,1305,2012,12185
3207,6331,3238,3093,2012,12186
3208,420,195,225,2012,12187
3209,11126,5385,5741,2012,12188
3210,17365,8250,9115,2012,12189
3211,663,336,327,2012,12190
3212,1875,796,1079,2012,12192
3213,1753,930,823,2012,12193
3214,147,78,69,2012,12194
3215,194,93,101,2012,12195
3216,3373,1621,1752,2012,12196
3217,2431,1157,1274,2012,12197
3218,7700,3603,4097,2012,12198
3219,9079,3870,5209,2012,12202
3220,30078,13984,16094,2012,12203
3221,7205,3354,3851,2012,12204
3222,27575,13488,14087,2012,12205
3223,17170,8474,8696,2012,12206
3224,1792,1101,691,2012,12207
3225,21398,10061,11337,2012,12208
3226,10830,4959,5871,2012,12209
3227,8992,4849,4143,2012,12210
3228,11840,5922,5918,2012,12211
3229,5995,3053,2942,2012,12222
3230,27672,13271,14401,2012,12302
3231,30294,14479,15815,2012,12303
3232,21600,9980,11620,2012,12304
3233,5090,2829,2261,2012,12305
3234,26371,12802,13569,2012,12306
3235,7018,3409,3609,2012,12307
3236,14749,7052,7697,2012,12308
3237,29656,14213,15443,2012,12309
3238,35043,16587,18456,2012,12401
3239,3127,1705,1422,2012,12404
3240,451,262,189,2012,12405
3241,635,305,330,2012,12406
3242,165,67,98,2012,12407
3243,500,246,254,2012,12409
3244,558,295,263,2012,12410
3245,436,243,193,2012,12411
3246,522,310,212,2012,12412
3247,2912,1323,1589,2012,12413
3248,10498,5389,5109,2012,12414
3249,339,147,192,2012,12416
3250,652,286,366,2012,12417
3251,319,162,157,2012,12418
3252,451,165,286,2012,12419
3253,506,272,234,2012,12420
3254,528,313,215,2012,12421
3255,276,147,129,2012,12422
3256,1224,562,662,2012,12423
3257,295,129,166,2012,12424
3258,531,231,300,2012,12427
3259,6541,3255,3286,2012,12428
3260,360,223,137,2012,12429
3261,1110,472,638,2012,12430
3262,1466,748,718,2012,12431
3263,491,204,287,2012,12432
3264,441,270,171,2012,12433
3265,595,278,317,2012,12434
3266,280,160,120,2012,12435
3267,491,265,226,2012,12436
3268,34,13,21,2012,12438
3269,154,83,71,2012,12439
3270,2157,1001,1156,2012,12440
3271,76,41,35,2012,12441
3272,801,409,392,2012,12442
3273,3643,1828,1815,2012,12443
3274,523,224,299,2012,12444
3275,5004,2519,2485,2012,12446
3276,488,250,238,2012,12448
3277,3262,1612,1650,2012,12449
3278,347,160,187,2012,12450
3279,1960,1047,913,2012,12451
3280,291,120,171,2012,12452
3281,390,257,133,2012,12453
3282,202,113,89,2012,12454
3283,2077,1110,967,2012,12455
3284,797,361,436,2012,12456
3285,1000,476,524,2012,12457
3286,3400,2344,1056,2012,12458
3287,136,78,58,2012,12459
3288,278,118,160,2012,12460
3289,1949,1036,913,2012,12461
3290,1049,548,501,2012,12463
3291,808,401,407,2012,12464
3292,154,92,62,2012,12465
3293,2365,1052,1313,2012,12466
3294,1018,528,490,2012,12468
3295,683,362,321,2012,12469
3296,826,279,547,2012,12470
3297,694,271,423,2012,12471
3298,1645,878,767,2012,12472
3299,959,401,558,2012,12473
3300,1464,686,778,2012,12474
3301,424,226,198,2012,12475
3302,18695,9301,9394,2012,12477
3303,580,275,305,2012,12480
3304,1058,518,540,2012,12481
3305,702,420,282,2012,12482
3306,405,171,234,2012,12483
3307,3203,1421,1782,2012,12484
3308,731,383,348,2012,12485
3309,1595,828,767,2012,12486
3310,3153,1617,1536,2012,12487
3311,877,669,208,2012,12489
3312,58,40,18,2012,12490
3313,1937,956,981,2012,12491
3314,336,165,171,2012,12492
3315,263,82,181,2012,12493
3316,942,394,548,2012,12494
3317,158,88,70,2012,12495
3318,1765,869,896,2012,12496
3319,5197,2536,2661,2012,12498
3320,2476,1271,1205,2012,12501
3321,1005,539,466,2012,12502
3322,781,428,353,2012,12503
3323,1224,547,677,2012,12504
3324,153,81,72,2012,12507
3325,20459,10449,10010,2012,12508
3326,186,88,98,2012,12512
3327,561,343,218,2012,12513
3328,2690,1454,1236,2012,12514
3329,1209,619,590,2012,12515
3330,2023,973,1050,2012,12516
3331,691,404,287,2012,12517
3332,5856,3001,2855,2012,12518
3333,3110,1508,1602,2012,12520
3334,1525,739,786,2012,12521
3335,5081,2542,2539,2012,12522
3336,1751,871,880,2012,12523
3337,14758,7627,7131,2012,12524
3338,2967,1627,1340,2012,12525
3339,3579,1631,1948,2012,12526
3340,337,112,225,2012,12527
3341,12875,6153,6722,2012,12528
3342,2714,1332,1382,2012,12529
3343,10,5,5,2012,12530
3344,3217,1548,1669,2012,12531
3345,26083,13207,12876,2012,12533
3346,18560,9714,8846,2012,12534
3347,13885,6574,7311,2012,12538
3348,8221,4028,4193,2012,12540
3349,6234,3082,3152,2012,12542
3350,2974,1385,1589,2012,12543
3351,4640,2148,2492,2012,12545
3352,2992,1493,1499,2012,12546
3353,2698,1423,1275,2012,12547
3354,1601,812,789,2012,12548
3355,10113,4966,5147,2012,12549
3356,55405,26379,29026,2012,12550
3357,25156,12022,13134,2012,12553
3358,18087,8086,10001,2012,12561
3359,7748,3755,3993,2012,12563
3360,7567,3802,3765,2012,12564
3361,1338,734,604,2012,12565
3362,11004,5669,5335,2012,12566
3363,2667,1393,1274,2012,12567
3364,9526,4753,4773,2012,12569
3365,7375,3782,3593,2012,12570
3366,10486,5310,5176,2012,12571
3367,9085,4555,4530,2012,12572
3368,365,147,218,2012,12574
3369,2127,1028,1099,2012,12575
3370,1364,658,706,2012,12577
3371,2737,1504,1233,2012,12578
3372,4872,2232,2640,2012,12580
3373,2325,1065,1260,2012,12581
3374,6201,4081,2120,2012,12582
3375,2471,1191,1280,2012,12583
3376,686,330,356,2012,12585
3377,12520,6731,5789,2012,12586
3378,17873,9764,8109,2012,12589
3379,34368,17702,16666,2012,12590
3380,1524,727,797,2012,12592
3381,4287,2178,2109,2012,12594
3382,43400,20410,22990,2012,12601
3383,43043,20777,22266,2012,12603
3384,746,219,527,2012,12604
3385,10740,5274,5466,2012,12701
3386,1275,667,608,2012,12719
3387,77,44,33,2012,12720
3388,5973,3137,2836,2012,12721
3389,113,29,84,2012,12722
3390,2195,1026,1169,2012,12723
3391,264,117,147,2012,12724
3392,237,122,115,2012,12725
3393,986,453,533,2012,12726
3394,1863,1123,740,2012,12729
3395,551,286,265,2012,12732
3396,1335,920,415,2012,12733
3397,840,516,324,2012,12734
3398,170,69,101,2012,12736
3399,2181,1127,1054,2012,12737
3400,515,223,292,2012,12738
3401,1719,804,915,2012,12740
3402,352,191,161,2012,12741
3403,430,217,213,2012,12742
3404,296,173,123,2012,12743
3405,161,65,96,2012,12745
3406,1101,583,518,2012,12746
3407,1633,701,932,2012,12747
3408,1964,1030,934,2012,12748
3409,206,94,112,2012,12749
3410,109,66,43,2012,12750
3411,932,406,526,2012,12751
3412,228,142,86,2012,12752
3413,7672,4054,3618,2012,12754
3414,4074,2136,1938,2012,12758
3415,2016,1074,942,2012,12759
3416,645,286,359,2012,12760
3417,503,239,264,2012,12762
3418,785,343,442,2012,12763
3419,1722,867,855,2012,12764
3420,777,316,461,2012,12765
3421,436,233,203,2012,12766
3422,126,68,58,2012,12767
3423,971,532,439,2012,12768
3424,123,66,57,2012,12769
3425,300,144,156,2012,12770
3426,14639,6958,7681,2012,12771
3427,2434,1232,1202,2012,12775
3428,2105,1053,1052,2012,12776
3429,876,372,504,2012,12777
3430,612,348,264,2012,12778
3431,2310,1308,1002,2012,12779
3432,2217,1073,1144,2012,12780
3433,366,145,221,2012,12781
3434,1825,1063,762,2012,12783
3435,68,22,46,2012,12784
3436,933,434,499,2012,12785
3437,611,327,284,2012,12786
3438,429,183,246,2012,12787
3439,3285,2052,1233,2012,12788
3440,1745,849,896,2012,12789
3441,4601,2271,2330,2012,12790
3442,750,411,339,2012,12791
3443,392,190,202,2012,12792
3444,14696,6956,7740,2012,12801
3445,7852,3915,3937,2012,12803
3446,26265,12614,13651,2012,12804
3447,298,163,135,2012,12808
3448,3576,1821,1755,2012,12809
3449,584,306,278,2012,12810
3450,236,90,146,2012,12811
3451,152,71,81,2012,12812
3452,1846,908,938,2012,12814
3453,976,458,518,2012,12815
3454,4522,2176,2346,2012,12816
3455,1984,928,1056,2012,12817
3456,463,224,239,2012,12819
3457,2250,2133,117,2012,12821
3458,6139,3103,3036,2012,12822
3459,160,94,66,2012,12823
3460,819,433,386,2012,12824
3461,3951,2035,1916,2012,12827
3462,9817,4857,4960,2012,12828
3463,17212,8884,8328,2012,12831
3464,6716,3237,3479,2012,12832
3465,4160,2001,2159,2012,12833
3466,6527,3234,3293,2012,12834
3467,2446,1278,1168,2012,12835
3468,574,295,279,2012,12836
3469,979,496,483,2012,12837
3470,450,248,202,2012,12838
3471,13299,6453,6846,2012,12839
3472,128,54,74,2012,12841
3473,1235,620,615,2012,12842
3474,533,274,259,2012,12843
3475,166,88,78,2012,12844
3476,5033,2498,2535,2012,12845
3477,3333,1692,1641,2012,12846
3478,628,338,290,2012,12847
3479,503,257,246,2012,12849
3480,2917,1558,1359,2012,12850
3481,208,102,106,2012,12851
3482,516,234,282,2012,12852
3483,1457,719,738,2012,12853
3484,157,79,78,2012,12855
3485,48,18,30,2012,12856
3486,486,248,238,2012,12857
3487,76,48,28,2012,12858
3488,2448,1224,1224,2012,12859
3489,1188,605,583,2012,12860
3490,785,430,355,2012,12861
3491,0,0,0,2012,12862
3492,598,333,265,2012,12863
3493,60,37,23,2012,12864
3494,3538,1745,1793,2012,12865
3495,36752,18015,18737,2012,12866
3496,1505,711,794,2012,12870
3497,4269,2172,2097,2012,12871
3498,77,20,57,2012,12872
3499,684,304,380,2012,12873
3500,155,77,78,2012,12874
3501,838,419,419,2012,12878
3502,5045,2338,2707,2012,12883
3503,397,223,174,2012,12884
3504,4568,2354,2214,2012,12885
3505,313,142,171,2012,12886
3506,5600,3247,2353,2012,12887
3507,33238,16179,17059,2012,12901
3508,1104,480,624,2012,12903
3509,2234,1455,779,2012,12910
3510,35,9,26,2012,12911
3511,2423,1135,1288,2012,12912
3512,1113,573,540,2012,12913
3513,778,407,371,2012,12914
3514,2252,1063,1189,2012,12916
3515,1225,629,596,2012,12917
3516,2457,1361,1096,2012,12918
3517,2808,1487,1321,2012,12919
3518,2826,1520,1306,2012,12920
3519,2262,1180,1082,2012,12921
3520,32,21,11,2012,12922
3521,622,304,318,2012,12923
3522,145,56,89,2012,12924
3523,1866,996,870,2012,12926
3524,192,95,97,2012,12927
3525,2064,1111,953,2012,12928
3526,4037,3442,595,2012,12929
3527,888,453,435,2012,12930
3528,1407,687,720,2012,12932
3529,12,3,9,2012,12933
3530,1216,592,624,2012,12934
3531,1578,834,744,2012,12935
3532,572,268,304,2012,12936
3533,1386,736,650,2012,12937
3534,203,128,75,2012,12939
3535,1298,626,672,2012,12941
3536,664,362,302,2012,12942
3537,265,132,133,2012,12943
3538,3998,1893,2105,2012,12944
3539,424,215,209,2012,12945
3540,5337,2854,2483,2012,12946
3541,872,453,419,2012,12950
3542,342,153,189,2012,12952
3543,16001,9973,6028,2012,12953
3544,392,193,199,2012,12955
3545,1157,651,506,2012,12956
3546,1677,765,912,2012,12957
3547,1825,911,914,2012,12958
3548,1542,775,767,2012,12959
3549,1263,725,538,2012,12960
3550,198,93,105,2012,12961
3551,5941,2934,3007,2012,12962
3552,172,87,85,2012,12964
3553,408,211,197,2012,12965
3554,3395,1774,1621,2012,12966
3555,1065,578,487,2012,12967
3556,500,278,222,2012,12969
3557,1047,715,332,2012,12970
3558,6680,3311,3369,2012,12972
3559,206,95,111,2012,12973
3560,1513,712,801,2012,12974
3561,260,118,142,2012,12975
3562,96,40,56,2012,12976
3563,1875,1870,5,2012,12977
3564,335,191,144,2012,12978
3565,2661,1199,1462,2012,12979
3566,1188,577,611,2012,12980
3567,2333,1128,1205,2012,12981
3568,7842,4069,3773,2012,12983
3569,1001,438,563,2012,12985
3570,6117,3098,3019,2012,12986
3571,227,93,134,2012,12987
3572,1174,612,562,2012,12989
3573,4534,2314,2220,2012,12992
3574,1640,850,790,2012,12993
3575,1772,895,877,2012,12996
3576,1145,569,576,2012,12997
3577,690,284,406,2012,12998
3578,170,91,79,2012,13020
3579,39017,18857,20160,2012,13021
3580,1704,1704,0,2012,13024
3581,1723,804,919,2012,13026
3582,31318,15022,16296,2012,13027
3583,1443,785,658,2012,13028
3584,7202,3454,3748,2012,13029
3585,3863,1989,1874,2012,13030
3586,15188,7135,8053,2012,13031
3587,13694,6700,6994,2012,13032
3588,4470,2215,2255,2012,13033
3589,1794,851,943,2012,13034
3590,8490,4121,4369,2012,13035
3591,8816,4399,4417,2012,13036
3592,8580,3977,4603,2012,13037
3593,17361,8485,8876,2012,13039
3594,2341,1220,1121,2012,13040
3595,10725,5495,5230,2012,13041
3596,1981,986,995,2012,13042
3597,2546,1329,1217,2012,13044
3598,30052,14410,15642,2012,13045
3599,26,13,13,2012,13051
3600,1651,830,821,2012,13052
3601,3887,1945,1942,2012,13053
3602,1293,561,732,2012,13054
3603,15235,7500,7735,2012,13057
3604,2277,987,1290,2012,13060
3605,1286,695,591,2012,13061
3606,304,165,139,2012,13062
3607,1995,943,1052,2012,13063
3608,10,5,5,2012,13064
3609,11821,5458,6363,2012,13066
3610,5245,2574,2671,2012,13068
3611,24968,12448,12520,2012,13069
3612,840,436,404,2012,13071
3613,1121,672,449,2012,13072
3614,6390,3074,3316,2012,13073
3615,4648,2198,2450,2012,13074
3616,2427,1212,1215,2012,13076
3617,6525,3096,3429,2012,13077
3618,10505,5287,5218,2012,13078
3619,3962,2098,1864,2012,13080
3620,1207,594,613,2012,13081
3621,4224,2078,2146,2012,13082
3622,1726,848,878,2012,13083
3623,4246,2200,2046,2012,13084
3624,294,150,144,2012,13087
3625,21475,10201,11274,2012,13088
3626,30257,15133,15124,2012,13090
3627,2992,1469,1523,2012,13092
3628,2615,1335,1280,2012,13101
3629,340,175,165,2012,13102
3630,334,189,145,2012,13103
3631,15951,7704,8247,2012,13104
3632,6424,3187,3237,2012,13108
3633,2324,1277,1047,2012,13110
3634,1485,700,785,2012,13111
3635,1900,966,934,2012,13112
3636,262,143,119,2012,13113
3637,6495,3282,3213,2012,13114
3638,166,69,97,2012,13115
3639,3463,1656,1807,2012,13116
3640,177,91,86,2012,13117
3641,6164,3608,2556,2012,13118
3642,2024,989,1035,2012,13120
3643,869,416,453,2012,13122
3644,84,45,39,2012,13123
3645,119,59,60,2012,13124
3646,37483,18742,18741,2012,13126
3647,3707,1838,1869,2012,13131
3648,3789,1901,1888,2012,13132
3649,37,7,30,2012,13134
3650,6715,3251,3464,2012,13135
3651,486,261,225,2012,13136
3652,29,15,14,2012,13138
3653,4159,2073,2086,2012,13140
3654,456,255,201,2012,13141
3655,6430,3224,3206,2012,13142
3656,3262,1910,1352,2012,13143
3657,1527,803,724,2012,13144
3658,1872,917,955,2012,13145
3659,2398,1206,1192,2012,13146
3660,1599,805,794,2012,13147
3661,10772,5348,5424,2012,13148
3662,8207,4010,4197,2012,13152
3663,267,167,100,2012,13153
3664,686,381,305,2012,13155
3665,2296,1176,1120,2012,13156
3666,770,429,341,2012,13157
3667,1891,968,923,2012,13158
3668,5605,2841,2764,2012,13159
3669,2086,1053,1033,2012,13160
3670,629,347,282,2012,13162
3671,303,174,129,2012,13163
3672,2604,1335,1269,2012,13164
3673,10729,5028,5701,2012,13165
3674,5706,3004,2702,2012,13166
3675,3179,1516,1663,2012,13167
3676,5209,2884,2325,2012,13202
3677,15513,7442,8071,2012,13203
3678,20777,10515,10262,2012,13204
3679,19511,9059,10452,2012,13205
3680,15650,7149,8501,2012,13206
3681,13543,6175,7368,2012,13207
3682,22475,10736,11739,2012,13208
3683,13149,6387,6762,2012,13209
3684,28368,13218,15150,2012,13210
3685,6711,3106,3605,2012,13211
3686,20638,9664,10974,2012,13212
3687,8289,3722,4567,2012,13214
3688,15599,7396,8203,2012,13215
3689,15095,7412,7683,2012,13219
3690,8868,4197,4671,2012,13224
3691,0,0,0,2012,13290
3692,194,93,101,2012,13301
3693,1546,793,753,2012,13302
3694,1045,586,459,2012,13303
3695,1387,729,658,2012,13304
3696,346,175,171,2012,13305
3697,3710,1850,1860,2012,13308
3698,6143,3054,3089,2012,13309
3699,559,334,225,2012,13310
3700,300,161,139,2012,13312
3701,512,244,268,2012,13313
3702,532,291,241,2012,13314
3703,1536,806,730,2012,13315
3704,6746,3530,3216,2012,13316
3705,3744,1845,1899,2012,13317
3706,1244,645,599,2012,13318
3707,1181,450,731,2012,13319
3708,2076,1046,1030,2012,13320
3709,980,409,571,2012,13321
3710,1103,530,573,2012,13322
3711,11348,5359,5989,2012,13323
3712,2249,1193,1056,2012,13324
3713,985,524,461,2012,13325
3714,5515,2472,3043,2012,13326
3715,1952,975,977,2012,13327
3716,1301,663,638,2012,13328
3717,3899,2048,1851,2012,13329
3718,254,131,123,2012,13331
3719,2573,1327,1246,2012,13332
3720,49,20,29,2012,13333
3721,1239,623,616,2012,13334
3722,1617,805,812,2012,13335
3723,680,319,361,2012,13337
3724,1087,525,562,2012,13338
3725,6900,3476,3424,2012,13339
3726,7878,3831,4047,2012,13340
3727,116,28,88,2012,13341
3728,230,114,116,2012,13342
3729,1560,840,720,2012,13343
3730,244,131,113,2012,13345
3731,6843,3327,3516,2012,13346
3732,1129,561,568,2012,13348
3733,10094,4823,5271,2012,13350
3734,271,146,125,2012,13352
3735,40,20,20,2012,13353
3736,3295,1534,1761,2012,13354
3737,825,401,424,2012,13355
3738,11201,5340,5861,2012,13357
3739,566,299,267,2012,13360
3740,993,575,418,2012,13361
3741,128,52,76,2012,13362
3742,2475,1147,1328,2012,13363
3743,338,128,210,2012,13364
3744,8837,4495,4342,2012,13365
3745,8545,4213,4332,2012,13367
3746,1287,649,638,2012,13368
3747,1540,841,699,2012,13402
3748,7641,5448,2193,2012,13403
3749,300,179,121,2012,13404
3750,725,352,373,2012,13406
3751,5474,2482,2992,2012,13407
3752,3604,1824,1780,2012,13408
3753,2827,1320,1507,2012,13409
3754,265,139,126,2012,13410
3755,3889,1973,1916,2012,13411
3756,16067,7616,8451,2012,13413
3757,59,36,23,2012,13415
3758,2186,1022,1164,2012,13416
3759,3169,1315,1854,2012,13417
3760,361,208,153,2012,13418
3761,1215,655,560,2012,13420
3762,14191,6675,7516,2012,13421
3763,2722,1488,1234,2012,13424
3764,2278,1151,1127,2012,13425
3765,1499,715,784,2012,13428
3766,2169,985,1184,2012,13431
3767,1934,952,982,2012,13433
3768,213,109,104,2012,13435
3769,77,50,27,2012,13436
3770,493,233,260,2012,13437
3771,4161,2181,1980,2012,13438
3772,3831,1887,1944,2012,13439
3773,42329,21892,20437,2012,13440
3774,12,8,4,2012,13441
3775,159,72,87,2012,13450
3776,4809,2441,2368,2012,13452
3777,654,315,339,2012,13454
3778,4081,2063,2018,2012,13456
3779,2296,1255,1041,2012,13459
3780,4297,2080,2217,2012,13460
3781,3071,1551,1520,2012,13461
3782,978,477,501,2012,13464
3783,534,228,306,2012,13468
3784,742,402,340,2012,13469
3785,606,307,299,2012,13470
3786,3639,1998,1641,2012,13471
3787,375,193,182,2012,13472
3788,666,366,300,2012,13473
3789,28,10,18,2012,13475
3790,2957,1390,1567,2012,13476
3791,1601,635,966,2012,13477
3792,2886,1457,1429,2012,13478
3793,3609,1802,1807,2012,13480
3794,156,81,75,2012,13483
3795,296,192,104,2012,13484
3796,922,490,432,2012,13485
3797,567,300,267,2012,13486
3798,98,44,54,2012,13488
3799,501,256,245,2012,13489
3800,1347,731,616,2012,13490
3801,3474,1714,1760,2012,13491
3802,11530,5721,5809,2012,13492
3803,2194,1183,1011,2012,13493
3804,346,175,171,2012,13494
3805,2202,1047,1155,2012,13495
3806,37480,17699,19781,2012,13501
3807,34183,16670,17513,2012,13502
3808,38411,19174,19237,2012,13601
3809,3104,2624,480,2012,13602
3810,10386,5087,5299,2012,13603
3811,4740,2430,2310,2012,13605
3812,3049,1460,1589,2012,13606
3813,1993,1000,993,2012,13607
3814,1562,775,787,2012,13608
3815,2877,1453,1424,2012,13612
3816,2669,1341,1328,2012,13613
3817,354,163,191,2012,13614
3818,1052,514,538,2012,13615
3819,1787,987,800,2012,13616
3820,11118,5634,5484,2012,13617
3821,1817,915,902,2012,13618
3822,10687,5259,5428,2012,13619
3823,2298,1079,1219,2012,13620
3824,690,345,345,2012,13621
3825,2971,1460,1511,2012,13622
3826,106,69,37,2012,13623
3827,5395,2950,2445,2012,13624
3828,1843,971,872,2012,13625
3829,1897,1004,893,2012,13626
3830,266,149,117,2012,13628
3831,1582,862,720,2012,13630
3832,344,181,163,2012,13633
3833,4500,2198,2302,2012,13634
3834,850,430,420,2012,13635
3835,270,124,146,2012,13636
3836,4343,2442,1901,2012,13637
3837,252,137,115,2012,13638
3838,201,114,87,2012,13639
3839,214,123,91,2012,13640
3840,64,39,25,2012,13641
3841,10309,5402,4907,2012,13642
3842,84,30,54,2012,13643
3843,2735,1463,1272,2012,13646
3844,66,34,32,2012,13647
3845,2470,1223,1247,2012,13648
3846,1202,596,606,2012,13650
3847,212,114,98,2012,13651
3848,1634,856,778,2012,13652
3849,2311,1219,1092,2012,13654
3850,3443,1666,1777,2012,13655
3851,2758,1422,1336,2012,13656
3852,1995,878,1117,2012,13658
3853,561,307,254,2012,13659
3854,2243,1217,1026,2012,13660
3855,1897,934,963,2012,13661
3856,16631,8023,8608,2012,13662
3857,577,293,284,2012,13664
3858,1560,814,746,2012,13665
3859,367,205,162,2012,13666
3860,2950,1500,1450,2012,13667
3861,3433,1720,1713,2012,13668
3862,17146,8980,8166,2012,13669
3863,484,258,226,2012,13670
3864,608,287,321,2012,13672
3865,2271,1068,1203,2012,13673
3866,143,51,92,2012,13674
3867,26,7,19,2012,13675
3868,16339,8474,7865,2012,13676
3869,196,83,113,2012,13677
3870,214,103,111,2012,13678
3871,1694,868,826,2012,13679
3872,1317,601,716,2012,13680
3873,828,397,431,2012,13681
3874,739,381,358,2012,13682
3875,1003,522,481,2012,13684
3876,2192,1109,1083,2012,13685
3877,547,244,303,2012,13687
3878,907,426,481,2012,13690
3879,3123,1613,1510,2012,13691
3880,77,31,46,2012,13692
3881,434,207,227,2012,13693
3882,1365,613,752,2012,13694
3883,64,38,26,2012,13695
3884,42,0,42,2012,13696
3885,2368,1168,1200,2012,13697
3886,3009,1461,1548,2012,13730
3887,919,459,460,2012,13731
3888,8116,3978,4138,2012,13732
3889,5239,2694,2545,2012,13733
3890,2128,1078,1050,2012,13734
3891,2417,1209,1208,2012,13736
3892,916,484,432,2012,13739
3893,470,244,226,2012,13740
3894,3926,1791,2135,2012,13743
3895,1357,713,644,2012,13744
3896,2212,1159,1053,2012,13746
3897,3855,1857,1998,2012,13748
3898,922,458,464,2012,13750
3899,160,94,66,2012,13751
3900,643,355,288,2012,13752
3901,5818,3065,2753,2012,13753
3902,3708,1771,1937,2012,13754
3903,1621,815,806,2012,13755
3904,516,221,295,2012,13756
3905,980,477,503,2012,13757
3906,44489,21613,22876,2012,13760
3907,275,154,121,2012,13774
3908,1710,829,881,2012,13775
3909,499,194,305,2012,13776
3910,644,305,339,2012,13777
3911,6056,3062,2994,2012,13778
3912,1044,538,506,2012,13780
3913,675,326,349,2012,13782
3914,2169,1144,1025,2012,13783
3915,154,82,72,2012,13784
3916,514,335,179,2012,13786
3917,3617,1766,1851,2012,13787
3918,983,499,484,2012,13788
3919,18610,9116,9494,2012,13790
3920,116,58,58,2012,13794
3921,3861,1772,2089,2012,13795
3922,1251,616,635,2012,13796
3923,2199,1058,1141,2012,13797
3924,1277,687,590,2012,13801
3925,590,332,258,2012,13802
3926,4131,2035,2096,2012,13803
3927,610,292,318,2012,13804
3928,185,102,83,2012,13806
3929,1275,585,690,2012,13807
3930,1547,790,757,2012,13808
3931,1715,870,845,2012,13809
3932,1209,621,588,2012,13810
3933,4295,2116,2179,2012,13811
3934,2310,1185,1125,2012,13812
3935,1089,570,519,2012,13813
3936,14215,6841,7374,2012,13815
3937,22709,10849,11860,2012,13820
3938,3406,1587,1819,2012,13825
3939,0,0,0,2012,13826
3940,12167,6131,6036,2012,13827
3941,4804,2383,2421,2012,13830
3942,698,348,350,2012,13832
3943,4161,1985,2176,2012,13833
3944,46,34,12,2012,13834
3945,1568,834,734,2012,13835
3946,4277,2154,2123,2012,13838
3947,1470,793,677,2012,13839
3948,595,290,305,2012,13841
3949,646,310,336,2012,13842
3950,1534,810,724,2012,13843
3951,818,500,318,2012,13844
3952,153,86,67,2012,13845
3953,281,141,140,2012,13846
3954,107,51,56,2012,13847
3955,4277,2153,2124,2012,13849
3956,21926,10067,11859,2012,13850
3957,6622,3272,3350,2012,13856
3958,248,163,85,2012,13859
3959,87,50,37,2012,13860
3960,515,241,274,2012,13861
3961,4284,2100,2184,2012,13862
3962,759,396,363,2012,13863
3963,1059,503,556,2012,13864
3964,6465,3418,3047,2012,13865
3965,18625,9104,9521,2012,13901
3966,6158,3064,3094,2012,13902
3967,19376,9303,10073,2012,13903
3968,9288,4618,4670,2012,13904
3969,28342,14773,13569,2012,13905
3970,9860,5288,4572,2012,14001
3971,12132,6741,5391,2012,14004
3972,2225,1090,1135,2012,14005
3973,9413,4457,4956,2012,14006
3974,1325,640,685,2012,14008
3975,5654,2917,2737,2012,14009
3976,10102,6818,3284,2012,14011
3977,2266,1066,1200,2012,14012
3978,1816,855,961,2012,14013
3979,23302,11238,12064,2012,14020
3980,1767,851,916,2012,14024
3981,3331,1925,1406,2012,14025
3982,717,407,310,2012,14026
3983,1549,785,764,2012,14028
3984,1647,797,850,2012,14030
3985,9807,4606,5201,2012,14031
3986,7235,3548,3687,2012,14032
3987,2063,886,1177,2012,14033
3988,2967,2104,863,2012,14034
3989,187,137,50,2012,14035
3990,5117,2574,2543,2012,14036
3991,910,473,437,2012,14037
3992,101,51,50,2012,14039
3993,2156,1093,1063,2012,14040
3994,338,160,178,2012,14041
3995,3915,1941,1974,2012,14042
3996,24425,11881,12544,2012,14043
3997,6847,3369,3478,2012,14047
3998,15072,7433,7639,2012,14048
3999,20065,10251,9814,2012,14051
4000,17818,8643,9175,2012,14052
4001,1340,682,658,2012,14054
4002,1653,802,851,2012,14055
4003,8018,3988,4030,2012,14057
4004,2249,1164,1085,2012,14058
4005,9184,4676,4508,2012,14059
4006,631,315,316,2012,14060
4007,271,145,126,2012,14061
4008,3222,1706,1516,2012,14062
4009,14678,7042,7636,2012,14063
4010,1823,955,868,2012,14065
4011,1338,679,659,2012,14066
4012,5038,2531,2507,2012,14067
4013,7363,3246,4117,2012,14068
4014,672,374,298,2012,14069
4015,6629,3828,2801,2012,14070
4016,20324,9761,10563,2012,14072
4017,42670,20452,22218,2012,14075
4018,4671,2345,2326,2012,14080
4019,3061,1465,1596,2012,14081
4020,325,159,166,2012,14082
4021,7025,3651,3374,2012,14085
4022,31685,15674,16011,2012,14086
4023,1286,613,673,2012,14091
4024,11388,5517,5871,2012,14092
4025,51069,24432,26637,2012,14094
4026,3099,1550,1549,2012,14098
4027,2193,1074,1119,2012,14101
4028,1417,664,753,2012,14102
4029,11087,5307,5780,2012,14103
4030,4489,2339,2150,2012,14105
4031,5464,2953,2511,2012,14108
4032,851,259,592,2012,14109
4033,3291,1715,1576,2012,14111
4034,11,6,5,2012,14112
4035,614,325,289,2012,14113
4036,44200,21526,22674,2012,14120
4037,3855,1957,1898,2012,14125
4038,726,347,379,2012,14126
4039,29661,14069,15592,2012,14127
4040,1542,804,738,2012,14129
4041,277,154,123,2012,14130
4042,4903,2517,2386,2012,14131
4043,6585,3110,3475,2012,14132
4044,65,24,41,2012,14134
4045,119,55,64,2012,14135
4046,5054,2333,2721,2012,14136
4047,2199,1044,1155,2012,14138
4048,1914,968,946,2012,14139
4049,7737,3719,4018,2012,14141
4050,1063,536,527,2012,14143
4051,1501,752,749,2012,14145
4052,42258,20429,21829,2012,14150
4053,1678,931,747,2012,14167
4054,91,45,46,2012,14168
4055,368,186,182,2012,14169
4056,2405,1242,1163,2012,14170
4057,1837,892,945,2012,14171
4058,3277,1668,1609,2012,14172
4059,219,143,76,2012,14173
4060,5735,2862,2873,2012,14174
4061,13371,6624,6747,2012,14201
4062,3673,2154,1519,2012,14202
4063,1216,671,545,2012,14203
4064,9202,4114,5088,2012,14204
4065,22248,10790,11458,2012,14206
4066,22694,11409,11285,2012,14207
4067,11258,4894,6364,2012,14208
4068,8071,3602,4469,2012,14209
4069,13318,6351,6967,2012,14210
4070,21906,9897,12009,2012,14211
4071,11078,5475,5603,2012,14212
4072,23220,10979,12241,2012,14213
4073,19625,9525,10100,2012,14214
4074,40084,17726,22358,2012,14215
4075,23066,10879,12187,2012,14216
4076,23048,11197,11851,2012,14217
4077,18953,9231,9722,2012,14218
4078,11015,5210,5805,2012,14219
4079,24299,11233,13066,2012,14220
4080,52863,24530,28333,2012,14221
4081,15605,7743,7862,2012,14222
4082,22790,10882,11908,2012,14223
4083,39939,19350,20589,2012,14224
4084,32751,15265,17486,2012,14225
4085,29514,13938,15576,2012,14226
4086,22821,10836,11985,2012,14227
4087,20774,10461,10313,2012,14228
4088,5492,2650,2842,2012,14261
4089,12985,6103,6882,2012,14301
4090,75,33,42,2012,14302
4091,5790,2852,2938,2012,14303
4092,30128,14972,15156,2012,14304
4093,17411,7914,9497,2012,14305
4094,14525,7385,7140,2012,14411
4095,7119,3693,3426,2012,14414
4096,133,48,85,2012,14415
4097,3607,1928,1679,2012,14416
4098,1165,595,570,2012,14418
4099,20526,9640,10886,2012,14420
4100,2425,1174,1251,2012,14422
4101,4739,2361,2378,2012,14423
4102,26440,12852,13588,2012,14424
4103,10818,5280,5538,2012,14425
4104,2114,972,1142,2012,14427
4105,8511,4447,4064,2012,14428
4106,5813,2828,2985,2012,14432
4107,4219,2184,2035,2012,14433
4108,2956,1482,1474,2012,14435
4109,11380,6392,4988,2012,14437
4110,335,203,132,2012,14441
4111,8008,3834,4174,2012,14445
4112,40922,19654,21268,2012,14450
4113,11050,4796,6254,2012,14454
4114,20177,9755,10422,2012,14456
4115,555,293,262,2012,14462
4116,7087,3355,3732,2012,14464
4117,1677,733,944,2012,14466
4118,9485,4661,4824,2012,14467
4119,17785,9193,8592,2012,14468
4120,5955,2999,2956,2012,14469
4121,7937,3870,4067,2012,14470
4122,2680,1213,1467,2012,14471
4123,8468,4496,3972,2012,14472
4124,243,104,139,2012,14475
4125,2257,1107,1150,2012,14476
4126,2024,1085,939,2012,14477
4127,1528,639,889,2012,14478
4128,316,130,186,2012,14479
4129,831,375,456,2012,14480
4130,1878,1003,875,2012,14481
4131,8305,4204,4101,2012,14482
4132,4345,2090,2255,2012,14485
4133,288,128,160,2012,14486
4134,6101,2948,3153,2012,14487
4135,7512,3676,3836,2012,14489
4136,10576,5198,5378,2012,14502
4137,1557,730,827,2012,14504
4138,5376,2643,2733,2012,14505
4139,1457,701,756,2012,14506
4140,1215,592,623,2012,14507
4141,4892,2364,2528,2012,14510
4142,407,183,224,2012,14511
4143,4737,2396,2341,2012,14512
4144,13829,6477,7352,2012,14513
4145,6243,2779,3464,2012,14514
4146,2174,999,1175,2012,14516
4147,2958,1498,1460,2012,14517
4148,11490,5792,5698,2012,14519
4149,2876,1721,1155,2012,14521
4150,9486,4693,4793,2012,14522
4151,2820,1518,1302,2012,14525
4152,20146,9909,10237,2012,14526
4153,13157,6372,6785,2012,14527
4154,114,55,59,2012,14529
4155,5425,2848,2577,2012,14530
4156,4316,2172,2144,2012,14532
4157,1978,977,1001,2012,14533
4158,32106,15371,16735,2012,14534
4159,555,248,307,2012,14536
4160,158,56,102,2012,14537
4161,157,68,89,2012,14539
4162,4483,3050,1433,2012,14541
4163,47,36,11,2012,14542
4164,3166,1498,1668,2012,14543
4165,2364,1167,1197,2012,14544
4166,201,114,87,2012,14545
4167,4624,2280,2344,2012,14546
4168,4499,2213,2286,2012,14548
4169,42,27,15,2012,14549
4170,1611,840,771,2012,14550
4171,5720,2906,2814,2012,14551
4172,1099,573,526,2012,14555
4173,18069,8824,9245,2012,14559
4174,1628,846,782,2012,14560
4175,3578,1796,1782,2012,14561
4176,14382,7081,7301,2012,14564
4177,6211,2957,3254,2012,14568
4178,6137,2744,3393,2012,14569
4179,1231,613,618,2012,14571
4180,5398,2610,2788,2012,14572
4181,50036,23923,26113,2012,14580
4182,65,23,42,2012,14585
4183,10431,5220,5211,2012,14586
4184,262,247,15,2012,14588
4185,7694,3804,3890,2012,14589
4186,5159,2619,2540,2012,14590
4187,1687,888,799,2012,14591
4188,225,118,107,2012,14592
4189,1494,754,740,2012,14604
4190,13524,6318,7206,2012,14605
4191,30109,13998,16111,2012,14606
4192,16002,8252,7750,2012,14607
4193,12390,5711,6679,2012,14608
4194,42085,19944,22141,2012,14609
4195,14157,6837,7320,2012,14610
4196,17403,7847,9556,2012,14611
4197,35695,16987,18708,2012,14612
4198,13022,6318,6704,2012,14613
4199,1119,1012,107,2012,14614
4200,16573,8159,8414,2012,14615
4201,27969,13005,14964,2012,14616
4202,23091,10878,12213,2012,14617
4203,22370,10326,12044,2012,14618
4204,15078,6817,8261,2012,14619
4205,25960,12821,13139,2012,14620
4206,33133,15646,17487,2012,14621
4207,11808,5520,6288,2012,14622
4208,26462,14658,11804,2012,14623
4209,35755,17336,18419,2012,14624
4210,10563,5086,5477,2012,14625
4211,29627,14184,15443,2012,14626
4212,2780,1412,1368,2012,14627
4213,40408,19549,20859,2012,14701
4214,6359,3139,3220,2012,14706
4215,274,160,114,2012,14707
4216,311,135,176,2012,14708
4217,1486,749,737,2012,14709
4218,3569,1765,1804,2012,14710
4219,1621,867,754,2012,14711
4220,3522,1662,1860,2012,14712
4221,555,275,280,2012,14714
4222,2833,1359,1474,2012,14715
4223,3046,1931,1115,2012,14716
4224,638,365,273,2012,14717
4225,2197,1132,1065,2012,14718
4226,3638,1836,1802,2012,14719
4227,758,408,350,2012,14720
4228,145,75,70,2012,14721
4229,309,148,161,2012,14722
4230,1243,618,625,2012,14723
4231,2424,1120,1304,2012,14724
4232,2080,1051,1029,2012,14726
4233,5335,2805,2530,2012,14727
4234,949,509,440,2012,14728
4235,960,522,438,2012,14729
4236,1267,649,618,2012,14731
4237,135,79,56,2012,14732
4238,4128,2161,1967,2012,14733
4239,2812,1423,1389,2012,14735
4240,180,94,86,2012,14736
4241,4085,1990,2095,2012,14737
4242,3701,1850,1851,2012,14738
4243,2911,1524,1387,2012,14739
4244,1673,766,907,2012,14740
4245,2226,1141,1085,2012,14741
4246,253,108,145,2012,14742
4247,1680,871,809,2012,14743
4248,2255,1108,1147,2012,14744
4249,2203,1127,1076,2012,14747
4250,1011,476,535,2012,14748
4251,4358,2144,2214,2012,14750
4252,181,48,133,2012,14752
4253,1009,510,499,2012,14753
4254,637,318,319,2012,14754
4255,3056,1587,1469,2012,14755
4256,100,0,100,2012,14756
4257,3441,1857,1584,2012,14757
4258,18439,8964,9475,2012,14760
4259,2022,1045,977,2012,14767
4260,983,467,516,2012,14769
4261,2972,1582,1390,2012,14770
4262,4093,2057,2036,2012,14772
4263,267,125,142,2012,14774
4264,2316,1204,1112,2012,14775
4265,622,291,331,2012,14777
4266,1487,685,802,2012,14778
4267,6691,3209,3482,2012,14779
4268,2204,1114,1090,2012,14781
4269,2826,1393,1433,2012,14782
4270,329,172,157,2012,14783
4271,824,456,368,2012,14784
4272,5137,2235,2902,2012,14787
4273,146,66,80,2012,14788
4274,5452,2733,2719,2012,14801
4275,4410,2448,1962,2012,14802
4276,871,423,448,2012,14803
4277,1645,856,789,2012,14804
4278,948,470,478,2012,14805
4279,2200,1106,1094,2012,14806
4280,2884,1499,1385,2012,14807
4281,473,262,211,2012,14808
4282,2314,1230,1084,2012,14809
4283,12418,6274,6144,2012,14810
4284,3596,1995,1601,2012,14812
4285,2577,1430,1147,2012,14813
4286,2287,1092,1195,2012,14814
4287,956,440,516,2012,14815
4288,616,303,313,2012,14816
4289,2273,1251,1022,2012,14817
4290,1834,896,938,2012,14818
4291,944,589,355,2012,14819
4292,689,338,351,2012,14820
4293,3265,1616,1649,2012,14821
4294,1224,662,562,2012,14822
4295,3704,1917,1787,2012,14823
4296,761,375,386,2012,14824
4297,1093,465,628,2012,14825
4298,2168,1043,1125,2012,14826
4299,37,12,25,2012,14827
4300,19636,9699,9937,2012,14830
4301,1067,541,526,2012,14836
4302,5425,2662,2763,2012,14837
4303,1924,958,966,2012,14838
4304,771,392,379,2012,14839
4305,3135,1605,1530,2012,14840
4306,1012,551,461,2012,14841
4307,956,553,403,2012,14842
4308,13065,6338,6727,2012,14843
4309,20350,9958,10392,2012,14845
4310,741,397,344,2012,14846
4311,2339,1111,1228,2012,14847
4312,64394,31590,32804,2012,14850
4313,2769,1371,1398,2012,14853
4314,0,0,0,2012,14854
4315,810,375,435,2012,14855
4316,129,64,65,2012,14856
4317,1863,854,1009,2012,14858
4318,974,420,554,2012,14859
4319,1214,644,570,2012,14860
4320,1263,702,561,2012,14861
4321,1260,633,627,2012,14864
4322,2643,1233,1410,2012,14865
4323,5619,2776,2843,2012,14867
4324,1396,649,747,2012,14869
4325,10131,4941,5190,2012,14870
4326,5278,3028,2250,2012,14871
4327,775,346,429,2012,14872
4328,2457,1298,1159,2012,14873
4329,283,138,145,2012,14874
4330,467,233,234,2012,14877
4331,834,344,490,2012,14878
4332,2165,1022,1143,2012,14879
4333,1579,772,807,2012,14880
4334,100,51,49,2012,14881
4335,3919,1824,2095,2012,14882
4336,4355,2169,2186,2012,14883
4337,223,104,119,2012,14884
4338,1091,540,551,2012,14885
4339,6722,3480,3242,2012,14886
4340,1508,736,772,2012,14889
4341,4448,2138,2310,2012,14891
4342,7960,3813,4147,2012,14892
4343,6,3,3,2012,14893
4344,1477,776,701,2012,14894
4345,9591,4394,5197,2012,14895
4346,939,498,441,2012,14897
4347,2120,965,1155,2012,14898
4348,16658,8900,7758,2012,14901
4349,6927,3356,3571,2012,14903
4350,15806,7607,8199,2012,14904
4351,9897,4684,5213,2012,14905
4352,32722,15736,16986,2012,15001
4353,11789,5648,6141,2012,15003
4354,166,97,69,2012,15004
4355,9453,4636,4817,2012,15005
4356,215,98,117,2012,15006
4357,312,144,168,2012,15007
4358,15084,7289,7795,2012,15009
4359,28476,13686,14790,2012,15010
4360,16243,7717,8526,2012,15012
4361,3204,1460,1744,2012,15014
4362,1228,611,617,2012,15015
4363,15846,7588,8258,2012,15017
4364,710,315,395,2012,15018
4365,1900,859,1041,2012,15019
4366,121,66,55,2012,15020
4367,7926,3898,4028,2012,15021
4368,10061,4546,5515,2012,15022
4369,8603,4137,4466,2012,15024
4370,16098,7422,8676,2012,15025
4371,3021,1506,1515,2012,15026
4372,2103,989,1114,2012,15027
4373,129,61,68,2012,15028
4374,1054,493,561,2012,15030
4375,488,357,131,2012,15031
4376,4981,2288,2693,2012,15033
4377,1859,899,960,2012,15034
4378,2182,1004,1178,2012,15035
4379,11384,5511,5873,2012,15037
4380,354,201,153,2012,15038
4381,8155,3958,4197,2012,15042
4382,2465,1225,1240,2012,15043
4383,26292,12661,13631,2012,15044
4384,4495,2231,2264,2012,15045
4385,2619,1283,1336,2012,15046
4386,0,0,0,2012,15047
4387,933,405,528,2012,15049
4388,2535,1221,1314,2012,15050
4389,523,219,304,2012,15051
4390,3432,1710,1722,2012,15052
4391,121,53,68,2012,15053
4392,379,209,170,2012,15054
4393,1284,575,709,2012,15055
4394,1123,496,627,2012,15056
4395,14362,7029,7333,2012,15057
4396,4264,1832,2432,2012,15059
4397,901,383,518,2012,15060
4398,12434,5945,6489,2012,15061
4399,7732,3565,4167,2012,15062
4400,11435,5466,5969,2012,15063
4401,578,244,334,2012,15064
4402,11823,5578,6245,2012,15065
4403,12682,6218,6464,2012,15066
4404,2423,1207,1216,2012,15067
4405,38270,18621,19649,2012,15068
4406,9850,4812,5038,2012,15071
4407,76,25,51,2012,15072
4408,9169,4432,4737,2012,15074
4409,74,46,28,2012,15075
4410,1074,441,633,2012,15076
4411,163,66,97,2012,15077
4412,329,166,163,2012,15078
4413,345,177,168,2012,15081
4414,191,72,119,2012,15082
4415,821,421,400,2012,15083
4416,9699,4876,4823,2012,15084
4417,7522,3532,3990,2012,15085
4418,381,189,192,2012,15086
4419,289,119,170,2012,15087
4420,775,377,398,2012,15088
4421,5797,2848,2949,2012,15089
4422,21290,10940,10350,2012,15090
4423,25717,12492,13225,2012,15101
4424,29736,14376,15360,2012,15102
4425,9232,4456,4776,2012,15104
4426,18753,9345,9408,2012,15106
4427,39880,19485,20395,2012,15108
4428,5639,2402,3237,2012,15110
4429,3320,1561,1759,2012,15112
4430,13912,6756,7156,2012,15116
4431,19080,8810,10270,2012,15120
4432,20298,9571,10727,2012,15122
4433,6881,3358,3523,2012,15126
4434,10771,5158,5613,2012,15129
4435,8335,3881,4454,2012,15131
4436,21634,10113,11521,2012,15132
4437,6466,3095,3371,2012,15133
4438,5272,2418,2854,2012,15135
4439,21661,10627,11034,2012,15136
4440,10106,4822,5284,2012,15137
4441,6323,2984,3339,2012,15139
4442,3297,1587,1710,2012,15140
4443,1437,656,781,2012,15142
4444,20009,9702,10307,2012,15143
4445,4024,1867,2157,2012,15144
4446,7535,3656,3879,2012,15145
4447,28366,13733,14633,2012,15146
4448,17782,8145,9637,2012,15147
4449,2582,1200,1382,2012,15148
4450,12542,6248,6294,2012,15201
4451,19579,9222,10357,2012,15202
4452,9884,5242,4642,2012,15203
4453,8066,3498,4568,2012,15204
4454,22312,10724,11588,2012,15205
4455,29504,13285,16219,2012,15206
4456,11263,5068,6195,2012,15207
4457,9873,4003,5870,2012,15208
4458,12857,6019,6838,2012,15209
4459,27308,12979,14329,2012,15210
4460,11622,5752,5870,2012,15211
4461,29296,14785,14511,2012,15212
4462,28566,13892,14674,2012,15213
4463,15002,6943,8059,2012,15214
4464,12672,6282,6390,2012,15215
4465,23194,11270,11924,2012,15216
4466,27045,13246,13799,2012,15217
4467,13813,6479,7334,2012,15218
4468,15894,7867,8027,2012,15219
4469,17448,8823,8625,2012,15220
4470,31147,13724,17423,2012,15221
4471,2994,1560,1434,2012,15222
4472,6922,3431,3491,2012,15223
4473,10504,4758,5746,2012,15224
4474,1068,559,509,2012,15225
4475,13432,6204,7228,2012,15226
4476,27772,13057,14715,2012,15227
4477,17864,8638,9226,2012,15228
4478,13953,6654,7299,2012,15229
4479,12114,6129,5985,2012,15232
4480,4164,2951,1213,2012,15233
4481,14226,6664,7562,2012,15234
4482,34208,16018,18190,2012,15235
4483,30324,14540,15784,2012,15236
4484,41101,19303,21798,2012,15237
4485,12821,6151,6670,2012,15238
4486,21179,10180,10999,2012,15239
4487,20075,9826,10249,2012,15241
4488,13468,6264,7204,2012,15243
4489,0,0,0,2012,15260
4490,0,0,0,2012,15290
4491,49279,23995,25284,2012,15301
4492,291,137,154,2012,15310
4493,1396,663,733,2012,15311
4494,3609,1922,1687,2012,15312
4495,317,173,144,2012,15313
4496,3799,1739,2060,2012,15314
4497,850,401,449,2012,15315
4498,100,40,60,2012,15316
4499,36133,17485,18648,2012,15317
4500,5326,2405,2921,2012,15320
4501,1480,601,879,2012,15321
4502,2224,1027,1197,2012,15322
4503,4351,2106,2245,2012,15323
4504,661,310,351,2012,15324
4505,480,244,236,2012,15325
4506,1257,623,634,2012,15327
4507,1733,868,865,2012,15329
4508,5271,2781,2490,2012,15330
4509,1016,490,526,2012,15331
4510,8249,4033,4216,2012,15332
4511,2262,1101,1161,2012,15333
4512,113,44,69,2012,15334
4513,712,364,348,2012,15337
4514,1654,829,825,2012,15338
4515,1701,897,804,2012,15340
4516,898,434,464,2012,15341
4517,4995,2326,2669,2012,15342
4518,1623,718,905,2012,15344
4519,1681,844,837,2012,15345
4520,592,323,269,2012,15346
4521,230,116,114,2012,15347
4522,192,109,83,2012,15348
4523,1849,879,970,2012,15349
4524,494,260,234,2012,15350
4525,900,441,459,2012,15351
4526,917,421,496,2012,15352
4527,46,25,21,2012,15353
4528,1427,688,739,2012,15357
4529,1230,618,612,2012,15358
4530,138,75,63,2012,15359
4531,1731,879,852,2012,15360
4532,41,20,21,2012,15361
4533,786,425,361,2012,15362
4534,984,486,498,2012,15363
4535,835,411,424,2012,15364
4536,322,169,153,2012,15366
4537,8839,4308,4531,2012,15367
4538,278,146,132,2012,15368
4539,15118,8680,6438,2012,15370
4540,1919,1011,908,2012,15376
4541,669,356,313,2012,15377
4542,0,0,0,2012,15378
4543,129,61,68,2012,15379
4544,816,387,429,2012,15380
4545,31878,15470,16408,2012,15401
4546,659,246,413,2012,15410
4547,640,335,305,2012,15411
4548,291,127,164,2012,15412
4549,654,348,306,2012,15413
4550,8175,3893,4282,2012,15417
4551,4706,2243,2463,2012,15419
4552,457,219,238,2012,15420
4553,132,53,79,2012,15421
4554,299,158,141,2012,15422
4555,2601,1322,1279,2012,15423
4556,2745,1297,1448,2012,15424
4557,19374,9247,10127,2012,15425
4558,1233,681,552,2012,15427
4559,1835,909,926,2012,15428
4560,148,74,74,2012,15429
4561,147,91,56,2012,15430
4562,4407,2235,2172,2012,15431
4563,380,189,191,2012,15432
4564,841,513,328,2012,15433
4565,295,118,177,2012,15434
4566,429,206,223,2012,15435
4567,2642,1154,1488,2012,15436
4568,2470,1348,1122,2012,15437
4569,2115,1070,1045,2012,15438
4570,297,137,160,2012,15440
4571,2331,1019,1312,2012,15442
4572,237,111,126,2012,15443
4573,525,265,260,2012,15444
4574,2565,1266,1299,2012,15445
4575,169,98,71,2012,15446
4576,293,211,82,2012,15447
4577,407,203,204,2012,15448
4578,180,77,103,2012,15449
4579,2117,1959,158,2012,15450
4580,1027,543,484,2012,15451
4581,384,219,165,2012,15454
4582,377,126,251,2012,15455
4583,3279,1596,1683,2012,15456
4584,2603,1233,1370,2012,15458
4585,1347,686,661,2012,15459
4586,140,73,67,2012,15460
4587,4104,2018,2086,2012,15461
4588,451,167,284,2012,15462
4589,0,0,0,2012,15463
4590,1613,769,844,2012,15464
4591,424,202,222,2012,15466
4592,89,52,37,2012,15467
4593,2096,894,1202,2012,15468
4594,2342,1296,1046,2012,15469
4595,1173,662,511,2012,15470
4596,367,208,159,2012,15472
4597,3956,2003,1953,2012,15473
4598,2099,1083,1016,2012,15474
4599,1388,607,781,2012,15475
4600,166,88,78,2012,15476
4601,708,339,369,2012,15477
4602,6636,3206,3430,2012,15478
4603,2179,1079,1100,2012,15479
4604,2415,1095,1320,2012,15480
4605,672,353,319,2012,15482
4606,512,265,247,2012,15483
4607,632,329,303,2012,15484
4608,1891,872,1019,2012,15486
4609,373,155,218,2012,15489
4610,1108,606,502,2012,15490
4611,83,38,45,2012,15492
4612,16528,8127,8401,2012,15501
4613,128,64,64,2012,15502
4614,2223,2223,0,2012,15510
4615,452,174,278,2012,15520
4616,2070,1143,927,2012,15521
4617,11641,5855,5786,2012,15522
4618,5187,2605,2582,2012,15530
4619,3992,1930,2062,2012,15531
4620,279,143,136,2012,15532
4621,1477,686,791,2012,15533
4622,865,463,402,2012,15534
4623,2085,1156,929,2012,15535
4624,440,224,216,2012,15536
4625,8004,3737,4267,2012,15537
4626,802,423,379,2012,15538
4627,625,281,344,2012,15539
4628,278,127,151,2012,15540
4629,4085,2055,2030,2012,15541
4630,956,476,480,2012,15542
4631,134,70,64,2012,15544
4632,3021,1499,1522,2012,15545
4633,455,312,143,2012,15546
4634,439,244,195,2012,15547
4635,1627,819,808,2012,15550
4636,927,497,430,2012,15551
4637,6401,3161,3240,2012,15552
4638,2409,1281,1128,2012,15554
4639,46,27,19,2012,15555
4640,3651,1848,1803,2012,15557
4641,2206,1105,1101,2012,15558
4642,1960,940,1020,2012,15559
4643,203,107,96,2012,15560
4644,132,59,73,2012,15561
4645,168,86,82,2012,15562
4646,3093,1478,1615,2012,15563
4647,89,44,45,2012,15564
4648,59819,28982,30837,2012,15601
4649,3524,1686,1838,2012,15610
4650,522,336,186,2012,15611
4651,165,98,67,2012,15612
4652,14446,7290,7156,2012,15613
4653,457,228,229,2012,15615
4654,273,144,129,2012,15616
4655,513,247,266,2012,15617
4656,2558,1240,1318,2012,15618
4657,932,491,441,2012,15620
4658,44,35,9,2012,15621
4659,1380,622,758,2012,15622
4660,781,290,491,2012,15623
4661,346,150,196,2012,15624
4662,24,0,24,2012,15625
4663,4854,2435,2419,2012,15626
4664,6361,3055,3306,2012,15627
4665,786,394,392,2012,15628
4666,592,279,313,2012,15629
4667,1230,609,621,2012,15631
4668,9454,4759,4695,2012,15632
4669,266,127,139,2012,15633
4670,639,263,376,2012,15634
4671,98,36,62,2012,15635
4672,4189,2142,2047,2012,15636
4673,1877,984,893,2012,15637
4674,295,108,187,2012,15638
4675,2412,1208,1204,2012,15639
4676,788,394,394,2012,15640
4677,469,251,218,2012,15641
4678,45361,21902,23459,2012,15642
4679,19309,9589,9720,2012,15644
4680,194,78,116,2012,15646
4681,190,106,84,2012,15647
4682,28805,14111,14694,2012,15650
4683,545,320,225,2012,15655
4684,10108,5006,5102,2012,15656
4685,8419,4189,4230,2012,15658
4686,357,177,180,2012,15660
4687,477,207,270,2012,15661
4688,206,130,76,2012,15662
4689,496,270,226,2012,15663
4690,1625,881,744,2012,15665
4691,16497,7767,8730,2012,15666
4692,13508,6652,6856,2012,15668
4693,3170,1543,1627,2012,15670
4694,964,533,431,2012,15671
4695,3578,1593,1985,2012,15672
4696,1374,660,714,2012,15673
4697,977,470,507,2012,15675
4698,151,38,113,2012,15676
4699,360,175,185,2012,15677
4700,324,118,206,2012,15678
4701,3610,1883,1727,2012,15679
4702,114,66,48,2012,15680
4703,4938,2457,2481,2012,15681
4704,8302,3671,4631,2012,15683
4705,810,420,390,2012,15684
4706,970,492,478,2012,15686
4707,1071,479,592,2012,15687
4708,569,261,308,2012,15688
4709,195,82,113,2012,15689
4710,9037,4352,4685,2012,15690
4711,33,0,33,2012,15691
4712,743,365,378,2012,15692
4713,153,95,58,2012,15693
4714,193,66,127,2012,15695
4715,293,165,128,2012,15696
4716,3056,1541,1515,2012,15697
4717,666,336,330,2012,15698
4718,34692,16760,17932,2012,15701
4719,342,189,153,2012,15710
4720,498,250,248,2012,15711
4721,192,102,90,2012,15712
4722,181,132,49,2012,15713
4723,4990,2389,2601,2012,15714
4724,649,283,366,2012,15715
4725,654,313,341,2012,15716
4726,11148,5921,5227,2012,15717
4727,243,120,123,2012,15721
4728,2203,1201,1002,2012,15722
4729,38,14,24,2012,15723
4730,2273,1094,1179,2012,15724
4731,1328,662,666,2012,15725
4732,144,73,71,2012,15727
4733,3167,1572,1595,2012,15728
4734,1614,773,841,2012,15729
4735,46,26,20,2012,15730
4736,315,225,90,2012,15731
4737,1691,833,858,2012,15732
4738,115,51,64,2012,15733
4739,343,175,168,2012,15734
4740,604,273,331,2012,15736
4741,119,53,66,2012,15737
4742,185,92,93,2012,15738
4743,340,147,193,2012,15739
4744,69,35,34,2012,15741
4745,901,472,429,2012,15742
4746,147,60,87,2012,15744
4747,472,246,226,2012,15745
4748,158,64,94,2012,15746
4749,2093,985,1108,2012,15747
4750,7187,3400,3787,2012,15748
4751,129,57,72,2012,15750
4752,87,43,44,2012,15752
4753,576,269,307,2012,15753
4754,512,214,298,2012,15754
4755,209,140,69,2012,15756
4756,1505,738,767,2012,15757
4757,2975,1487,1488,2012,15759
4758,141,72,69,2012,15760
4759,44,15,29,2012,15761
4760,771,377,394,2012,15762
4761,90,51,39,2012,15764
4762,1808,923,885,2012,15765
4763,14465,6875,7590,2012,15767
4764,314,190,124,2012,15770
4765,1050,507,543,2012,15771
4766,1731,981,750,2012,15772
4767,462,214,248,2012,15773
4768,3297,1561,1736,2012,15774
4769,889,331,558,2012,15775
4770,58,38,20,2012,15776
4771,95,41,54,2012,15777
4772,128,78,50,2012,15778
4773,251,147,104,2012,15779
4774,127,65,62,2012,15780
4775,73,29,44,2012,15781
4776,78,49,29,2012,15783
4777,69,35,34,2012,15784
4778,19391,9362,10029,2012,15801
4779,157,71,86,2012,15821
4780,1611,864,747,2012,15823
4781,5284,2586,2698,2012,15824
4782,9800,4762,5038,2012,15825
4783,344,189,155,2012,15827
4784,368,191,177,2012,15828
4785,1158,593,565,2012,15829
4786,281,146,135,2012,15832
4787,4567,2261,2306,2012,15834
4788,1882,967,915,2012,15840
4789,440,195,245,2012,15841
4790,3529,1666,1863,2012,15845
4791,3681,1902,1779,2012,15846
4792,221,118,103,2012,15847
4793,1096,559,537,2012,15848
4794,1225,662,563,2012,15849
4795,6742,3507,3235,2012,15851
4796,6190,3101,3089,2012,15853
4797,908,458,450,2012,15856
4798,13232,6430,6802,2012,15857
4799,931,485,446,2012,15860
4800,155,69,86,2012,15861
4801,145,76,69,2012,15863
4802,1833,910,923,2012,15864
4803,1378,729,649,2012,15865
4804,241,124,117,2012,15866
4805,1256,633,623,2012,15868
4806,1290,703,587,2012,15870
4807,4077,1983,2094,2012,15901
4808,13035,6191,6844,2012,15902
4809,16475,7510,8965,2012,15904
4810,20971,10083,10888,2012,15905
4811,11156,5724,5432,2012,15906
4812,5397,2619,2778,2012,15909
4813,933,472,461,2012,15920
4814,235,126,109,2012,15921
4815,162,98,64,2012,15922
4816,1769,877,892,2012,15923
4817,965,502,463,2012,15924
4818,154,76,78,2012,15925
4819,2688,1396,1292,2012,15926
4820,819,415,404,2012,15927
4821,2236,1159,1077,2012,15928
4822,73,21,52,2012,15929
4823,163,71,92,2012,15930
4824,9483,4866,4617,2012,15931
4825,148,47,101,2012,15934
4826,2524,1328,1196,2012,15935
4827,1678,910,768,2012,15936
4828,756,444,312,2012,15937
4829,2496,1208,1288,2012,15938
4830,4027,2318,1709,2012,15940
4831,2091,1084,1007,2012,15942
4832,4103,2055,2048,2012,15943
4833,3939,2015,1924,2012,15944
4834,222,107,115,2012,15945
4835,6997,3380,3617,2012,15946
4836,637,299,338,2012,15948
4837,516,261,255,2012,15949
4838,173,96,77,2012,15951
4839,1431,704,727,2012,15952
4840,158,110,48,2012,15953
4841,2496,1253,1243,2012,15954
4842,3018,1445,1573,2012,15955
4843,2544,1358,1186,2012,15956
4844,635,309,326,2012,15957
4845,2144,1053,1091,2012,15958
4846,503,205,298,2012,15960
4847,757,402,355,2012,15961
4848,103,62,41,2012,15962
4849,10831,5268,5563,2012,15963
4850,40381,19853,20528,2012,16001
4851,15866,8504,7362,2012,16002
4852,1131,607,524,2012,16020
4853,480,250,230,2012,16022
4854,4252,2020,2232,2012,16023
4855,218,130,88,2012,16024
4856,5673,2770,2903,2012,16025
4857,269,151,118,2012,16027
4858,2100,1089,1011,2012,16028
4859,692,340,352,2012,16029
4860,305,158,147,2012,16030
4861,5885,2998,2887,2012,16033
4862,2045,1008,1037,2012,16034
4863,88,43,45,2012,16035
4864,252,109,143,2012,16036
4865,4527,2382,2145,2012,16037
4866,3753,1818,1935,2012,16038
4867,1028,495,533,2012,16040
4868,2000,1020,980,2012,16041
4869,1511,637,874,2012,16045
4870,13694,6494,7200,2012,16046
4871,139,84,55,2012,16048
4872,3480,1788,1692,2012,16049
4873,1546,788,758,2012,16050
4874,3018,1438,1580,2012,16051
4875,2233,1148,1085,2012,16052
4876,4106,2022,2084,2012,16053
4877,365,191,174,2012,16054
4878,8412,4129,4283,2012,16055
4879,5015,2221,2794,2012,16056
4880,13635,6586,7049,2012,16057
4881,8118,3940,4178,2012,16059
4882,2718,1328,1390,2012,16061
4883,6686,2971,3715,2012,16063
4884,28130,13964,14166,2012,16066
4885,34664,16454,18210,2012,16101
4886,5589,2730,2859,2012,16102
4887,15040,7292,7748,2012,16105
4888,277,151,126,2012,16110
4889,1159,560,599,2012,16111
4890,1472,696,776,2012,16112
4891,348,154,194,2012,16113
4892,583,310,273,2012,16114
4893,3271,1668,1603,2012,16115
4894,2853,1359,1494,2012,16116
4895,17028,8240,8788,2012,16117
4896,2296,1183,1113,2012,16120
4897,5010,2236,2774,2012,16121
4898,2322,1272,1050,2012,16123
4899,1876,930,946,2012,16124
4900,18272,8784,9488,2012,16125
4901,15889,7843,8046,2012,16127
4902,1947,1003,944,2012,16130
4903,821,384,437,2012,16131
4904,364,234,130,2012,16132
4905,1557,821,736,2012,16133
4906,4040,2099,1941,2012,16134
4907,783,357,426,2012,16136
4908,13049,7314,5735,2012,16137
4909,215,81,134,2012,16140
4910,1908,1009,899,2012,16141
4911,7128,3308,3820,2012,16142
4912,2969,1590,1379,2012,16143
4913,2682,1240,1442,2012,16145
4914,14080,6448,7632,2012,16146
4915,16857,7818,9039,2012,16148
4916,7378,3546,3832,2012,16150
4917,100,58,42,2012,16151
4918,2595,1330,1265,2012,16153
4919,2722,1526,1196,2012,16154
4920,75,21,54,2012,16155
4921,3305,1709,1596,2012,16156
4922,3618,1670,1948,2012,16157
4923,4770,2281,2489,2012,16159
4924,851,447,404,2012,16160
4925,706,315,391,2012,16161
4926,18426,9149,9277,2012,16201
4927,1175,613,562,2012,16210
4928,99,54,45,2012,16211
4929,362,201,161,2012,16212
4930,137,49,88,2012,16213
4931,9863,4229,5634,2012,16214
4932,158,73,85,2012,16217
4933,1291,639,652,2012,16218
4934,2456,1265,1191,2012,16222
4935,112,56,56,2012,16223
4936,1340,630,710,2012,16224
4937,8043,3947,4096,2012,16226
4938,376,167,209,2012,16228
4939,5010,2550,2460,2012,16229
4940,607,260,347,2012,16230
4941,4370,2195,2175,2012,16232
4942,919,449,470,2012,16233
4943,1192,593,599,2012,16235
4944,404,219,185,2012,16236
4945,401,186,215,2012,16238
4946,4091,3227,864,2012,16239
4947,1201,634,567,2012,16240
4948,4576,2210,2366,2012,16242
4949,195,97,98,2012,16244
4950,184,94,90,2012,16245
4951,283,147,136,2012,16246
4952,3247,1636,1611,2012,16248
4953,2035,1031,1004,2012,16249
4954,295,138,157,2012,16250
4955,122,68,54,2012,16253
4956,3575,1839,1736,2012,16254
4957,1785,915,870,2012,16255
4958,1873,955,918,2012,16256
4959,1926,940,986,2012,16258
4960,1881,974,907,2012,16259
4961,380,207,173,2012,16260
4962,3084,1483,1601,2012,16262
4963,467,237,230,2012,16263
4964,15984,7786,8198,2012,16301
4965,515,275,240,2012,16311
4966,17,7,10,2012,16312
4967,2205,1141,1064,2012,16313
4968,5513,2795,2718,2012,16314
4969,5435,2879,2556,2012,16316
4970,1727,880,847,2012,16317
4971,1247,562,685,2012,16319
4972,166,94,72,2012,16321
4973,116,42,74,2012,16322
4974,16426,8058,8368,2012,16323
4975,511,253,258,2012,16326
4976,3176,1664,1512,2012,16327
4977,97,32,65,2012,16328
4978,548,278,270,2012,16329
4979,83,32,51,2012,16331
4980,59,20,39,2012,16332
4981,206,112,94,2012,16333
4982,391,204,187,2012,16334
4983,28259,13407,14852,2012,16335
4984,1811,957,854,2012,16340
4985,2046,975,1071,2012,16341
4986,2569,1345,1224,2012,16342
4987,404,205,199,2012,16343
4988,657,312,345,2012,16344
4989,3310,1664,1646,2012,16345
4990,3316,1554,1762,2012,16346
4991,2518,1343,1175,2012,16347
4992,2637,1316,1321,2012,16350
4993,1503,780,723,2012,16351
4994,245,120,125,2012,16352
4995,3201,1678,1523,2012,16353
4996,11246,5442,5804,2012,16354
4997,1469,782,687,2012,16360
4998,77,53,24,2012,16361
4999,1227,607,620,2012,16362
5000,1118,625,493,2012,16364
5001,18834,9236,9598,2012,16365
5002,393,189,204,2012,16370
5003,3315,1557,1758,2012,16371
5004,389,197,192,2012,16372
5005,3286,1660,1626,2012,16373
5006,1940,984,956,2012,16374
5007,6558,4296,2262,2012,16401
5008,819,418,401,2012,16402
5009,7107,3130,3977,2012,16403
5010,3270,1666,1604,2012,16404
5011,868,452,416,2012,16405
5012,3562,1594,1968,2012,16406
5013,11151,5435,5716,2012,16407
5014,1832,891,941,2012,16410
5015,1433,751,682,2012,16411
5016,10984,4958,6026,2012,16412
5017,8701,4164,4537,2012,16415
5018,282,139,143,2012,16416
5019,8378,4126,4252,2012,16417
5020,557,264,293,2012,16420
5021,2532,1339,1193,2012,16421
5022,159,78,81,2012,16422
5023,4532,2016,2516,2012,16423
5024,4644,2296,2348,2012,16424
5025,3822,1922,1900,2012,16426
5026,304,159,145,2012,16427
5027,12591,6321,6270,2012,16428
5028,5232,2672,2560,2012,16433
5029,3494,1729,1765,2012,16434
5030,2087,1063,1024,2012,16435
5031,708,346,362,2012,16436
5032,7879,3898,3981,2012,16438
5033,948,514,434,2012,16440
5034,10017,5014,5003,2012,16441
5035,3027,1624,1403,2012,16442
5036,1349,793,556,2012,16443
5037,1013,498,515,2012,16444
5038,2388,1043,1345,2012,16501
5039,17560,8833,8727,2012,16502
5040,15309,7410,7899,2012,16503
5041,17461,8279,9182,2012,16504
5042,16913,8065,8848,2012,16505
5043,23576,11661,11915,2012,16506
5044,10824,5364,5460,2012,16507
5045,16474,8056,8418,2012,16508
5046,27165,12990,14175,2012,16509
5047,25479,12835,12644,2012,16510
5048,11381,5203,6178,2012,16511
5049,1092,440,652,2012,16546
5050,1502,807,695,2012,16563
5051,33538,16260,17278,2012,16601
5052,29941,14213,15728,2012,16602
5053,2406,1140,1266,2012,16611
5054,1576,769,807,2012,16613
5055,87,37,50,2012,16616
5056,2917,1560,1357,2012,16617
5057,231,129,102,2012,16619
5058,418,224,194,2012,16620
5059,598,290,308,2012,16621
5060,205,95,110,2012,16622
5061,516,247,269,2012,16623
5062,195,89,106,2012,16624
5063,4021,2065,1956,2012,16625
5064,2183,1133,1050,2012,16627
5065,5872,3114,2758,2012,16630
5066,28,12,16,2012,16631
5067,167,61,106,2012,16633
5068,227,114,113,2012,16634
5069,12725,6223,6502,2012,16635
5070,814,413,401,2012,16636
5071,2388,1040,1348,2012,16637
5072,75,41,34,2012,16638
5073,1583,789,794,2012,16639
5074,859,475,384,2012,16640
5075,2613,1326,1287,2012,16641
5076,133,61,72,2012,16645
5077,2437,1206,1231,2012,16646
5078,593,285,308,2012,16647
5079,14826,7205,7621,2012,16648
5080,1990,1065,925,2012,16650
5081,5862,4144,1718,2012,16651
5082,18025,10588,7437,2012,16652
5083,1442,692,750,2012,16655
5084,1495,763,732,2012,16656
5085,1187,653,534,2012,16657
5086,314,160,154,2012,16659
5087,1011,534,477,2012,16661
5088,5600,2658,2942,2012,16662
5089,2053,958,1095,2012,16664
5090,285,147,138,2012,16665
5091,3558,1864,1694,2012,16666
5092,1709,837,872,2012,16667
5093,3616,1800,1816,2012,16668
5094,2353,1136,1217,2012,16669
5095,18,6,12,2012,16670
5096,547,277,270,2012,16671
5097,180,81,99,2012,16672
5098,5436,2718,2718,2012,16673
5099,539,262,277,2012,16674
5100,110,92,18,2012,16677
5101,2833,1353,1480,2012,16678
5102,845,418,427,2012,16679
5103,396,226,170,2012,16680
5104,176,103,73,2012,16682
5105,418,237,181,2012,16683
5106,412,247,165,2012,16685
5107,13373,6544,6829,2012,16686
5108,595,253,342,2012,16689
5109,329,179,150,2012,16691
5110,758,417,341,2012,16692
5111,4505,2335,2170,2012,16693
5112,205,101,104,2012,16694
5113,1222,630,592,2012,16695
5114,822,812,10,2012,16699
5115,17979,8743,9236,2012,16701
5116,1268,665,603,2012,16720
5117,77,42,35,2012,16724
5118,114,70,44,2012,16725
5119,538,290,248,2012,16726
5120,190,98,92,2012,16727
5121,32,16,16,2012,16728
5122,676,340,336,2012,16729
5123,105,44,61,2012,16730
5124,2995,1573,1422,2012,16731
5125,260,126,134,2012,16732
5126,169,88,81,2012,16733
5127,286,159,127,2012,16734
5128,6090,2988,3102,2012,16735
5129,2685,2061,624,2012,16738
5130,1053,555,498,2012,16740
5131,3856,1796,2060,2012,16743
5132,459,186,273,2012,16744
5133,590,305,285,2012,16745
5134,1484,758,726,2012,16746
5135,2818,1364,1454,2012,16748
5136,4504,2292,2212,2012,16749
5137,408,210,198,2012,16750
5138,41731,22420,19311,2012,16801
5139,13495,6511,6984,2012,16802
5140,24057,12553,11504,2012,16803
5141,1192,633,559,2012,16820
5142,280,132,148,2012,16821
5143,1931,965,966,2012,16822
5144,26859,14176,12683,2012,16823
5145,132,61,71,2012,16825
5146,583,245,338,2012,16826
5147,4069,2115,1954,2012,16827
5148,4652,2308,2344,2012,16828
5149,701,358,343,2012,16829
5150,13988,6922,7066,2012,16830
5151,343,162,181,2012,16832
5152,5448,2575,2873,2012,16833
5153,156,87,69,2012,16834
5154,274,128,146,2012,16835
5155,1160,590,570,2012,16836
5156,93,42,51,2012,16837
5157,1637,803,834,2012,16838
5158,473,217,256,2012,16839
5159,550,251,299,2012,16840
5160,6038,3083,2955,2012,16841
5161,408,247,161,2012,16843
5162,3041,1527,1514,2012,16844
5163,1287,859,428,2012,16845
5164,409,194,215,2012,16847
5165,471,281,190,2012,16848
5166,282,130,152,2012,16849
5167,976,556,420,2012,16851
5168,459,288,171,2012,16852
5169,154,65,89,2012,16853
5170,979,483,496,2012,16854
5171,331,143,188,2012,16855
5172,4044,1939,2105,2012,16858
5173,616,311,305,2012,16859
5174,374,199,175,2012,16860
5175,236,130,106,2012,16861
5176,778,309,469,2012,16863
5177,2005,950,1055,2012,16865
5178,9904,4925,4979,2012,16866
5179,424,183,241,2012,16868
5180,6534,3358,3176,2012,16870
5181,27,15,12,2012,16871
5182,1430,689,741,2012,16872
5183,1361,718,643,2012,16874
5184,3535,1786,1749,2012,16875
5185,351,152,199,2012,16876
5186,1651,893,758,2012,16877
5187,1541,752,789,2012,16878
5188,545,261,284,2012,16879
5189,2066,1047,1019,2012,16881
5190,329,153,176,2012,16882
5191,10335,4914,5421,2012,16901
5192,426,242,184,2012,16911
5193,1841,961,880,2012,16912
5194,2368,1106,1262,2012,16914
5195,5809,2771,3038,2012,16915
5196,1453,726,727,2012,16917
5197,2259,1154,1105,2012,16920
5198,579,257,322,2012,16921
5199,2070,1034,1036,2012,16922
5200,1588,840,748,2012,16923
5201,3088,1619,1469,2012,16925
5202,830,395,435,2012,16926
5203,712,363,349,2012,16927
5204,1579,835,744,2012,16928
5205,2274,1167,1107,2012,16929
5206,1353,685,668,2012,16930
5207,711,361,350,2012,16932
5208,7128,3388,3740,2012,16933
5209,1205,582,623,2012,16935
5210,2255,1111,1144,2012,16936
5211,245,142,103,2012,16937
5212,694,378,316,2012,16938
5213,434,207,227,2012,16939
5214,431,222,209,2012,16940
5215,110,55,55,2012,16941
5216,630,305,325,2012,16942
5217,440,254,186,2012,16943
5218,2239,1120,1119,2012,16946
5219,5182,2543,2639,2012,16947
5220,1547,793,754,2012,16948
5221,3456,1659,1797,2012,16950
5222,679,372,307,2012,17002
5223,11854,5653,6201,2012,17003
5224,5304,2608,2696,2012,17004
5225,346,170,176,2012,17005
5226,1169,589,580,2012,17006
5227,5522,2674,2848,2012,17007
5228,2185,1114,1071,2012,17009
5229,0,0,0,2012,17010
5230,34659,18108,16551,2012,17011
5231,34476,16249,18227,2012,17013
5232,20801,10274,10527,2012,17015
5233,603,239,364,2012,17016
5234,1837,867,970,2012,17017
5235,4455,2219,2236,2012,17018
5236,17940,8677,9263,2012,17019
5237,9041,4626,4415,2012,17020
5238,833,431,402,2012,17021
5239,29139,13751,15388,2012,17022
5240,3458,1716,1742,2012,17023
5241,2141,1079,1062,2012,17024
5242,16642,8342,8300,2012,17025
5243,3550,1929,1621,2012,17026
5244,2164,900,1264,2012,17027
5245,3650,2022,1628,2012,17028
5246,626,327,299,2012,17029
5247,820,430,390,2012,17030
5248,8216,4107,4109,2012,17032
5249,17023,8164,8859,2012,17033
5250,2605,1258,1347,2012,17034
5251,754,372,382,2012,17035
5252,22528,11069,11459,2012,17036
5253,958,537,421,2012,17037
5254,8150,4143,4007,2012,17038
5255,34,9,25,2012,17039
5256,2223,1128,1095,2012,17040
5257,288,115,173,2012,17041
5258,37257,18205,19052,2012,17042
5259,5853,2953,2900,2012,17043
5260,21001,10082,10919,2012,17044
5261,3160,1563,1597,2012,17045
5262,30057,14447,15610,2012,17046
5263,2600,1252,1348,2012,17047
5264,3867,1931,1936,2012,17048
5265,3204,1685,1519,2012,17049
5266,33277,16232,17045,2012,17050
5267,4366,2188,2178,2012,17051
5268,1812,905,907,2012,17052
5269,4890,2311,2579,2012,17053
5270,34210,16357,17853,2012,17055
5271,40,5,35,2012,17056
5272,22116,10695,11421,2012,17057
5273,1868,947,921,2012,17058
5274,7971,3889,4082,2012,17059
5275,1441,748,693,2012,17060
5276,7058,3459,3599,2012,17061
5277,4145,2017,2128,2012,17062
5278,3326,1657,1669,2012,17063
5279,349,156,193,2012,17064
5280,3886,1950,1936,2012,17065
5281,5664,2673,2991,2012,17066
5282,14630,7187,7443,2012,17067
5283,4723,2499,2224,2012,17068
5284,131,74,57,2012,17069
5285,15058,7333,7725,2012,17070
5286,77,55,22,2012,17071
5287,376,167,209,2012,17072
5288,5186,2573,2613,2012,17073
5289,7427,3571,3856,2012,17074
5290,101,53,48,2012,17075
5291,41,29,12,2012,17076
5292,21,11,10,2012,17077
5293,19796,9495,10301,2012,17078
5294,252,125,127,2012,17080
5295,76,41,35,2012,17081
5296,3367,1688,1679,2012,17082
5297,73,47,26,2012,17083
5298,4291,2045,2246,2012,17084
5299,2385,1148,1237,2012,17086
5300,3131,1648,1483,2012,17087
5301,505,289,216,2012,17088
5302,5140,2600,2540,2012,17090
5303,702,341,361,2012,17093
5304,2751,1381,1370,2012,17094
5305,906,428,478,2012,17097
5306,2382,1115,1267,2012,17098
5307,1044,578,466,2012,17099
5308,2099,1186,913,2012,17101
5309,7852,4135,3717,2012,17102
5310,11391,5481,5910,2012,17103
5311,21179,9328,11851,2012,17104
5312,23077,10659,12418,2012,17109
5313,24153,11268,12885,2012,17110
5314,30464,15027,15437,2012,17111
5315,33427,16781,16646,2012,17112
5316,11096,5095,6001,2012,17113
5317,0,0,0,2012,17120
5318,25417,12065,13352,2012,17201
5319,30037,14771,15266,2012,17202
5320,206,81,125,2012,17210
5321,336,181,155,2012,17211
5322,937,528,409,2012,17212
5323,621,308,313,2012,17213
5324,1112,577,535,2012,17214
5325,205,104,101,2012,17215
5326,77,34,43,2012,17217
5327,357,142,215,2012,17219
5328,597,299,298,2012,17220
5329,536,253,283,2012,17221
5330,10260,4805,5455,2012,17222
5331,287,119,168,2012,17223
5332,2149,1151,998,2012,17224
5333,19662,9618,10044,2012,17225
5334,1141,583,558,2012,17228
5335,1323,673,650,2012,17229
5336,4909,2423,2486,2012,17233
5337,821,502,319,2012,17235
5338,8271,4193,4078,2012,17236
5339,2100,1020,1080,2012,17237
5340,1653,844,809,2012,17238
5341,162,79,83,2012,17239
5342,3314,1667,1647,2012,17240
5343,12026,6082,5944,2012,17241
5344,1548,774,774,2012,17243
5345,2374,1174,1200,2012,17244
5346,91,60,31,2012,17246
5347,308,101,207,2012,17247
5348,297,124,173,2012,17249
5349,214,103,111,2012,17250
5350,111,60,51,2012,17251
5351,3707,2078,1629,2012,17252
5352,298,173,125,2012,17253
5353,2,2,0,2012,17254
5354,1104,527,577,2012,17255
5355,49,11,38,2012,17256
5356,28304,13918,14386,2012,17257
5357,1105,545,560,2012,17260
5358,227,173,54,2012,17261
5359,1530,748,782,2012,17262
5360,698,472,226,2012,17263
5361,2369,1201,1168,2012,17264
5362,661,360,301,2012,17265
5363,616,294,322,2012,17266
5364,2692,1364,1328,2012,17267
5365,27389,13018,14371,2012,17268
5366,221,90,131,2012,17270
5367,319,153,166,2012,17271
5368,252,156,96,2012,17272
5369,3654,1748,1906,2012,17301
5370,2894,1564,1330,2012,17302
5371,3190,1643,1547,2012,17304
5372,277,123,154,2012,17306
5373,6021,2983,3038,2012,17307
5374,1682,901,781,2012,17309
5375,286,138,148,2012,17311
5376,10600,4988,5612,2012,17313
5377,5870,3036,2834,2012,17314
5378,26570,12478,14092,2012,17315
5379,8427,4286,4141,2012,17316
5380,748,314,434,2012,17317
5381,334,160,174,2012,17318
5382,10440,5116,5324,2012,17319
5383,7895,3674,4221,2012,17320
5384,2401,1230,1171,2012,17321
5385,6692,3410,3282,2012,17322
5386,4161,2027,2134,2012,17324
5387,28710,13912,14798,2012,17325
5388,8082,3979,4103,2012,17327
5389,2387,1262,1125,2012,17329
5390,49876,24378,25498,2012,17331
5391,6981,3636,3345,2012,17339
5392,10958,5653,5305,2012,17340
5393,122,49,73,2012,17343
5394,3512,1655,1857,2012,17344
5395,7606,3822,3784,2012,17345
5396,6241,3243,2998,2012,17347
5397,7452,3664,3788,2012,17349
5398,12907,6516,6391,2012,17350
5399,1272,556,716,2012,17352
5400,2805,1409,1396,2012,17353
5401,249,139,110,2012,17355
5402,21800,10570,11230,2012,17356
5403,5942,2968,2974,2012,17360
5404,5380,2628,2752,2012,17361
5405,13701,6996,6705,2012,17362
5406,9762,4759,5003,2012,17363
5407,3694,1929,1765,2012,17364
5408,2158,1078,1080,2012,17365
5409,5556,2834,2722,2012,17366
5410,7425,3595,3830,2012,17368
5411,5330,2919,2411,2012,17370
5412,241,142,99,2012,17371
5413,4229,2051,2178,2012,17372
5414,17100,8445,8655,2012,17401
5415,35767,18470,17297,2012,17402
5416,39648,18932,20716,2012,17403
5417,35861,17246,18615,2012,17404
5418,21738,11079,10659,2012,17406
5419,2124,1100,1024,2012,17407
5420,22534,10895,11639,2012,17408
5421,4491,2084,2407,2012,17501
5422,2618,1251,1367,2012,17502
5423,1669,814,855,2012,17505
5424,24,12,12,2012,17507
5425,127,63,64,2012,17508
5426,4424,2297,2127,2012,17509
5427,17534,8239,9295,2012,17512
5428,4596,2387,2209,2012,17516
5429,15501,7917,7584,2012,17517
5430,1477,738,739,2012,17518
5431,6841,3446,3395,2012,17519
5432,4670,2318,2352,2012,17520
5433,31940,15538,16402,2012,17522
5434,6310,3190,3120,2012,17527
5435,4206,2177,2029,2012,17529
5436,3414,1696,1718,2012,17532
5437,2009,979,1030,2012,17535
5438,2799,1456,1343,2012,17536
5439,6936,3523,3413,2012,17538
5440,9658,4747,4911,2012,17540
5441,41887,20143,21744,2012,17543
5442,21582,10722,10860,2012,17545
5443,7016,3494,3522,2012,17547
5444,780,381,399,2012,17550
5445,10764,5199,5565,2012,17551
5446,18710,9142,9568,2012,17552
5447,7133,3496,3637,2012,17554
5448,7659,4017,3642,2012,17555
5449,14022,6977,7045,2012,17557
5450,4869,2283,2586,2012,17560
5451,4721,2432,2289,2012,17562
5452,3869,1907,1962,2012,17563
5453,2248,1132,1116,2012,17565
5454,12305,6009,6296,2012,17566
5455,5513,2749,2764,2012,17569
5456,231,76,155,2012,17570
5457,3424,1575,1849,2012,17572
5458,173,111,62,2012,17576
5459,7754,3806,3948,2012,17578
5460,5886,2933,2953,2012,17579
5461,916,481,435,2012,17581
5462,2127,1036,1091,2012,17582
5463,8972,4380,4592,2012,17584
5464,48895,23371,25524,2012,17601
5465,53388,26264,27124,2012,17602
5466,62628,30095,32533,2012,17603
5467,566,213,353,2012,17606
5468,44600,21578,23022,2012,17701
5469,10508,5169,5339,2012,17702
5470,1951,938,1013,2012,17721
5471,46,23,23,2012,17723
5472,5445,2679,2766,2012,17724
5473,52,27,25,2012,17727
5474,5283,2728,2555,2012,17728
5475,91,47,44,2012,17729
5476,306,197,109,2012,17730
5477,116,52,64,2012,17731
5478,6160,2940,3220,2012,17737
5479,44,20,24,2012,17739
5480,12952,6730,6222,2012,17740
5481,59,21,38,2012,17742
5482,3234,1686,1548,2012,17744
5483,18768,8790,9978,2012,17745
5484,3188,1573,1615,2012,17747
5485,254,112,142,2012,17748
5486,275,156,119,2012,17749
5487,117,61,56,2012,17750
5488,7479,3838,3641,2012,17751
5489,4942,2448,2494,2012,17752
5490,12059,5877,6182,2012,17754
5491,12000,5510,6490,2012,17756
5492,908,469,439,2012,17758
5493,529,271,258,2012,17760
5494,493,261,232,2012,17762
5495,370,199,171,2012,17763
5496,2210,1080,1130,2012,17764
5497,980,511,469,2012,17765
5498,71,47,24,2012,17767
5499,226,120,106,2012,17768
5500,3405,1719,1686,2012,17771
5501,2683,1391,1292,2012,17772
5502,1193,599,594,2012,17774
5503,237,117,120,2012,17776
5504,6927,3473,3454,2012,17777
5505,72,37,35,2012,17778
5506,204,106,98,2012,17779
5507,16532,8036,8496,2012,17801
5508,6031,4781,1250,2012,17810
5509,1456,731,725,2012,17812
5510,1961,969,992,2012,17813
5511,4425,2230,2195,2012,17814
5512,31122,14654,16468,2012,17815
5513,5638,2837,2801,2012,17820
5514,18501,8746,9755,2012,17821
5515,0,0,0,2012,17822
5516,1103,558,545,2012,17823
5517,4115,1946,2169,2012,17824
5518,598,320,278,2012,17827
5519,265,149,116,2012,17829
5520,1822,888,934,2012,17830
5521,684,347,337,2012,17832
5522,3516,1658,1858,2012,17834
5523,163,87,76,2012,17835
5524,159,68,91,2012,17836
5525,19819,10129,9690,2012,17837
5526,524,276,248,2012,17840
5527,4960,2483,2477,2012,17841
5528,8947,4511,4436,2012,17842
5529,9954,5075,4879,2012,17844
5530,2449,1274,1175,2012,17845
5531,3477,1677,1800,2012,17846
5532,12136,5834,6302,2012,17847
5533,639,285,354,2012,17850
5534,7833,3746,4087,2012,17851
5535,3377,1670,1707,2012,17853
5536,885,443,442,2012,17855
5537,3719,1910,1809,2012,17856
5538,7492,3629,3863,2012,17857
5539,3264,1559,1705,2012,17859
5540,2145,1092,1053,2012,17860
5541,95,49,46,2012,17861
5542,392,216,176,2012,17862
5543,2669,1424,1245,2012,17864
5544,150,77,73,2012,17865
5545,10372,6489,3883,2012,17866
5546,172,92,80,2012,17867
5547,1037,490,547,2012,17868
5548,14989,7192,7797,2012,17870
5549,9751,4876,4875,2012,17872
5550,1692,775,917,2012,17876
5551,1400,649,751,2012,17878
5552,64,30,34,2012,17880
5553,1672,802,870,2012,17881
5554,250,121,129,2012,17884
5555,214,114,100,2012,17885
5556,912,478,434,2012,17886
5557,142,70,72,2012,17887
5558,303,162,141,2012,17888
5559,2076,1055,1021,2012,17889
5560,24090,11528,12562,2012,17901
5561,315,164,151,2012,17920
5562,7377,4443,2934,2012,17921
5563,4610,2382,2228,2012,17922
5564,287,148,139,2012,17923
5565,401,198,203,2012,17925
5566,1829,926,903,2012,17929
5567,478,276,202,2012,17930
5568,8557,5808,2749,2012,17931
5569,68,34,34,2012,17933
5570,556,300,256,2012,17934
5571,1804,824,980,2012,17935
5572,840,425,415,2012,17936
5573,2492,1200,1292,2012,17938
5574,834,421,413,2012,17941
5575,497,266,231,2012,17943
5576,269,120,149,2012,17944
5577,111,40,71,2012,17945
5578,298,132,166,2012,17946
5579,4954,2427,2527,2012,17948
5580,282,163,119,2012,17949
5581,301,119,182,2012,17951
5582,227,78,149,2012,17952
5583,489,248,241,2012,17953
5584,4558,2092,2466,2012,17954
5585,296,139,157,2012,17957
5586,1371,661,710,2012,17959
5587,3658,1844,1814,2012,17960
5588,6962,3315,3647,2012,17961
5589,9287,4790,4497,2012,17963
5590,682,341,341,2012,17964
5591,2090,1044,1046,2012,17965
5592,2347,1162,1185,2012,17967
5593,330,144,186,2012,17968
5594,3402,1642,1760,2012,17970
5595,11249,5615,5634,2012,17972
5596,304,145,159,2012,17974
5597,6820,3512,3308,2012,17976
5598,177,87,90,2012,17978
5599,75,45,30,2012,17979
5600,3161,1546,1615,2012,17980
5601,2729,1318,1411,2012,17981
5602,395,205,190,2012,17982
5603,1479,701,778,2012,17983
5604,1075,542,533,2012,17985
5605,5553,2715,2838,2012,18011
5606,18258,8870,9388,2012,18013
5607,11377,5559,5818,2012,18014
5608,32466,16864,15602,2012,18015
5609,0,0,0,2012,18016
5610,37225,17594,19631,2012,18017
5611,32833,15242,17591,2012,18018
5612,20648,9929,10719,2012,18020
5613,752,413,339,2012,18030
5614,6888,3474,3414,2012,18031
5615,9314,4346,4968,2012,18032
5616,8486,4100,4386,2012,18034
5617,218,134,84,2012,18035
5618,12475,6321,6154,2012,18036
5619,7100,3590,3510,2012,18037
5620,3011,1432,1579,2012,18038
5621,15572,7503,8069,2012,18040
5622,5308,2575,2733,2012,18041
5623,41744,21046,20698,2012,18042
5624,25696,12630,13066,2012,18045
5625,0,0,0,2012,18046
5626,16998,8334,8664,2012,18049
5627,3965,2206,1759,2012,18051
5628,26876,12913,13963,2012,18052
5629,2560,1208,1352,2012,18053
5630,4508,2161,2347,2012,18054
5631,12294,6070,6224,2012,18055
5632,855,418,437,2012,18056
5633,9240,4446,4794,2012,18058
5634,1174,592,582,2012,18059
5635,24108,11891,12217,2012,18062
5636,584,329,255,2012,18063
5637,24305,11804,12501,2012,18064
5638,5712,2795,2917,2012,18066
5639,17774,8706,9068,2012,18067
5640,130,42,88,2012,18068
5641,8148,4140,4008,2012,18069
5642,920,427,493,2012,18070
5643,10741,5148,5593,2012,18071
5644,6308,3038,3270,2012,18072
5645,9136,4427,4709,2012,18073
5646,6108,3077,3031,2012,18074
5647,2786,1438,1348,2012,18076
5648,2375,1232,1143,2012,18077
5649,7280,3635,3645,2012,18078
5650,477,207,270,2012,18079
5651,11487,5932,5555,2012,18080
5652,274,103,171,2012,18081
5653,527,223,304,2012,18083
5654,1027,512,515,2012,18085
5655,584,292,292,2012,18086
5656,701,356,345,2012,18087
5657,8337,4076,4261,2012,18088
5658,6099,2692,3407,2012,18091
5659,3302,1648,1654,2012,18092
5660,3773,2009,1764,2012,18101
5661,48483,23430,25053,2012,18102
5662,48021,22898,25123,2012,18103
5663,43396,20352,23044,2012,18104
5664,61,26,35,2012,18105
5665,6829,3340,3489,2012,18106
5666,16274,7976,8298,2012,18109
5667,0,0,0,2012,18195
5668,27593,13688,13905,2012,18201
5669,11859,5481,6378,2012,18202
5670,7222,3386,3836,2012,18210
5671,1357,638,719,2012,18211
5672,100,48,52,2012,18212
5673,2324,1341,983,2012,18214
5674,1042,510,532,2012,18216
5675,2415,1250,1165,2012,18218
5676,1283,651,632,2012,18219
5677,381,204,177,2012,18220
5678,304,167,137,2012,18221
5679,9279,4695,4584,2012,18222
5680,142,78,64,2012,18223
5681,5500,2742,2758,2012,18224
5682,5,0,5,2012,18225
5683,9579,5003,4576,2012,18229
5684,85,50,35,2012,18230
5685,658,312,346,2012,18231
5686,3953,1918,2035,2012,18232
5687,391,127,264,2012,18234
5688,18894,9073,9821,2012,18235
5689,3515,1707,1808,2012,18237
5690,490,242,248,2012,18239
5691,3929,1993,1936,2012,18240
5692,945,441,504,2012,18241
5693,214,99,115,2012,18242
5694,440,248,192,2012,18244
5695,482,294,188,2012,18245
5696,178,72,106,2012,18246
5697,585,312,273,2012,18248
5698,3721,1929,1792,2012,18249
5699,3045,1696,1349,2012,18250
5700,107,66,41,2012,18251
5701,11205,5221,5984,2012,18252
5702,769,438,331,2012,18254
5703,4241,2078,2163,2012,18255
5704,532,246,286,2012,18256
5705,27877,13099,14778,2012,18301
5706,17289,8764,8525,2012,18302
5707,1794,916,878,2012,18321
5708,2711,1279,1432,2012,18322
5709,99,41,58,2012,18323
5710,10769,5150,5619,2012,18324
5711,2269,1154,1115,2012,18325
5712,4782,2294,2488,2012,18326
5713,614,314,300,2012,18327
5714,7477,3746,3731,2012,18328
5715,10112,5042,5070,2012,18330
5716,1191,663,528,2012,18331
5717,2515,1011,1504,2012,18332
5718,761,291,470,2012,18333
5719,4467,2198,2269,2012,18334
5720,297,203,94,2012,18335
5721,4102,1830,2272,2012,18336
5722,14610,7301,7309,2012,18337
5723,140,63,77,2012,18340
5724,424,200,224,2012,18342
5725,3771,1832,1939,2012,18343
5726,3479,1654,1825,2012,18344
5727,2679,1291,1388,2012,18346
5728,2413,1291,1122,2012,18347
5729,239,98,141,2012,18349
5730,2006,1184,822,2012,18350
5731,457,205,252,2012,18351
5732,1154,566,588,2012,18352
5733,12352,6333,6019,2012,18353
5734,445,194,251,2012,18354
5735,1417,589,828,2012,18355
5736,275,188,87,2012,18356
5737,129,46,83,2012,18357
5738,28578,14559,14019,2012,18360
5739,1396,718,678,2012,18370
5740,499,160,339,2012,18371
5741,3262,1846,1416,2012,18372
5742,6926,3396,3530,2012,18403
5743,2574,1388,1186,2012,18405
5744,13902,6905,6997,2012,18407
5745,22260,10661,11599,2012,18411
5746,162,96,66,2012,18413
5747,5638,2871,2767,2012,18414
5748,1046,529,517,2012,18415
5749,1168,586,582,2012,18417
5750,4411,2011,2400,2012,18419
5751,55,24,31,2012,18420
5752,4444,2151,2293,2012,18421
5753,4880,2542,2338,2012,18424
5754,1441,799,642,2012,18425
5755,5045,2736,2309,2012,18426
5756,290,116,174,2012,18427
5757,11526,6015,5511,2012,18428
5758,33,10,23,2012,18430
5759,13528,6607,6921,2012,18431
5760,7094,3273,3821,2012,18433
5761,4225,1954,2271,2012,18434
5762,656,305,351,2012,18435
5763,14446,7253,7193,2012,18436
5764,164,93,71,2012,18437
5765,1002,455,547,2012,18438
5766,492,261,231,2012,18439
5767,407,175,232,2012,18441
5768,241,142,99,2012,18443
5769,13539,6701,6838,2012,18444
5770,2020,1040,980,2012,18445
5771,3873,1898,1975,2012,18446
5772,9975,4649,5326,2012,18447
5773,392,184,208,2012,18451
5774,5079,2406,2673,2012,18452
5775,1084,531,553,2012,18453
5776,37,14,23,2012,18454
5777,102,55,47,2012,18455
5778,422,188,234,2012,18456
5779,124,83,41,2012,18457
5780,3131,1567,1564,2012,18458
5781,85,29,56,2012,18459
5782,196,99,97,2012,18460
5783,248,121,127,2012,18461
5784,451,216,235,2012,18462
5785,287,159,128,2012,18463
5786,921,420,501,2012,18464
5787,1575,766,809,2012,18465
5788,17306,8561,8745,2012,18466
5789,506,209,297,2012,18469
5790,2294,1141,1153,2012,18470
5791,525,263,262,2012,18471
5792,7437,5174,2263,2012,18472
5793,380,174,206,2012,18473
5794,1022,633,389,2012,18503
5795,20619,9420,11199,2012,18504
5796,20973,9814,11159,2012,18505
5797,4884,2315,2569,2012,18507
5798,11731,5569,6162,2012,18508
5799,14243,7073,7170,2012,18509
5800,14632,6974,7658,2012,18510
5801,11997,5574,6423,2012,18512
5802,4965,2355,2610,2012,18517
5803,8323,4224,4099,2012,18518
5804,4953,2418,2535,2012,18519
5805,238,130,108,2012,18602
5806,19239,9085,10154,2012,18603
5807,4788,2245,2543,2012,18610
5808,17400,8972,8428,2012,18612
5809,2767,1408,1359,2012,18614
5810,1938,942,996,2012,18615
5811,551,280,271,2012,18616
5812,2084,1063,1021,2012,18617
5813,3878,1852,2026,2012,18618
5814,224,119,105,2012,18619
5815,6154,3739,2415,2012,18621
5816,208,109,99,2012,18622
5817,2382,1223,1159,2012,18623
5818,590,322,268,2012,18624
5819,386,200,186,2012,18625
5820,660,298,362,2012,18626
5821,263,114,149,2012,18628
5822,1739,879,860,2012,18629
5823,3219,1601,1618,2012,18630
5824,1194,580,614,2012,18631
5825,354,188,166,2012,18632
5826,13474,6284,7190,2012,18634
5827,4113,1930,2183,2012,18635
5828,1465,762,703,2012,18636
5829,17157,8300,8857,2012,18640
5830,7142,3466,3676,2012,18641
5831,3950,1960,1990,2012,18642
5832,12652,6132,6520,2012,18643
5833,7321,3564,3757,2012,18644
5834,8850,4130,4720,2012,18651
5835,138,54,84,2012,18653
5836,6581,3297,3284,2012,18655
5837,2252,1165,1087,2012,18656
5838,12498,6402,6096,2012,18657
5839,3209,1633,1576,2012,18660
5840,5418,2759,2659,2012,18661
5841,3005,1443,1562,2012,18701
5842,41121,20104,21017,2012,18702
5843,31277,14771,16506,2012,18704
5844,14324,6685,7639,2012,18705
5845,16268,7680,8588,2012,18706
5846,15850,7610,8240,2012,18707
5847,9937,5445,4492,2012,18708
5848,2892,1403,1489,2012,18709
5849,8744,4435,4309,2012,18801
5850,6107,2730,3377,2012,18810
5851,1583,769,814,2012,18812
5852,125,75,50,2012,18814
5853,158,74,84,2012,18816
5854,214,83,131,2012,18817
5855,1456,804,652,2012,18818
5856,1153,661,492,2012,18821
5857,3673,1776,1897,2012,18822
5858,244,130,114,2012,18823
5859,1314,746,568,2012,18824
5860,107,45,62,2012,18825
5861,1487,750,737,2012,18826
5862,216,105,111,2012,18828
5863,817,428,389,2012,18829
5864,846,430,416,2012,18830
5865,1099,494,605,2012,18831
5866,1814,985,829,2012,18832
5867,1954,988,966,2012,18833
5868,3654,1934,1720,2012,18834
5869,3315,1692,1623,2012,18837
5870,11007,5137,5870,2012,18840
5871,294,118,176,2012,18842
5872,151,65,86,2012,18843
5873,2061,983,1078,2012,18844
5874,314,162,152,2012,18845
5875,798,417,381,2012,18846
5876,5886,2914,2972,2012,18847
5877,9011,4567,4444,2012,18848
5878,2249,1130,1119,2012,18850
5879,766,418,348,2012,18851
5880,4692,2446,2246,2012,18853
5881,1345,711,634,2012,18854
5882,27949,13381,14568,2012,18901
5883,20482,10076,10406,2012,18902
5884,0,0,0,2012,18912
5885,47,38,9,2012,18913
5886,21519,10484,11035,2012,18914
5887,903,445,458,2012,18915
5888,2338,1238,1100,2012,18917
5889,139,69,70,2012,18920
5890,969,561,408,2012,18923
5891,6245,3007,3238,2012,18925
5892,8510,4095,4415,2012,18929
5893,2543,1213,1330,2012,18930
5894,414,183,231,2012,18932
5895,37,10,27,2012,18935
5896,60,45,15,2012,18936
5897,14087,7000,7087,2012,18938
5898,28982,14276,14706,2012,18940
5899,3719,1874,1845,2012,18942
5900,24361,12052,12309,2012,18944
5901,6949,3529,3420,2012,18947
5902,192,91,101,2012,18950
5903,34511,16804,17707,2012,18951
5904,9677,4758,4919,2012,18954
5905,1551,706,845,2012,18955
5906,12838,6157,6681,2012,18960
5907,492,240,252,2012,18962
5908,13408,6289,7119,2012,18964
5909,38005,18699,19306,2012,18966
5910,15132,7488,7644,2012,18969
5911,664,309,355,2012,18970
5912,3730,1901,1829,2012,18972
5913,41577,20078,21499,2012,18974
5914,19036,9379,9657,2012,18976
5915,4132,1993,2139,2012,18977
5916,503,247,256,2012,18980
5917,17236,8311,8925,2012,19001
5918,32883,15948,16935,2012,19002
5919,12646,5535,7111,2012,19003
5920,9544,4517,5027,2012,19004
5921,21400,10684,10716,2012,19006
5922,20805,10314,10491,2012,19007
5923,20509,10144,10365,2012,19008
5924,1011,521,490,2012,19009
5925,21184,9126,12058,2012,19010
5926,6752,3251,3501,2012,19012
5927,35496,16643,18853,2012,19013
5928,20805,10487,10318,2012,19014
5929,16421,7811,8610,2012,19015
5930,407,199,208,2012,19017
5931,23407,10704,12703,2012,19018
5932,55741,28293,27448,2012,19020
5933,10324,5116,5208,2012,19021
5934,4104,2014,2090,2012,19022
5935,22500,10879,11621,2012,19023
5936,5679,2701,2978,2012,19025
5937,30645,14639,16006,2012,19026
5938,19684,9139,10545,2012,19027
5939,3998,2083,1915,2012,19029
5940,12512,6308,6204,2012,19030
5941,4792,2071,2721,2012,19031
5942,6617,3183,3434,2012,19032
5943,8520,4481,4039,2012,19033
5944,5591,2708,2883,2012,19034
5945,3220,1500,1720,2012,19035
5946,12736,5866,6870,2012,19036
5947,30748,14260,16488,2012,19038
5948,20236,9504,10732,2012,19040
5949,6043,2669,3374,2012,19041
5950,2472,1079,1393,2012,19043
5951,16461,7971,8490,2012,19044
5952,17781,8306,9475,2012,19046
5953,35306,16877,18429,2012,19047
5954,28326,13273,15053,2012,19050
5955,25931,12427,13504,2012,19053
5956,17437,8676,8761,2012,19054
5957,13508,6972,6536,2012,19055
5958,15677,7624,8053,2012,19056
5959,17482,8667,8815,2012,19057
5960,11228,5690,5538,2012,19060
5961,20101,9268,10833,2012,19061
5962,35864,16920,18944,2012,19063
5963,24718,12030,12688,2012,19064
5964,6284,2994,3290,2012,19066
5965,50915,24632,26283,2012,19067
5966,7182,3388,3794,2012,19070
5967,9192,4165,5027,2012,19072
5968,18392,8855,9537,2012,19073
5969,5887,2715,3172,2012,19074
5970,7391,3556,3835,2012,19075
5971,6571,3287,3284,2012,19076
5972,10961,5526,5435,2012,19078
5973,9347,4094,5253,2012,19079
5974,10189,4743,5446,2012,19081
5975,40924,19411,21513,2012,19082
5976,35748,17273,18475,2012,19083
5977,8525,4240,4285,2012,19085
5978,11252,5405,5847,2012,19086
5979,32683,15768,16915,2012,19087
5980,18868,9032,9836,2012,19090
5981,3539,1660,1879,2012,19094
5982,7270,3058,4212,2012,19095
5983,13994,6290,7704,2012,19096
5984,3592,1849,1743,2012,19102
5985,22850,10112,12738,2012,19103
5986,53002,25948,27054,2012,19104
5987,10833,5895,4938,2012,19106
5988,11802,5895,5907,2012,19107
5989,0,0,0,2012,19109
5990,67295,31886,35409,2012,19111
5991,0,0,0,2012,19112
5992,106,49,57,2012,19113
5993,30745,15206,15539,2012,19114
5994,32605,15849,16756,2012,19115
5995,32338,15394,16944,2012,19116
5996,9261,4113,5148,2012,19118
5997,28170,12807,15363,2012,19119
5998,74763,34300,40463,2012,19120
5999,34418,15887,18531,2012,19121
6000,19343,9130,10213,2012,19122
6001,12267,5861,6406,2012,19123
6002,63222,29963,33259,2012,19124
6003,22472,11173,11299,2012,19125
6004,16531,8282,8249,2012,19126
6005,5094,2420,2674,2012,19127
6006,35041,17367,17674,2012,19128
6007,11125,5203,5922,2012,19129
6008,24219,12175,12044,2012,19130
6009,43660,19591,24069,2012,19131
6010,35903,16077,19826,2012,19132
6011,24615,11046,13569,2012,19133
6012,58914,28841,30073,2012,19134
6013,33731,16415,17316,2012,19135
6014,39587,20410,19177,2012,19136
6015,8316,4190,4126,2012,19137
6016,33955,14373,19582,2012,19138
6017,43181,19340,23841,2012,19139
6018,54687,25764,28923,2012,19140
6019,32876,15064,17812,2012,19141
6020,29332,13628,15704,2012,19142
6021,66969,30473,36496,2012,19143
6022,44803,19908,24895,2012,19144
6023,47857,21602,26255,2012,19145
6024,34095,16032,18063,2012,19146
6025,33845,16828,17017,2012,19147
6026,49088,24370,24718,2012,19148
6027,53857,26200,27657,2012,19149
6028,23370,10247,13123,2012,19150
6029,32381,13651,18730,2012,19151
6030,33832,16020,17812,2012,19152
6031,12020,5542,6478,2012,19153
6032,34006,17002,17004,2012,19154
6033,6294,3062,3232,2012,19301
6034,3310,1690,1620,2012,19310
6035,8805,4510,4295,2012,19311
6036,11442,5371,6071,2012,19312
6037,236,121,115,2012,19316
6038,9405,4391,5014,2012,19317
6039,1119,519,600,2012,19319
6040,52093,25706,26387,2012,19320
6041,5483,2686,2797,2012,19330
6042,7076,3232,3844,2012,19333
6043,46766,22894,23872,2012,19335
6044,16846,8463,8383,2012,19341
6045,18338,9162,9176,2012,19342
6046,8486,4164,4322,2012,19343
6047,11840,5636,6204,2012,19344
6048,717,139,578,2012,19345
6049,22240,11122,11118,2012,19348
6050,11235,5859,5376,2012,19350
6051,10122,5070,5052,2012,19352
6052,24261,12181,12080,2012,19355
6053,407,193,214,2012,19358
6054,6245,3172,3073,2012,19362
6055,17026,8353,8673,2012,19363
6056,6781,3462,3319,2012,19365
6057,135,82,53,2012,19367
6058,1311,701,610,2012,19372
6059,4431,2904,1527,2012,19373
6060,1358,978,380,2012,19374
6061,24,24,0,2012,19375
6062,49708,24129,25579,2012,19380
6063,53265,25877,27388,2012,19382
6064,3068,991,2077,2012,19383
6065,13212,6422,6790,2012,19390
6066,41617,20936,20681,2012,19401
6067,44465,22465,22000,2012,19403
6068,5176,2938,2238,2012,19405
6069,23454,11459,11995,2012,19406
6070,18409,9163,9246,2012,19422
6071,13791,6999,6792,2012,19425
6072,38980,20722,18258,2012,19426
6073,16421,7979,8442,2012,19428
6074,158,44,114,2012,19435
6075,601,128,473,2012,19436
6076,511,271,240,2012,19437
6077,23616,11429,12187,2012,19438
6078,17750,8910,8840,2012,19440
6079,0,0,0,2012,19442
6080,10357,4973,5384,2012,19444
6081,54718,27012,27706,2012,19446
6082,1423,670,753,2012,19453
6083,28484,13758,14726,2012,19454
6084,618,335,283,2012,19456
6085,165,133,32,2012,19457
6086,39619,19470,20149,2012,19460
6087,15063,7067,7996,2012,19462
6088,45498,22075,23423,2012,19464
6089,17079,8462,8617,2012,19465
6090,25174,12419,12755,2012,19468
6091,0,0,0,2012,19472
6092,15975,7761,8214,2012,19473
6093,407,151,256,2012,19474
6094,11425,5701,5724,2012,19475
6095,157,80,77,2012,19477
6096,431,187,244,2012,19492
6097,1009,541,468,2012,19501
6098,1371,726,645,2012,19503
6099,5325,2480,2845,2012,19504
6100,3116,1576,1540,2012,19505
6101,7736,4072,3664,2012,19506
6102,3597,1773,1824,2012,19507
6103,15312,7881,7431,2012,19508
6104,7527,3638,3889,2012,19510
6105,358,161,197,2012,19511
6106,17256,8384,8872,2012,19512
6107,14568,7433,7135,2012,19518
6108,104,43,61,2012,19519
6109,5596,2750,2846,2012,19520
6110,14933,7517,7416,2012,19522
6111,295,163,132,2012,19523
6112,13964,6792,7172,2012,19525
6113,11326,5510,5816,2012,19526
6114,3121,1491,1630,2012,19529
6115,15947,7234,8713,2012,19530
6116,7567,4216,3351,2012,19533
6117,2127,1163,964,2012,19534
6118,43,21,22,2012,19535
6119,404,185,219,2012,19536
6120,112,66,46,2012,19538
6121,4690,2419,2271,2012,19539
6122,12257,6385,5872,2012,19540
6123,4085,2235,1850,2012,19541
6124,0,0,0,2012,19542
6125,5992,3064,2928,2012,19543
6126,187,82,105,2012,19544
6127,520,261,259,2012,19545
6128,4344,2179,2165,2012,19547
6129,253,120,133,2012,19549
6130,597,428,169,2012,19550
6131,5062,2525,2537,2012,19551
6132,339,194,145,2012,19554
6133,3343,1694,1649,2012,19555
6134,306,155,151,2012,19559
6135,7656,3656,4000,2012,19560
6136,2304,1027,1277,2012,19562
6137,101,51,50,2012,19564
6138,8650,4194,4456,2012,19565
6139,5264,2728,2536,2012,19567
6140,33403,16358,17045,2012,19601
6141,18190,8823,9367,2012,19602
6142,26703,13048,13655,2012,19604
6143,19094,9228,9866,2012,19605
6144,34275,16042,18233,2012,19606
6145,21482,10085,11397,2012,19607
6146,21838,10583,11255,2012,19608
6147,10402,4959,5443,2012,19609
6148,15246,7120,8126,2012,19610
6149,10985,5170,5815,2012,19611
6150,40443,20331,20112,2012,19701
6151,52656,25758,26898,2012,19702
6152,14227,7007,7220,2012,19703
6153,1917,936,981,2012,19706
6154,15768,7765,8003,2012,19707
6155,35438,17650,17788,2012,19709
6156,0,0,0,2012,19710
6157,50327,24126,26201,2012,19711
6158,30517,14561,15956,2012,19713
6159,1337,545,792,2012,19716
6160,4091,1625,2466,2012,19717
6161,61095,28917,32178,2012,19720
6162,471,266,205,2012,19730
6163,153,70,83,2012,19731
6164,117,56,61,2012,19732
6165,147,74,73,2012,19733
6166,10536,5160,5376,2012,19734
6167,0,0,0,2012,19735
6168,0,0,0,2012,19736
6169,15355,7479,7876,2012,19801
6170,25385,11410,13975,2012,19802
6171,21154,10161,10993,2012,19803
6172,18446,8481,9965,2012,19804
6173,41422,19645,21777,2012,19805
6174,9867,4638,5229,2012,19806
6175,7337,3526,3811,2012,19807
6176,36866,17981,18885,2012,19808
6177,14080,6865,7215,2012,19809
6178,25553,12374,13179,2012,19810
6179,35333,16528,18805,2012,19901
6180,125,108,17,2012,19902
6181,33183,16104,17079,2012,19904
6182,1940,894,1046,2012,19930
6183,232,115,117,2012,19931
6184,8495,4228,4267,2012,19933
6185,13231,6374,6857,2012,19934
6186,421,258,163,2012,19936
6187,8705,4548,4157,2012,19938
6188,7296,3527,3769,2012,19939
6189,5224,2602,2622,2012,19940
6190,3012,1455,1557,2012,19941
6191,12105,6171,5934,2012,19943
6192,497,241,256,2012,19944
6193,8819,4484,4335,2012,19945
6194,4263,2245,2018,2012,19946
6195,18267,9928,8339,2012,19947
6196,6481,3126,3355,2012,19950
6197,1922,1013,909,2012,19951
6198,10021,4849,5172,2012,19952
6199,4065,1913,2152,2012,19953
6200,1511,782,729,2012,19954
6201,80,46,34,2012,19955
6202,14906,6907,7999,2012,19956
6203,19356,8984,10372,2012,19958
6204,7398,3293,4105,2012,19960
6205,10086,4876,5210,2012,19962
6206,18304,8565,9739,2012,19963
6207,1550,836,714,2012,19964
6208,26916,13116,13800,2012,19966
6209,415,215,200,2012,19967
6210,9139,4381,4758,2012,19968
6211,6678,3384,3294,2012,19970
6212,11224,5620,5604,2012,19971
6213,21540,10334,11206,2012,19973
6214,8862,4370,4492,2012,19975
6215,23273,12241,11032,2012,19977
6216,551,270,281,2012,19979
6217,38570,19226,19344,2012,20001
6218,55023,27646,27377,2012,20002
6219,27231,14042,13189,2012,20003
6220,1589,868,721,2012,20004
6221,12062,6880,5182,2012,20005
6222,2941,1395,1546,2012,20006
6223,25249,11519,13730,2012,20007
6224,27527,12261,15266,2012,20008
6225,47537,24304,23233,2012,20009
6226,31139,15210,15929,2012,20010
6227,59379,28132,31247,2012,20011
6228,14640,6849,7791,2012,20012
6229,15796,7371,8425,2012,20015
6230,33991,15383,18608,2012,20016
6231,18336,8370,9966,2012,20017
6232,17367,7247,10120,2012,20018
6233,52103,22526,29577,2012,20019
6234,51213,22387,28826,2012,20020
6235,11713,5429,6284,2012,20024
6236,35349,16252,19097,2012,20032
6237,5672,2803,2869,2012,20036
6238,14304,6792,7512,2012,20037
6239,0,0,0,2012,20045
6240,555,267,288,2012,20052
6241,0,0,0,2012,20053
6242,4074,1845,2229,2012,20057
6243,1684,820,864,2012,20064
6244,11420,5694,5726,2012,20105
6245,5416,2649,2767,2012,20106
6246,34256,17102,17154,2012,20109
6247,43640,22331,21309,2012,20110
6248,31106,15927,15179,2012,20111
6249,25777,13019,12758,2012,20112
6250,6261,3180,3081,2012,20115
6251,2576,1223,1353,2012,20117
6252,9,4,5,2012,20118
6253,3988,2147,1841,2012,20119
6254,41318,20415,20903,2012,20120
6255,28381,14343,14038,2012,20121
6256,16032,8216,7816,2012,20124
6257,643,337,306,2012,20129
6258,330,192,138,2012,20130
6259,16503,8356,8147,2012,20132
6260,2970,1556,1414,2012,20135
6261,29346,14293,15053,2012,20136
6262,1415,729,686,2012,20137
6263,271,112,159,2012,20139
6264,6558,3131,3427,2012,20141
6265,1213,616,597,2012,20143
6266,1389,815,574,2012,20144
6267,55759,26786,28973,2012,20147
6268,28440,13855,14585,2012,20148
6269,21715,10729,10986,2012,20151
6270,25621,13295,12326,2012,20152
6271,29738,14919,14819,2012,20155
6272,4395,2064,2331,2012,20158
6273,36201,18368,17833,2012,20164
6274,32377,15491,16886,2012,20165
6275,9465,4912,4553,2012,20166
6276,19702,9755,9947,2012,20169
6277,41152,21212,19940,2012,20170
6278,46201,22648,23553,2012,20171
6279,28263,14388,13875,2012,20175
6280,46270,22624,23646,2012,20176
6281,6135,2966,3169,2012,20180
6282,7505,3783,3722,2012,20181
6283,807,352,455,2012,20184
6284,14365,6570,7795,2012,20186
6285,15862,7996,7866,2012,20187
6286,17638,8489,9149,2012,20190
6287,28574,13807,14767,2012,20191
6288,13436,6462,6974,2012,20194
6289,1743,798,945,2012,20197
6290,2116,900,1216,2012,20198
6291,0,0,0,2012,20202
6292,0,0,0,2012,20204
6293,0,0,0,2012,20228
6294,0,0,0,2012,20230
6295,0,0,0,2012,20240
6296,0,0,0,2012,20245
6297,0,0,0,2012,20260
6298,108,98,10,2012,20307
6299,348,246,102,2012,20317
6300,106,106,0,2012,20319
6301,38,38,0,2012,20373
6302,115,115,0,2012,20390
6303,0,0,0,2012,20405
6304,0,0,0,2012,20418
6305,0,0,0,2012,20427
6306,0,0,0,2012,20506
6307,0,0,0,2012,20510
6308,0,0,0,2012,20520
6309,0,0,0,2012,20535
6310,0,0,0,2012,20540
6311,0,0,0,2012,20551
6312,0,0,0,2012,20553
6313,0,0,0,2012,20560
6314,0,0,0,2012,20565
6315,0,0,0,2012,20566
6316,0,0,0,2012,20593
6317,24801,11850,12951,2012,20601
6318,25225,11752,13473,2012,20602
6319,30628,14595,16033,2012,20603
6320,335,189,146,2012,20606
6321,9560,4732,4828,2012,20607
6322,813,400,413,2012,20608
6323,1066,562,504,2012,20609
6324,878,420,458,2012,20611
6325,259,147,112,2012,20612
6326,13446,7142,6304,2012,20613
6327,244,141,103,2012,20615
6328,6369,2978,3391,2012,20616
6329,878,411,467,2012,20617
6330,705,372,333,2012,20618
6331,9817,4574,5243,2012,20619
6332,1586,742,844,2012,20620
6333,1180,641,539,2012,20621
6334,4651,2357,2294,2012,20622
6335,3016,1421,1595,2012,20623
6336,1164,605,559,2012,20624
6337,644,278,366,2012,20625
6338,359,183,176,2012,20626
6339,305,155,150,2012,20628
6340,227,120,107,2012,20629
6341,187,100,87,2012,20630
6342,331,228,103,2012,20632
6343,6252,3158,3094,2012,20634
6344,10435,5020,5415,2012,20636
6345,4856,2324,2532,2012,20637
6346,14442,7308,7134,2012,20639
6347,9945,4891,5054,2012,20640
6348,862,475,387,2012,20645
6349,18866,9371,9495,2012,20646
6350,13569,6901,6668,2012,20650
6351,26057,13524,12533,2012,20653
6352,20538,9967,10571,2012,20657
6353,990,555,435,2012,20658
6354,23320,11387,11933,2012,20659
6355,44,24,20,2012,20660
6356,2752,1278,1474,2012,20662
6357,2636,1332,1304,2012,20664
6358,416,132,284,2012,20667
6359,1203,784,419,2012,20670
6360,925,462,463,2012,20674
6361,1663,812,851,2012,20675
6362,3775,1854,1921,2012,20676
6363,2802,1326,1476,2012,20677
6364,11168,5369,5799,2012,20678
6365,1148,501,647,2012,20680
6366,959,379,580,2012,20684
6367,6818,3502,3316,2012,20685
6368,754,322,432,2012,20686
6369,368,170,198,2012,20687
6370,1645,660,985,2012,20688
6371,1865,930,935,2012,20689
6372,394,199,195,2012,20690
6373,1312,662,650,2012,20692
6374,926,484,442,2012,20693
6375,5770,2818,2952,2012,20695
6376,122,0,122,2012,20701
6377,25222,12318,12904,2012,20705
6378,37358,17763,19595,2012,20706
6379,31459,14678,16781,2012,20707
6380,25206,11399,13807,2012,20708
6381,9323,4399,4924,2012,20710
6382,6462,3313,3149,2012,20711
6383,8965,4160,4805,2012,20712
6384,4077,1839,2238,2012,20714
6385,27011,13059,13952,2012,20715
6386,20485,9558,10927,2012,20716
6387,21356,10296,11060,2012,20720
6388,26134,11598,14536,2012,20721
6389,5571,2655,2916,2012,20722
6390,28739,13946,14793,2012,20723
6391,15177,7018,8159,2012,20724
6392,9616,4684,4932,2012,20732
6393,2708,1425,1283,2012,20733
6394,35555,16515,19040,2012,20735
6395,9264,4709,4555,2012,20736
6396,20195,11100,9095,2012,20737
6397,27776,14809,12967,2012,20740
6398,8822,4482,4340,2012,20742
6399,36099,16770,19329,2012,20743
6400,51088,24319,26769,2012,20744
6401,28626,13394,15232,2012,20745
6402,28009,12504,15505,2012,20746
6403,39879,17887,21992,2012,20747
6404,39490,18243,21247,2012,20748
6405,2127,1209,918,2012,20751
6406,6978,3562,3416,2012,20754
6407,10712,5284,5428,2012,20755
6408,668,314,354,2012,20758
6409,3437,1752,1685,2012,20759
6410,3210,1692,1518,2012,20762
6411,2347,1287,1060,2012,20763
6412,4590,2252,2338,2012,20764
6413,420,202,218,2012,20765
6414,6244,3210,3034,2012,20769
6415,24816,11672,13144,2012,20770
6416,43925,20769,23156,2012,20772
6417,42351,19179,23172,2012,20774
6418,3607,1799,1808,2012,20776
6419,3199,1455,1744,2012,20777
6420,2152,1090,1062,2012,20778
6421,1192,554,638,2012,20779
6422,11920,5749,6171,2012,20781
6423,33769,16088,17681,2012,20782
6424,46389,26635,19754,2012,20783
6425,29515,14347,15168,2012,20784
6426,35771,16552,19219,2012,20785
6427,14682,9201,5481,2012,20794
6428,232,118,114,2012,20812
6429,26998,12912,14086,2012,20814
6430,30323,13818,16505,2012,20815
6431,15904,7365,8539,2012,20816
6432,36222,17239,18983,2012,20817
6433,2057,1019,1038,2012,20818
6434,24919,12064,12855,2012,20832
6435,7698,3554,4144,2012,20833
6436,5657,2697,2960,2012,20837
6437,267,105,162,2012,20838
6438,195,110,85,2012,20839
6439,10637,5507,5130,2012,20841
6440,1622,786,836,2012,20842
6441,45464,21370,24094,2012,20850
6442,13665,6798,6867,2012,20851
6443,40725,19068,21657,2012,20852
6444,29548,14590,14958,2012,20853
6445,49714,23990,25724,2012,20854
6446,14377,7111,7266,2012,20855
6447,2375,1112,1263,2012,20860
6448,1596,833,763,2012,20861
6449,175,101,74,2012,20862
6450,12557,5831,6726,2012,20866
6451,1335,730,605,2012,20868
6452,12953,6340,6613,2012,20871
6453,13264,6438,6826,2012,20872
6454,57883,28263,29620,2012,20874
6455,25895,12491,13404,2012,20876
6456,33519,16613,16906,2012,20877
6457,62983,30148,32835,2012,20878
6458,24630,12139,12491,2012,20879
6459,489,201,288,2012,20880
6460,14294,7191,7103,2012,20882
6461,33725,16058,17667,2012,20886
6462,18711,8830,9881,2012,20895
6463,973,477,496,2012,20896
6464,130,121,9,2012,20899
6465,35135,17354,17781,2012,20901
6466,49458,24354,25104,2012,20902
6467,25445,13145,12300,2012,20903
6468,55956,25724,30232,2012,20904
6469,17489,8626,8863,2012,20905
6470,64936,30176,34760,2012,20906
6471,37510,17760,19750,2012,20910
6472,24857,12159,12698,2012,20912
6473,21213,10328,10885,2012,21001
6474,1889,1066,823,2012,21005
6475,29322,14178,15144,2012,21009
6476,294,105,189,2012,21010
6477,20784,10102,10682,2012,21012
6478,5093,2549,2544,2012,21013
6479,34468,16897,17571,2012,21014
6480,28286,13694,14592,2012,21015
6481,7335,3712,3623,2012,21017
6482,3565,1758,1807,2012,21028
6483,11236,5641,5595,2012,21029
6484,23754,11263,12491,2012,21030
6485,35,12,23,2012,21031
6486,8626,4450,4176,2012,21032
6487,3283,1644,1639,2012,21034
6488,7991,4126,3865,2012,21035
6489,2187,1041,1146,2012,21036
6490,20525,10067,10458,2012,21037
6491,24282,11167,13115,2012,21040
6492,39556,19499,20057,2012,21042
6493,41498,20535,20963,2012,21043
6494,40854,19247,21607,2012,21044
6495,40367,20195,20172,2012,21045
6496,15569,7299,8270,2012,21046
6497,12014,6185,5829,2012,21047
6498,10712,5732,4980,2012,21048
6499,18954,9245,9709,2012,21050
6500,227,113,114,2012,21051
6501,227,107,120,2012,21052
6502,3300,1675,1625,2012,21053
6503,9441,4621,4820,2012,21054
6504,141,83,58,2012,21056
6505,3993,2084,1909,2012,21057
6506,28848,14010,14838,2012,21060
6507,52784,24884,27900,2012,21061
6508,275,137,138,2012,21071
6509,14220,6686,7534,2012,21074
6510,26220,12626,13594,2012,21075
6511,13205,6639,6566,2012,21076
6512,117,41,76,2012,21077
6513,18441,8853,9588,2012,21078
6514,543,300,243,2012,21082
6515,7548,3678,3870,2012,21084
6516,16581,8328,8253,2012,21085
6517,5391,2783,2608,2012,21087
6518,10273,4871,5402,2012,21090
6519,36282,16841,19441,2012,21093
6520,11218,5404,5814,2012,21102
6521,5018,2372,2646,2012,21104
6522,25,12,13,2012,21105
6523,18074,8726,9348,2012,21108
6524,4624,2164,2460,2012,21111
6525,30570,14443,16127,2012,21113
6526,26196,13060,13136,2012,21114
6527,55580,25570,30010,2012,21117
6528,6732,3323,3409,2012,21120
6529,60168,30298,29870,2012,21122
6530,13449,6383,7066,2012,21128
6531,282,154,128,2012,21130
6532,7073,3661,3412,2012,21131
6533,2311,1232,1079,2012,21132
6534,29896,13803,16093,2012,21133
6535,34471,16186,18285,2012,21136
6536,3479,1709,1770,2012,21140
6537,31928,15500,16428,2012,21144
6538,26521,12896,13625,2012,21146
6539,6324,3154,3170,2012,21152
6540,344,173,171,2012,21153
6541,6843,3642,3201,2012,21154
6542,2236,1111,1125,2012,21155
6543,388,170,218,2012,21156
6544,37990,18324,19666,2012,21157
6545,19673,9623,10050,2012,21158
6546,2210,1229,981,2012,21160
6547,6278,2936,3342,2012,21161
6548,3351,1547,1804,2012,21162
6549,7373,3595,3778,2012,21163
6550,15547,6954,8593,2012,21201
6551,22054,12562,9492,2012,21202
6552,19930,9238,10692,2012,21204
6553,17042,8036,9006,2012,21205
6554,50147,23175,26972,2012,21206
6555,49520,21948,27572,2012,21207
6556,32488,14475,18013,2012,21208
6557,28202,13176,15026,2012,21209
6558,14971,7489,7482,2012,21210
6559,16927,8291,8636,2012,21211
6560,33408,15570,17838,2012,21212
6561,30391,13451,16940,2012,21213
6562,19589,9193,10396,2012,21214
6563,63515,28252,35263,2012,21215
6564,25946,11872,14074,2012,21216
6565,39788,17493,22295,2012,21217
6566,51290,24359,26931,2012,21218
6567,9266,4407,4859,2012,21219
6568,39313,19714,19599,2012,21220
6569,41575,19771,21804,2012,21221
6570,55163,26523,28640,2012,21222
6571,25270,12038,13232,2012,21223
6572,47784,24504,23280,2012,21224
6573,35401,16994,18407,2012,21225
6574,6795,3412,3383,2012,21226
6575,34624,17425,17199,2012,21227
6576,48191,22644,25547,2012,21228
6577,45438,21178,24260,2012,21229
6578,33364,17058,16306,2012,21230
6579,16367,7902,8465,2012,21231
6580,68256,31441,36815,2012,21234
6581,37599,17625,19974,2012,21236
6582,29728,13787,15941,2012,21237
6583,29726,13609,16117,2012,21239
6584,0,0,0,2012,21240
6585,36875,17654,19221,2012,21244
6586,3351,2037,1314,2012,21250
6587,801,416,385,2012,21251
6588,2675,1262,1413,2012,21252
6589,19506,8669,10837,2012,21286
6590,37112,18296,18816,2012,21401
6591,6121,4636,1485,2012,21402
6592,30044,14124,15920,2012,21403
6593,435,194,241,2012,21405
6594,19563,9823,9740,2012,21409
6595,43549,23542,20007,2012,21502
6596,1924,901,1023,2012,21520
6597,1498,753,745,2012,21521
6598,101,56,45,2012,21522
6599,299,179,120,2012,21523
6600,731,353,378,2012,21524
6601,414,178,236,2012,21529
6602,1597,814,783,2012,21530
6603,2239,1134,1105,2012,21531
6604,15883,7668,8215,2012,21532
6605,4370,2153,2217,2012,21536
6606,718,371,347,2012,21538
6607,2738,1392,1346,2012,21539
6608,109,44,65,2012,21540
6609,1222,692,530,2012,21541
6610,484,231,253,2012,21542
6611,113,69,44,2012,21543
6612,1897,897,1000,2012,21545
6613,14423,7127,7296,2012,21550
6614,1590,735,855,2012,21555
6615,2168,998,1170,2012,21557
6616,2731,1272,1459,2012,21561
6617,3247,1590,1657,2012,21562
6618,23633,11358,12275,2012,21601
6619,652,379,273,2012,21607
6620,460,222,238,2012,21610
6621,306,149,157,2012,21612
6622,17618,8344,9274,2012,21613
6623,9616,5000,4616,2012,21617
6624,5949,2858,3091,2012,21619
6625,12415,5552,6863,2012,21620
6626,667,409,258,2012,21622
6627,2021,983,1038,2012,21623
6628,122,56,66,2012,21624
6629,2562,1240,1322,2012,21625
6630,102,54,48,2012,21626
6631,15,7,8,2012,21627
6632,324,117,207,2012,21628
6633,9575,4653,4922,2012,21629
6634,2681,1303,1378,2012,21631
6635,5861,2742,3119,2012,21632
6636,410,160,250,2012,21634
6637,2204,1222,982,2012,21635
6638,1460,728,732,2012,21636
6639,4881,2518,2363,2012,21638
6640,4647,2210,2437,2012,21639
6641,1367,637,730,2012,21640
6642,53,26,27,2012,21641
6643,5298,2537,2761,2012,21643
6644,90,64,26,2012,21644
6645,1292,676,616,2012,21645
6646,341,132,209,2012,21647
6647,308,173,135,2012,21648
6648,1906,1018,888,2012,21649
6649,266,115,151,2012,21650
6650,3193,1653,1540,2012,21651
6651,117,57,60,2012,21652
6652,106,41,65,2012,21653
6653,1003,413,590,2012,21654
6654,4945,2514,2431,2012,21655
6655,908,488,420,2012,21657
6656,4009,2045,1964,2012,21658
6657,1724,788,936,2012,21659
6658,4108,1921,2187,2012,21660
6659,2708,1280,1428,2012,21661
6660,808,384,424,2012,21662
6661,3375,1500,1875,2012,21663
6662,763,367,396,2012,21664
6663,329,156,173,2012,21665
6664,12498,5982,6516,2012,21666
6665,194,97,97,2012,21667
6666,1713,800,913,2012,21668
6667,137,51,86,2012,21669
6668,757,425,332,2012,21671
6669,216,124,92,2012,21672
6670,3240,1623,1617,2012,21673
6671,56,33,23,2012,21675
6672,425,179,246,2012,21676
6673,494,228,266,2012,21677
6674,2382,1180,1202,2012,21678
6675,593,310,283,2012,21679
6676,36648,17549,19099,2012,21701
6677,37423,18079,19344,2012,21702
6678,32376,16390,15986,2012,21703
6679,13407,6593,6814,2012,21704
6680,2,1,1,2012,21705
6681,4791,2412,2379,2012,21710
6682,1029,526,503,2012,21711
6683,9165,4446,4719,2012,21713
6684,11,0,11,2012,21714
6685,4881,2446,2435,2012,21716
6686,0,0,0,2012,21717
6687,148,62,86,2012,21718
6688,1357,618,739,2012,21719
6689,5346,2769,2577,2012,21722
6690,745,326,419,2012,21723
6691,5977,2765,3212,2012,21727
6692,1036,504,532,2012,21733
6693,913,452,461,2012,21734
6694,1066,493,573,2012,21737
6695,3266,1712,1554,2012,21738
6696,60838,31265,29573,2012,21740
6697,32585,15623,16962,2012,21742
6698,2584,2584,0,2012,21746
6699,3919,2078,1841,2012,21750
6700,5900,2867,3033,2012,21754
6701,5549,2727,2822,2012,21755
6702,3333,1730,1603,2012,21756
6703,2829,1510,1319,2012,21757
6704,5005,2441,2564,2012,21758
6705,88,38,50,2012,21762
6706,679,339,340,2012,21766
6707,1112,612,500,2012,21767
6708,11025,5817,5208,2012,21769
6709,5923,2863,3060,2012,21770
6710,29101,14204,14897,2012,21771
6711,5768,2918,2850,2012,21773
6712,11625,5806,5819,2012,21774
6713,5243,2544,2699,2012,21776
6714,1432,705,727,2012,21777
6715,1345,654,691,2012,21778
6716,1019,535,484,2012,21779
6717,2027,1089,938,2012,21780
6718,54,16,38,2012,21781
6719,4811,2446,2365,2012,21782
6720,9073,4192,4881,2012,21783
6721,39401,20135,19266,2012,21784
6722,11194,5357,5837,2012,21787
6723,11452,5608,5844,2012,21788
6724,25,7,18,2012,21790
6725,5678,2884,2794,2012,21791
6726,10194,4824,5370,2012,21793
6727,2251,1149,1102,2012,21794
6728,8943,4461,4482,2012,21795
6729,8124,4136,3988,2012,21797
6730,2601,1271,1330,2012,21798
6731,30990,14088,16902,2012,21801
6732,35,18,17,2012,21802
6733,36461,17840,18621,2012,21804
6734,439,201,238,2012,21810
6735,20834,9694,11140,2012,21811
6736,3104,1614,1490,2012,21813
6737,489,227,262,2012,21814
6738,4945,2390,2555,2012,21817
6739,842,407,435,2012,21821
6740,1676,678,998,2012,21822
6741,134,74,60,2012,21824
6742,4727,2314,2413,2012,21826
6743,924,473,451,2012,21829
6744,3608,1651,1957,2012,21830
6745,698,390,308,2012,21835
6746,2697,1246,1451,2012,21837
6747,1710,891,819,2012,21838
6748,458,279,179,2012,21840
6749,1038,528,510,2012,21841
6750,11360,5733,5627,2012,21842
6751,4121,2173,1948,2012,21849
6752,2640,1334,1306,2012,21850
6753,7582,3730,3852,2012,21851
6754,10775,4484,6291,2012,21853
6755,1185,642,543,2012,21856
6756,1118,488,630,2012,21861
6757,280,216,64,2012,21862
6758,5379,2682,2697,2012,21863
6759,624,312,312,2012,21864
6760,608,336,272,2012,21865
6761,38,16,22,2012,21866
6762,48,25,23,2012,21867
6763,740,343,397,2012,21869
6764,3163,2189,974,2012,21871
6765,611,314,297,2012,21872
6766,2168,1099,1069,2012,21874
6767,6802,3106,3696,2012,21875
6768,3127,3127,0,2012,21890
6769,16428,8263,8165,2012,21901
6770,150,122,28,2012,21902
6771,5788,2747,3041,2012,21903
6772,7734,3830,3904,2012,21904
6773,11109,5863,5246,2012,21911
6774,1100,587,513,2012,21912
6775,602,269,333,2012,21913
6776,594,311,283,2012,21914
6777,2820,1463,1357,2012,21915
6778,29,29,0,2012,21916
6779,2455,1234,1221,2012,21917
6780,4253,2067,2186,2012,21918
6781,3669,1698,1971,2012,21919
6782,124,79,45,2012,21920
6783,44090,21594,22496,2012,21921
6784,164,75,89,2012,21930
6785,55524,26471,29053,2012,22003
6786,43442,21442,22000,2012,22015
6787,17849,8646,9203,2012,22025
6788,14704,6886,7818,2012,22026
6789,2523,1205,1318,2012,22027
6790,54047,26590,27457,2012,22030
6791,31342,15843,15499,2012,22031
6792,29389,13889,15500,2012,22032
6793,36786,17555,19231,2012,22033
6794,0,0,0,2012,22035
6795,19356,9700,9656,2012,22039
6796,27234,13976,13258,2012,22041
6797,31961,15839,16122,2012,22042
6798,24656,12456,12200,2012,22043
6799,13343,6860,6483,2012,22044
6800,16231,7713,8518,2012,22046
6801,9420,5010,4410,2012,22060
6802,19295,9726,9569,2012,22066
6803,32225,16143,16082,2012,22079
6804,30381,14763,15618,2012,22101
6805,21920,10664,11256,2012,22102
6806,17915,8215,9700,2012,22124
6807,659,280,379,2012,22125
6808,8948,6119,2829,2012,22134
6809,28052,14226,13826,2012,22150
6810,17678,8816,8862,2012,22151
6811,28704,13807,14897,2012,22152
6812,31979,16231,15748,2012,22153
6813,8330,3930,4400,2012,22172
6814,23717,12142,11575,2012,22180
6815,14359,7695,6664,2012,22181
6816,26208,12850,13358,2012,22182
6817,0,0,0,2012,22185
6818,59665,29831,29834,2012,22191
6819,52691,25105,27586,2012,22192
6820,73467,35975,37492,2012,22193
6821,32980,16491,16489,2012,22201
6822,20265,9808,10457,2012,22202
6823,21593,11228,10365,2012,22203
6824,49348,25169,24179,2012,22204
6825,17413,8338,9075,2012,22205
6826,19474,9092,10382,2012,22206
6827,31884,15247,16637,2012,22207
6828,11977,6422,5555,2012,22209
6829,922,822,100,2012,22211
6830,3478,1727,1751,2012,22213
6831,115,99,16,2012,22214
6832,11524,5564,5960,2012,22301
6833,17567,7944,9623,2012,22302
6834,12395,6777,5618,2012,22303
6835,45359,20895,24464,2012,22304
6836,14424,7518,6906,2012,22305
6837,31225,14553,16672,2012,22306
6838,10489,5046,5443,2012,22307
6839,13178,6547,6631,2012,22308
6840,31685,15467,16218,2012,22309
6841,28908,14404,14504,2012,22310
6842,17406,8596,8810,2012,22311
6843,29133,14289,14844,2012,22312
6844,28946,14266,14680,2012,22314
6845,26044,12808,13236,2012,22315
6846,24932,11662,13270,2012,22401
6847,29164,14418,14746,2012,22405
6848,20869,9942,10927,2012,22406
6849,56718,27820,28898,2012,22407
6850,26224,12772,13452,2012,22408
6851,3674,2169,1505,2012,22427
6852,502,163,339,2012,22432
6853,180,97,83,2012,22433
6854,2053,967,1086,2012,22435
6855,729,494,235,2012,22436
6856,789,452,337,2012,22437
6857,362,138,224,2012,22438
6858,8552,4312,4240,2012,22443
6859,957,634,323,2012,22448
6860,1932,880,1052,2012,22454
6861,1754,887,867,2012,22460
6862,1736,822,914,2012,22469
6863,5319,2734,2585,2012,22473
6864,471,245,226,2012,22476
6865,869,329,540,2012,22480
6866,2958,1439,1519,2012,22482
6867,22782,11245,11537,2012,22485
6868,1123,457,666,2012,22488
6869,4398,2077,2321,2012,22503
6870,242,98,144,2012,22504
6871,13714,6750,6964,2012,22508
6872,0,0,0,2012,22509
6873,1244,602,642,2012,22511
6874,2436,1142,1294,2012,22514
6875,5334,2537,2797,2012,22520
6876,384,190,194,2012,22529
6877,161,94,67,2012,22530
6878,2872,1309,1563,2012,22534
6879,327,156,171,2012,22535
6880,459,265,194,2012,22538
6881,2341,1058,1283,2012,22539
6882,1332,654,678,2012,22542
6883,15986,7557,8429,2012,22546
6884,25,25,0,2012,22548
6885,17883,8786,9097,2012,22551
6886,13617,6930,6687,2012,22553
6887,51396,26322,25074,2012,22554
6888,25859,12548,13311,2012,22556
6889,6472,2949,3523,2012,22560
6890,3518,1625,1893,2012,22567
6891,7688,4415,3273,2012,22572
6892,1761,879,882,2012,22576
6893,2125,1112,1013,2012,22578
6894,135,71,64,2012,22579
6895,4981,2418,2563,2012,22580
6896,27843,13515,14328,2012,22601
6897,29208,14967,14241,2012,22602
6898,13760,6686,7074,2012,22603
6899,1589,801,788,2012,22610
6900,8378,4063,4315,2012,22611
6901,2350,1067,1283,2012,22620
6902,693,321,372,2012,22623
6903,2635,1295,1340,2012,22624
6904,4115,1993,2122,2012,22625
6905,779,447,332,2012,22627
6906,30781,15179,15602,2012,22630
6907,1381,726,655,2012,22637
6908,272,133,139,2012,22639
6909,837,374,463,2012,22640
6910,663,334,329,2012,22641
6911,3880,1899,1981,2012,22642
6912,52,14,38,2012,22643
6913,2449,1269,1180,2012,22644
6914,3776,1873,1903,2012,22645
6915,214,116,98,2012,22646
6916,1463,875,588,2012,22650
6917,1243,697,546,2012,22652
6918,608,408,200,2012,22654
6919,19481,9540,9941,2012,22655
6920,2144,1098,1046,2012,22656
6921,11024,5514,5510,2012,22657
6922,2034,1038,996,2012,22660
6923,1521,863,658,2012,22663
6924,8438,3916,4522,2012,22664
6925,31755,15476,16279,2012,22701
6926,938,432,506,2012,22709
6927,0,0,0,2012,22711
6928,7731,3839,3892,2012,22712
6929,1329,566,763,2012,22713
6930,1291,674,617,2012,22714
6931,1634,889,745,2012,22715
6932,873,527,346,2012,22716
6933,422,198,224,2012,22718
6934,458,173,285,2012,22719
6935,1108,571,537,2012,22720
6936,221,146,75,2012,22722
6937,122,68,54,2012,22723
6938,1525,726,799,2012,22724
6939,637,381,256,2012,22726
6940,4815,2063,2752,2012,22727
6941,3425,1761,1664,2012,22728
6942,1307,1229,78,2012,22729
6943,38,25,13,2012,22730
6944,131,64,67,2012,22731
6945,183,98,85,2012,22732
6946,1641,1013,628,2012,22733
6947,3584,1725,1859,2012,22734
6948,2163,1244,919,2012,22735
6949,868,418,450,2012,22736
6950,2880,1349,1531,2012,22737
6951,1239,648,591,2012,22738
6952,1147,460,687,2012,22740
6953,331,282,49,2012,22741
6954,2080,1129,951,2012,22742
6955,203,98,105,2012,22743
6956,1102,522,580,2012,22747
6957,398,160,238,2012,22749
6958,37495,17810,19685,2012,22801
6959,28238,13888,14350,2012,22802
6960,2351,836,1515,2012,22807
6961,662,320,342,2012,22810
6962,538,226,312,2012,22811
6963,8985,4323,4662,2012,22812
6964,8149,4230,3919,2012,22815
6965,132,69,63,2012,22820
6966,5876,2959,2917,2012,22821
6967,5762,2579,3183,2012,22824
6968,9619,4560,5059,2012,22827
6969,1889,988,901,2012,22830
6970,892,460,432,2012,22831
6971,1336,686,650,2012,22832
6972,1258,640,618,2012,22834
6973,11467,5677,5790,2012,22835
6974,4832,2347,2485,2012,22840
6975,2773,1263,1510,2012,22841
6976,5485,2791,2694,2012,22842
6977,2520,1194,1326,2012,22843
6978,4370,2110,2260,2012,22844
6979,0,0,0,2012,22845
6980,1710,866,844,2012,22846
6981,1030,491,539,2012,22847
6982,4700,2347,2353,2012,22849
6983,937,421,516,2012,22850
6984,6015,2833,3182,2012,22851
6985,4554,2096,2458,2012,22853
6986,32698,15781,16917,2012,22901
6987,20609,9919,10690,2012,22902
6988,39363,18503,20860,2012,22903
6989,4387,2015,2372,2012,22904
6990,16982,7914,9068,2012,22911
6991,4271,2114,2157,2012,22920
6992,2358,1167,1191,2012,22922
6993,4062,2052,2010,2012,22923
6994,309,156,153,2012,22931
6995,7666,3887,3779,2012,22932
6996,629,337,292,2012,22935
6997,4560,2290,2270,2012,22936
6998,2061,1076,985,2012,22937
6999,1369,687,682,2012,22938
7000,4770,2490,2280,2012,22939
7001,1060,491,569,2012,22940
7002,7747,3596,4151,2012,22942
7003,259,117,142,2012,22943
7004,183,138,45,2012,22946
7005,4129,1940,2189,2012,22947
7006,165,108,57,2012,22948
7007,987,409,578,2012,22949
7008,2044,1070,974,2012,22952
7009,1633,906,727,2012,22958
7010,1439,697,742,2012,22959
7011,11113,5593,5520,2012,22960
7012,15656,7278,8378,2012,22963
7013,140,72,68,2012,22964
7014,1590,824,766,2012,22967
7015,10117,5155,4962,2012,22968
7016,1502,736,766,2012,22969
7017,1744,537,1207,2012,22971
7018,337,172,165,2012,22972
7019,6636,3061,3575,2012,22973
7020,5512,2175,3337,2012,22974
7021,173,97,76,2012,22976
7022,31903,14981,16922,2012,22980
7023,117,70,47,2012,22989
7024,11263,5586,5677,2012,23002
7025,652,271,381,2012,23004
7026,15069,7403,7666,2012,23005
7027,6344,3140,3204,2012,23009
7028,1285,772,513,2012,23011
7029,3830,1858,1972,2012,23015
7030,485,260,225,2012,23021
7031,663,387,276,2012,23022
7032,255,160,95,2012,23023
7033,7706,3934,3772,2012,23024
7034,183,104,79,2012,23025
7035,1234,639,595,2012,23027
7036,5063,2511,2552,2012,23030
7037,339,135,204,2012,23032
7038,1277,569,708,2012,23035
7039,1258,519,739,2012,23038
7040,1092,530,562,2012,23039
7041,4381,2294,2087,2012,23040
7042,1499,769,730,2012,23043
7043,42,21,21,2012,23045
7044,1833,863,970,2012,23047
7045,553,267,286,2012,23050
7046,1011,465,546,2012,23055
7047,340,186,154,2012,23056
7048,33363,16558,16805,2012,23059
7049,33569,16884,16685,2012,23060
7050,20129,9666,10463,2012,23061
7051,2528,1167,1361,2012,23062
7052,5675,2421,3254,2012,23063
7053,66,33,33,2012,23064
7054,1906,979,927,2012,23065
7055,599,299,300,2012,23066
7056,390,212,178,2012,23068
7057,3432,1909,1523,2012,23069
7058,895,406,489,2012,23070
7059,1428,746,682,2012,23071
7060,12561,6370,6191,2012,23072
7061,10495,4740,5755,2012,23075
7062,691,365,326,2012,23076
7063,346,151,195,2012,23079
7064,1079,509,570,2012,23083
7065,1525,786,739,2012,23084
7066,343,221,122,2012,23085
7067,2810,1417,1393,2012,23086
7068,5003,2508,2495,2012,23089
7069,212,99,113,2012,23091
7070,605,296,309,2012,23092
7071,12887,6210,6677,2012,23093
7072,3184,2053,1131,2012,23102
7073,4301,2010,2291,2012,23103
7074,1144,614,530,2012,23106
7075,213,107,106,2012,23108
7076,2357,1115,1242,2012,23109
7077,554,317,237,2012,23110
7078,36509,17311,19198,2012,23111
7079,48386,23783,24603,2012,23112
7080,23672,11283,12389,2012,23113
7081,18559,9079,9480,2012,23114
7082,196,124,72,2012,23115
7083,27917,13890,14027,2012,23116
7084,10056,4897,5159,2012,23117
7085,155,69,86,2012,23119
7086,5753,2818,2935,2012,23120
7087,1360,461,899,2012,23123
7088,3234,1686,1548,2012,23124
7089,93,48,45,2012,23125
7090,420,190,230,2012,23126
7091,1190,642,548,2012,23128
7092,278,143,135,2012,23129
7093,303,67,236,2012,23130
7094,545,298,247,2012,23138
7095,23170,11485,11685,2012,23139
7096,5573,2709,2864,2012,23140
7097,6223,3257,2966,2012,23141
7098,3040,1399,1641,2012,23146
7099,2024,1067,957,2012,23148
7100,2630,1433,1197,2012,23149
7101,11928,5606,6322,2012,23150
7102,1136,584,552,2012,23153
7103,1944,785,1159,2012,23156
7104,3818,3762,56,2012,23160
7105,64,35,29,2012,23161
7106,345,105,240,2012,23163
7107,6480,2994,3486,2012,23168
7108,1572,780,792,2012,23169
7109,2342,1188,1154,2012,23173
7110,1455,720,735,2012,23175
7111,639,259,380,2012,23176
7112,830,467,363,2012,23177
7113,647,343,304,2012,23180
7114,5389,2465,2924,2012,23181
7115,45675,21964,23711,2012,23185
7116,148,74,74,2012,23187
7117,39005,18615,20390,2012,23188
7118,6907,3570,3337,2012,23192
7119,3295,1495,1800,2012,23219
7120,34996,16667,18329,2012,23220
7121,14199,7242,6957,2012,23221
7122,25911,11638,14273,2012,23222
7123,47951,22084,25867,2012,23223
7124,35356,17133,18223,2012,23224
7125,38296,17384,20912,2012,23225
7126,14987,7195,7792,2012,23226
7127,24844,11182,13662,2012,23227
7128,33710,15618,18092,2012,23228
7129,32637,15472,17165,2012,23229
7130,5546,2608,2938,2012,23230
7131,34384,16297,18087,2012,23231
7132,28612,13749,14863,2012,23233
7133,42265,19943,22322,2012,23234
7134,30251,14376,15875,2012,23235
7135,26509,13023,13486,2012,23236
7136,21326,10481,10845,2012,23237
7137,25251,11567,13684,2012,23238
7138,0,0,0,2012,23250
7139,17163,8224,8939,2012,23294
7140,1698,817,881,2012,23301
7141,46,17,29,2012,23302
7142,775,426,349,2012,23303
7143,141,74,67,2012,23304
7144,943,457,486,2012,23306
7145,782,389,393,2012,23307
7146,2177,934,1243,2012,23308
7147,4760,2278,2482,2012,23310
7148,146,98,48,2012,23313
7149,7043,3523,3520,2012,23314
7150,1583,685,898,2012,23315
7151,182,75,107,2012,23316
7152,51650,24138,27512,2012,23320
7153,34777,16341,18436,2012,23321
7154,61369,32211,29158,2012,23322
7155,34489,16658,17831,2012,23323
7156,23502,11214,12288,2012,23324
7157,17492,8053,9439,2012,23325
7158,3017,1500,1517,2012,23336
7159,289,142,147,2012,23337
7160,619,456,163,2012,23347
7161,3547,1561,1986,2012,23350
7162,196,75,121,2012,23354
7163,806,392,414,2012,23356
7164,765,436,329,2012,23357
7165,28,16,12,2012,23358
7166,1123,617,506,2012,23359
7167,85,46,39,2012,23389
7168,267,161,106,2012,23395
7169,18,9,9,2012,23398
7170,117,64,53,2012,23401
7171,1145,665,480,2012,23405
7172,436,216,220,2012,23407
7173,36,17,19,2012,23408
7174,20,8,12,2012,23409
7175,2239,951,1288,2012,23410
7176,809,345,464,2012,23413
7177,241,101,140,2012,23414
7178,1677,837,840,2012,23415
7179,456,233,223,2012,23416
7180,4411,2210,2201,2012,23417
7181,890,405,485,2012,23418
7182,2917,1371,1546,2012,23420
7183,4614,2109,2505,2012,23421
7184,215,85,130,2012,23422
7185,260,112,148,2012,23423
7186,187,87,100,2012,23426
7187,254,126,128,2012,23427
7188,16920,8314,8606,2012,23430
7189,1269,599,670,2012,23432
7190,868,380,488,2012,23433
7191,47448,22583,24865,2012,23434
7192,26688,12995,13693,2012,23435
7193,1149,598,551,2012,23436
7194,4765,2377,2388,2012,23437
7195,1983,927,1056,2012,23438
7196,520,270,250,2012,23440
7197,187,151,36,2012,23441
7198,1405,719,686,2012,23442
7199,42293,21101,21192,2012,23451
7200,59180,28326,30854,2012,23452
7201,35244,17531,17713,2012,23453
7202,63520,31302,32218,2012,23454
7203,47678,23724,23954,2012,23455
7204,51483,25706,25777,2012,23456
7205,4188,2011,2177,2012,23457
7206,1052,577,475,2012,23459
7207,678,581,97,2012,23460
7208,152,132,20,2012,23461
7209,60583,29238,31345,2012,23462
7210,73477,35256,38221,2012,23464
7211,264,133,131,2012,23480
7212,168,85,83,2012,23486
7213,6499,3240,3259,2012,23487
7214,125,81,44,2012,23488
7215,23363,11217,12146,2012,23502
7216,36357,20189,16168,2012,23503
7217,22914,10321,12593,2012,23504
7218,30925,16428,14497,2012,23505
7219,7495,3891,3604,2012,23507
7220,20170,11406,8764,2012,23508
7221,12725,6080,6645,2012,23509
7222,6987,3780,3207,2012,23510
7223,8331,6815,1516,2012,23511
7224,31343,14577,16766,2012,23513
7225,4299,2077,2222,2012,23517
7226,30487,15373,15114,2012,23518
7227,7264,3364,3900,2012,23523
7228,396,279,117,2012,23551
7229,24140,11082,13058,2012,23601
7230,40345,19589,20756,2012,23602
7231,3901,1993,1908,2012,23603
7232,7279,4655,2624,2012,23604
7233,13687,6488,7199,2012,23605
7234,27710,13781,13929,2012,23606
7235,23988,11122,12866,2012,23607
7236,43791,20703,23088,2012,23608
7237,540,311,229,2012,23651
7238,13709,6753,6956,2012,23661
7239,12110,5910,6200,2012,23662
7240,16844,7721,9123,2012,23663
7241,8526,3964,4562,2012,23664
7242,5262,2842,2420,2012,23665
7243,49149,24317,24832,2012,23666
7244,43230,19765,23465,2012,23669
7245,3437,1966,1471,2012,23690
7246,189,77,112,2012,23691
7247,18546,8769,9777,2012,23692
7248,23807,11829,11978,2012,23693
7249,3733,1864,1869,2012,23696
7250,23018,11158,11860,2012,23701
7251,11356,5766,5590,2012,23702
7252,27751,13622,14129,2012,23703
7253,18353,8557,9796,2012,23704
7254,14939,6649,8290,2012,23707
7255,332,325,7,2012,23708
7256,37,37,0,2012,23709
7257,5346,2961,2385,2012,23801
7258,40988,19874,21114,2012,23803
7259,19228,9265,9963,2012,23805
7260,2109,902,1207,2012,23806
7261,1413,639,774,2012,23821
7262,7599,4039,3560,2012,23824
7263,1500,726,774,2012,23827
7264,452,225,227,2012,23828
7265,2375,1914,461,2012,23829
7266,1149,542,607,2012,23830
7267,32354,15068,17286,2012,23831
7268,32830,15970,16860,2012,23832
7269,2361,1190,1171,2012,23833
7270,25573,12111,13462,2012,23834
7271,11376,5437,5939,2012,23836
7272,4373,2213,2160,2012,23837
7273,15453,7378,8075,2012,23838
7274,759,380,379,2012,23839
7275,1734,726,1008,2012,23840
7276,3974,1687,2287,2012,23841
7277,7219,3994,3225,2012,23842
7278,544,271,273,2012,23843
7279,812,330,482,2012,23844
7280,422,133,289,2012,23845
7281,529,274,255,2012,23846
7282,16087,9574,6513,2012,23847
7283,623,293,330,2012,23850
7284,13820,6105,7715,2012,23851
7285,965,427,538,2012,23856
7286,546,275,271,2012,23857
7287,30583,16134,14449,2012,23860
7288,2172,1084,1088,2012,23866
7289,2874,1224,1650,2012,23867
7290,7347,4281,3066,2012,23868
7291,2345,1026,1319,2012,23872
7292,1029,502,527,2012,23874
7293,10779,5048,5731,2012,23875
7294,549,281,268,2012,23876
7295,1121,571,550,2012,23878
7296,1027,505,522,2012,23879
7297,1975,887,1088,2012,23881
7298,2348,1131,1217,2012,23882
7299,2987,1530,1457,2012,23883
7300,64,43,21,2012,23884
7301,2531,1337,1194,2012,23885
7302,410,207,203,2012,23887
7303,2152,1056,1096,2012,23888
7304,485,192,293,2012,23889
7305,5074,3046,2028,2012,23890
7306,1401,1376,25,2012,23891
7307,156,67,89,2012,23893
7308,499,194,305,2012,23894
7309,373,164,209,2012,23897
7310,2132,1028,1104,2012,23898
7311,357,197,160,2012,23899
7312,16788,8064,8724,2012,23901
7313,1627,572,1055,2012,23909
7314,818,617,201,2012,23915
7315,3859,2394,1465,2012,23917
7316,2198,1035,1163,2012,23919
7317,3871,2001,1870,2012,23920
7318,1305,731,574,2012,23921
7319,1998,1310,688,2012,23922
7320,2701,1180,1521,2012,23923
7321,7335,3171,4164,2012,23924
7322,3897,1887,2010,2012,23927
7323,6598,2911,3687,2012,23930
7324,850,408,442,2012,23934
7325,9628,6248,3380,2012,23936
7326,2171,1053,1118,2012,23937
7327,306,96,210,2012,23938
7328,1078,581,497,2012,23942
7329,295,273,22,2012,23943
7330,4610,2118,2492,2012,23944
7331,3760,1889,1871,2012,23947
7332,3967,1993,1974,2012,23950
7333,147,75,72,2012,23952
7334,2112,1185,927,2012,23954
7335,3022,1528,1494,2012,23958
7336,1219,618,601,2012,23959
7337,2000,1106,894,2012,23960
7338,277,133,144,2012,23962
7339,411,241,170,2012,23963
7340,1280,729,551,2012,23964
7341,1998,904,1094,2012,23966
7342,925,493,432,2012,23967
7343,659,288,371,2012,23968
7344,8639,4041,4598,2012,23970
7345,5079,3000,2079,2012,23974
7346,152,73,79,2012,23976
7347,149,67,82,2012,24011
7348,29604,14521,15083,2012,24012
7349,8484,4165,4319,2012,24013
7350,16586,7707,8879,2012,24014
7351,15594,7599,7995,2012,24015
7352,8549,4176,4373,2012,24016
7353,23323,10893,12430,2012,24017
7354,37339,17635,19704,2012,24018
7355,26840,12682,14158,2012,24019
7356,389,0,389,2012,24020
7357,2951,1682,1269,2012,24053
7358,6645,3256,3389,2012,24054
7359,13399,6729,6670,2012,24055
7360,357,172,185,2012,24058
7361,723,323,400,2012,24059
7362,53205,29086,24119,2012,24060
7363,4418,2206,2212,2012,24064
7364,5828,2861,2967,2012,24065
7365,4749,2367,2382,2012,24066
7366,2594,1289,1305,2012,24067
7367,1858,990,868,2012,24069
7368,1566,763,803,2012,24070
7369,1217,500,717,2012,24072
7370,28598,13625,14973,2012,24073
7371,1220,679,541,2012,24076
7372,1292,589,703,2012,24077
7373,7543,3325,4218,2012,24078
7374,1534,788,746,2012,24079
7375,390,247,143,2012,24082
7376,2208,1143,1065,2012,24083
7377,11754,5901,5853,2012,24084
7378,2044,1035,1009,2012,24085
7379,171,65,106,2012,24086
7380,4837,2276,2561,2012,24087
7381,5070,2767,2303,2012,24088
7382,2765,1285,1480,2012,24089
7383,4691,2020,2671,2012,24090
7384,7334,3392,3942,2012,24091
7385,2738,1291,1447,2012,24092
7386,160,74,86,2012,24093
7387,4085,2026,2059,2012,24095
7388,6496,3118,3378,2012,24101
7389,1916,943,973,2012,24102
7390,3491,1584,1907,2012,24104
7391,881,448,433,2012,24105
7392,32610,15113,17497,2012,24112
7393,2006,1083,923,2012,24120
7394,9676,4802,4874,2012,24121
7395,1721,892,829,2012,24122
7396,4602,2327,2275,2012,24124
7397,4331,2114,2217,2012,24127
7398,1573,791,782,2012,24128
7399,0,0,0,2012,24130
7400,27,15,12,2012,24131
7401,404,191,213,2012,24132
7402,2687,1190,1497,2012,24133
7403,5603,2866,2737,2012,24134
7404,3607,1705,1902,2012,24136
7405,2565,1259,1306,2012,24137
7406,1626,861,765,2012,24138
7407,666,334,332,2012,24139
7408,20925,10204,10721,2012,24141
7409,2967,1204,1763,2012,24142
7410,1164,570,594,2012,24147
7411,7689,3663,4026,2012,24148
7412,3667,2016,1651,2012,24149
7413,815,411,404,2012,24150
7414,19756,9369,10387,2012,24151
7415,36110,17151,18959,2012,24153
7416,224,84,140,2012,24161
7417,2043,1077,966,2012,24162
7418,1324,667,657,2012,24165
7419,179,47,132,2012,24167
7420,242,106,136,2012,24168
7421,7567,3550,4017,2012,24171
7422,2541,1408,1133,2012,24174
7423,9915,5047,4868,2012,24175
7424,1823,984,839,2012,24176
7425,18773,8970,9803,2012,24179
7426,4845,2506,2339,2012,24184
7427,1204,647,557,2012,24185
7428,16897,7873,9024,2012,24201
7429,13140,6865,6275,2012,24202
7430,16195,7940,8255,2012,24210
7431,10217,4866,5351,2012,24211
7432,3110,1419,1691,2012,24216
7433,519,261,258,2012,24217
7434,11682,6454,5228,2012,24219
7435,805,430,375,2012,24220
7436,1064,583,481,2012,24221
7437,7234,3601,3633,2012,24224
7438,1732,862,870,2012,24225
7439,1443,701,742,2012,24226
7440,6863,3426,3437,2012,24228
7441,8859,4611,4248,2012,24230
7442,3093,1349,1744,2012,24236
7443,1121,614,507,2012,24237
7444,119,41,78,2012,24239
7445,2343,1203,1140,2012,24243
7446,5393,2787,2606,2012,24244
7447,1262,613,649,2012,24245
7448,398,82,316,2012,24246
7449,2696,1359,1337,2012,24248
7450,1135,536,599,2012,24250
7451,8747,4512,4235,2012,24251
7452,3685,1840,1845,2012,24256
7453,1654,731,923,2012,24258
7454,6437,2875,3562,2012,24260
7455,6364,3047,3317,2012,24263
7456,1134,573,561,2012,24265
7457,8711,4432,4279,2012,24266
7458,599,276,323,2012,24269
7459,703,384,319,2012,24270
7460,2481,1105,1376,2012,24271
7461,407,219,188,2012,24272
7462,6596,2976,3620,2012,24273
7463,6978,4131,2847,2012,24277
7464,5946,3345,2601,2012,24279
7465,756,421,335,2012,24280
7466,2498,1346,1152,2012,24281
7467,589,280,309,2012,24282
7468,2406,1162,1244,2012,24283
7469,2325,1200,1125,2012,24290
7470,540,262,278,2012,24292
7471,9916,4820,5096,2012,24293
7472,13802,6818,6984,2012,24301
7473,2002,1001,1001,2012,24311
7474,2539,1299,1240,2012,24312
7475,1035,488,547,2012,24313
7476,1718,947,771,2012,24314
7477,3661,2279,1382,2012,24315
7478,23,12,11,2012,24316
7479,4391,2171,2220,2012,24317
7480,632,266,366,2012,24318
7481,7593,3544,4049,2012,24319
7482,222,35,187,2012,24322
7483,681,270,411,2012,24323
7484,1975,1005,970,2012,24324
7485,1199,713,486,2012,24325
7486,897,463,434,2012,24326
7487,1687,691,996,2012,24328
7488,3817,1874,1943,2012,24330
7489,17540,8566,8974,2012,24333
7490,5693,2789,2904,2012,24340
7491,8898,4421,4477,2012,24343
7492,1826,978,848,2012,24347
7493,4294,2170,2124,2012,24348
7494,1189,697,492,2012,24350
7495,599,302,297,2012,24351
7496,944,510,434,2012,24352
7497,15304,7640,7664,2012,24354
7498,6626,3404,3222,2012,24360
7499,5146,2422,2724,2012,24361
7500,1182,563,619,2012,24363
7501,567,286,281,2012,24366
7502,4640,2431,2209,2012,24368
7503,6072,2895,3177,2012,24370
7504,1182,522,660,2012,24374
7505,1571,845,726,2012,24375
7506,361,208,153,2012,24377
7507,1364,544,820,2012,24378
7508,2260,1210,1050,2012,24380
7509,3294,1507,1787,2012,24381
7510,13303,6371,6932,2012,24382
7511,35403,16318,19085,2012,24401
7512,116,60,56,2012,24411
7513,155,85,70,2012,24412
7514,170,90,80,2012,24413
7515,94,19,75,2012,24415
7516,8809,4225,4584,2012,24416
7517,3664,1723,1941,2012,24421
7518,6566,3107,3459,2012,24422
7519,14140,7050,7090,2012,24426
7520,4788,3849,939,2012,24430
7521,2713,1321,1392,2012,24431
7522,300,128,172,2012,24432
7523,46,26,20,2012,24433
7524,2457,1200,1257,2012,24435
7525,1026,560,466,2012,24437
7526,1203,541,662,2012,24439
7527,2548,1265,1283,2012,24440
7528,6575,3107,3468,2012,24441
7529,175,81,94,2012,24442
7530,2229,1148,1081,2012,24445
7531,434,210,224,2012,24448
7532,16467,9225,7242,2012,24450
7533,293,161,132,2012,24457
7534,387,176,211,2012,24458
7535,929,508,421,2012,24459
7536,1292,649,643,2012,24460
7537,281,148,133,2012,24464
7538,1458,680,778,2012,24465
7539,1972,1086,886,2012,24467
7540,971,475,496,2012,24471
7541,1395,731,664,2012,24472
7542,988,447,541,2012,24473
7543,669,386,283,2012,24474
7544,288,160,128,2012,24476
7545,9687,4746,4941,2012,24477
7546,1323,808,515,2012,24479
7547,4695,2346,2349,2012,24482
7548,1089,502,587,2012,24483
7549,1236,530,706,2012,24484
7550,407,190,217,2012,24485
7551,3217,1532,1685,2012,24486
7552,277,110,167,2012,24487
7553,26458,11550,14908,2012,24501
7554,44312,21444,22868,2012,24502
7555,19394,9216,10178,2012,24503
7556,10864,5307,5557,2012,24504
7557,5615,2293,3322,2012,24517
7558,2057,917,1140,2012,24520
7559,10499,5083,5416,2012,24521
7560,9729,4684,5045,2012,24522
7561,18527,8811,9716,2012,24523
7562,1240,580,660,2012,24526
7563,2902,1415,1487,2012,24527
7564,3291,1678,1613,2012,24528
7565,1381,712,669,2012,24529
7566,1174,629,545,2012,24530
7567,9468,4833,4635,2012,24531
7568,1546,694,852,2012,24534
7569,150,53,97,2012,24536
7570,4409,2293,2116,2012,24538
7571,39,27,12,2012,24539
7572,31329,14768,16561,2012,24540
7573,28936,13410,15526,2012,24541
7574,4818,2311,2507,2012,24549
7575,7391,3748,3643,2012,24550
7576,21439,10815,10624,2012,24551
7577,2516,1321,1195,2012,24553
7578,3515,1731,1784,2012,24554
7579,2365,1204,1161,2012,24555
7580,3537,1824,1713,2012,24556
7581,7744,3517,4227,2012,24557
7582,7255,3399,3856,2012,24558
7583,560,334,226,2012,24562
7584,5404,2741,2663,2012,24563
7585,1186,627,559,2012,24565
7586,1547,740,807,2012,24566
7587,1204,716,488,2012,24569
7588,0,0,0,2012,24570
7589,1744,822,922,2012,24571
7590,15643,7410,8233,2012,24572
7591,3996,2095,1901,2012,24574
7592,4988,2549,2439,2012,24577
7593,767,336,431,2012,24578
7594,1459,582,877,2012,24579
7595,619,356,263,2012,24580
7596,0,0,0,2012,24581
7597,5560,2557,3003,2012,24586
7598,9016,4443,4573,2012,24588
7599,2172,1128,1044,2012,24589
7600,8046,3665,4381,2012,24590
7601,14313,6744,7569,2012,24592
7602,1827,903,924,2012,24593
7603,1400,718,682,2012,24594
7604,787,29,758,2012,24595
7605,1036,484,552,2012,24597
7606,2004,964,1040,2012,24598
7607,402,199,203,2012,24599
7608,47,15,32,2012,24601
7609,968,504,464,2012,24602
7610,1202,659,543,2012,24603
7611,447,98,349,2012,24604
7612,8622,4181,4441,2012,24605
7613,391,219,172,2012,24606
7614,395,159,236,2012,24607
7615,6695,3078,3617,2012,24609
7616,104,50,54,2012,24612
7617,535,273,262,2012,24613
7618,7751,3844,3907,2012,24614
7619,3606,1699,1907,2012,24620
7620,1139,575,564,2012,24622
7621,139,78,61,2012,24628
7622,7427,3705,3722,2012,24630
7623,2040,1215,825,2012,24631
7624,679,348,331,2012,24634
7625,1112,784,328,2012,24635
7626,3941,1989,1952,2012,24637
7627,4615,2625,1990,2012,24639
7628,5966,2820,3146,2012,24641
7629,641,293,348,2012,24646
7630,2821,1446,1375,2012,24649
7631,5702,2755,2947,2012,24651
7632,3278,1670,1608,2012,24656
7633,404,191,213,2012,24657
7634,20815,9841,10974,2012,24701
7635,1818,765,1053,2012,24712
7636,227,127,100,2012,24714
7637,641,297,344,2012,24715
7638,321,188,133,2012,24716
7639,393,196,197,2012,24719
7640,104,38,66,2012,24724
7641,329,178,151,2012,24726
7642,138,69,69,2012,24729
7643,254,148,106,2012,24731
7644,573,228,345,2012,24733
7645,1008,452,556,2012,24736
7646,137,73,64,2012,24737
7647,282,146,136,2012,24738
7648,31143,14934,16209,2012,24740
7649,2764,1301,1463,2012,24747
7650,4239,2065,2174,2012,24801
7651,731,331,400,2012,24808
7652,325,139,186,2012,24811
7653,484,215,269,2012,24813
7654,530,250,280,2012,24815
7655,70,35,35,2012,24816
7656,960,506,454,2012,24817
7657,1816,891,925,2012,24818
7658,675,424,251,2012,24822
7659,535,254,281,2012,24823
7660,351,196,155,2012,24826
7661,1529,687,842,2012,24827
7662,942,479,463,2012,24828
7663,109,42,67,2012,24830
7664,161,74,87,2012,24831
7665,535,273,262,2012,24834
7666,734,363,371,2012,24836
7667,1180,557,623,2012,24839
7668,137,75,62,2012,24843
7669,1778,847,931,2012,24844
7670,164,79,85,2012,24845
7671,151,86,65,2012,24846
7672,262,174,88,2012,24847
7673,138,84,54,2012,24848
7674,362,191,171,2012,24849
7675,824,334,490,2012,24850
7676,343,179,164,2012,24851
7677,897,411,486,2012,24853
7678,549,286,263,2012,24854
7679,667,346,321,2012,24857
7680,515,229,286,2012,24860
7681,364,213,151,2012,24861
7682,529,270,259,2012,24862
7683,72,39,33,2012,24866
7684,341,173,168,2012,24867
7685,2012,926,1086,2012,24868
7686,443,198,245,2012,24869
7687,3372,1645,1727,2012,24870
7688,188,82,106,2012,24871
7689,699,412,287,2012,24872
7690,502,247,255,2012,24873
7691,2458,1143,1315,2012,24874
7692,488,314,174,2012,24878
7693,704,313,391,2012,24879
7694,166,91,75,2012,24880
7695,576,302,274,2012,24881
7696,649,416,233,2012,24882
7697,389,188,201,2012,24884
7698,155,98,57,2012,24887
7699,251,100,151,2012,24888
7700,1548,794,754,2012,24892
7701,182,78,104,2012,24894
7702,124,74,50,2012,24898
7703,8896,4362,4534,2012,24901
7704,4948,1797,3151,2012,24910
7705,398,180,218,2012,24915
7706,721,386,335,2012,24916
7707,1602,763,839,2012,24918
7708,398,191,207,2012,24920
7709,268,136,132,2012,24924
7710,860,489,371,2012,24925
7711,308,163,145,2012,24927
7712,1511,669,842,2012,24931
7713,379,234,145,2012,24934
7714,655,334,321,2012,24935
7715,1494,688,806,2012,24938
7716,1459,713,746,2012,24941
7717,610,312,298,2012,24944
7718,555,312,243,2012,24945
7719,1660,944,716,2012,24946
7720,1383,656,727,2012,24951
7721,3786,1813,1973,2012,24954
7722,296,132,164,2012,24957
7723,101,59,42,2012,24962
7724,3340,1708,1632,2012,24963
7725,1064,569,495,2012,24966
7726,4833,2226,2607,2012,24970
7727,261,172,89,2012,24974
7728,1403,764,639,2012,24976
7729,436,236,200,2012,24977
7730,807,388,419,2012,24981
7731,2630,1292,1338,2012,24983
7732,139,49,90,2012,24984
7733,5672,2729,2943,2012,24986
7734,773,430,343,2012,24991
7735,222,121,101,2012,25002
7736,2364,1240,1124,2012,25003
7737,202,81,121,2012,25005
7738,366,155,211,2012,25007
7739,252,129,123,2012,25008
7740,1186,486,700,2012,25009
7741,1044,668,376,2012,25011
7742,4538,2240,2298,2012,25015
7743,545,297,248,2012,25019
7744,342,147,195,2012,25021
7745,59,30,29,2012,25022
7746,805,422,383,2012,25024
7747,166,67,99,2012,25025
7748,262,122,140,2012,25028
7749,421,253,168,2012,25030
7750,1089,507,582,2012,25031
7751,1835,945,890,2012,25033
7752,1082,580,502,2012,25035
7753,993,796,197,2012,25036
7754,1346,648,698,2012,25039
7755,570,252,318,2012,25040
7756,1749,915,834,2012,25043
7757,404,215,189,2012,25044
7758,6016,2886,3130,2012,25045
7759,440,267,173,2012,25047
7760,13,0,13,2012,25048
7761,725,433,292,2012,25049
7762,78,43,35,2012,25051
7763,4674,2341,2333,2012,25053
7764,282,147,135,2012,25054
7765,183,80,103,2012,25057
7766,524,241,283,2012,25059
7767,616,326,290,2012,25060
7768,279,139,140,2012,25061
7769,143,65,78,2012,25062
7770,1707,825,882,2012,25063
7771,9542,4342,5200,2012,25064
7772,1362,657,705,2012,25067
7773,2216,1104,1112,2012,25070
7774,11457,5609,5848,2012,25071
7775,659,361,298,2012,25075
7776,257,95,162,2012,25076
7777,1376,715,661,2012,25081
7778,1763,899,864,2012,25082
7779,714,331,383,2012,25083
7780,968,510,458,2012,25085
7781,808,401,407,2012,25086
7782,88,28,60,2012,25088
7783,142,54,88,2012,25090
7784,191,106,85,2012,25093
7785,329,182,147,2012,25102
7786,173,105,68,2012,25103
7787,600,268,332,2012,25106
7788,431,184,247,2012,25107
7789,433,171,262,2012,25108
7790,496,207,289,2012,25109
7791,774,314,460,2012,25110
7792,701,364,337,2012,25111
7793,93,54,39,2012,25112
7794,896,443,453,2012,25113
7795,529,237,292,2012,25114
7796,211,106,105,2012,25115
7797,1237,594,643,2012,25118
7798,631,285,346,2012,25119
7799,778,378,400,2012,25121
7800,3478,1653,1825,2012,25123
7801,1201,573,628,2012,25124
7802,878,500,378,2012,25125
7803,10,10,0,2012,25126
7804,3469,1671,1798,2012,25130
7805,657,343,314,2012,25132
7806,883,388,495,2012,25133
7807,419,267,152,2012,25134
7808,2463,1394,1069,2012,25136
7809,305,146,159,2012,25139
7810,1127,565,562,2012,25140
7811,342,195,147,2012,25141
7812,400,180,220,2012,25142
7813,8614,3932,4682,2012,25143
7814,103,50,53,2012,25148
7815,298,130,168,2012,25149
7816,326,182,144,2012,25152
7817,804,421,383,2012,25154
7818,147,99,48,2012,25156
7819,5311,2228,3083,2012,25159
7820,187,76,111,2012,25160
7821,347,163,184,2012,25161
7822,489,252,237,2012,25162
7823,1311,603,708,2012,25164
7824,479,249,230,2012,25165
7825,2603,1403,1200,2012,25168
7826,461,182,279,2012,25169
7827,327,148,179,2012,25173
7828,543,257,286,2012,25174
7829,24830,11579,13251,2012,25177
7830,165,75,90,2012,25180
7831,2253,1065,1188,2012,25181
7832,0,0,0,2012,25183
7833,517,517,0,2012,25185
7834,1068,465,603,2012,25186
7835,699,377,322,2012,25187
7836,631,346,285,2012,25193
7837,31,15,16,2012,25201
7838,1043,418,625,2012,25202
7839,90,47,43,2012,25203
7840,384,235,149,2012,25204
7841,185,87,98,2012,25205
7842,474,207,267,2012,25206
7843,909,478,431,2012,25208
7844,1290,548,742,2012,25209
7845,147,60,87,2012,25211
7846,5519,2706,2813,2012,25213
7847,559,353,206,2012,25214
7848,1724,841,883,2012,25234
7849,785,392,393,2012,25235
7850,1798,853,945,2012,25239
7851,1429,765,664,2012,25241
7852,805,400,405,2012,25243
7853,595,274,321,2012,25244
7854,696,342,354,2012,25245
7855,698,413,285,2012,25247
7856,3580,1853,1727,2012,25248
7857,588,294,294,2012,25251
7858,985,596,389,2012,25252
7859,2093,989,1104,2012,25253
7860,742,282,460,2012,25259
7861,1841,915,926,2012,25260
7862,317,158,159,2012,25261
7863,1316,725,591,2012,25262
7864,382,188,194,2012,25264
7865,1558,730,828,2012,25265
7866,1054,613,441,2012,25266
7867,495,211,284,2012,25267
7868,714,361,353,2012,25268
7869,1030,486,544,2012,25270
7870,9381,4585,4796,2012,25271
7871,2248,1180,1068,2012,25275
7872,7120,3399,3721,2012,25276
7873,473,219,254,2012,25285
7874,1638,878,760,2012,25286
7875,1065,340,725,2012,25287
7876,2439,1020,1419,2012,25301
7877,14932,7184,7748,2012,25302
7878,7200,3440,3760,2012,25303
7879,9216,4034,5182,2012,25304
7880,0,0,0,2012,25305
7881,6425,3088,3337,2012,25306
7882,12275,5946,6329,2012,25309
7883,9980,4900,5080,2012,25311
7884,14630,7525,7105,2012,25312
7885,13127,6196,6931,2012,25313
7886,16250,7824,8426,2012,25314
7887,3454,1560,1894,2012,25315
7888,7230,3608,3622,2012,25320
7889,14970,7267,7703,2012,25401
7890,13051,6328,6723,2012,25403
7891,20504,9871,10633,2012,25404
7892,11424,5639,5785,2012,25405
7893,12281,6287,5994,2012,25411
7894,7617,3931,3686,2012,25413
7895,17581,8350,9231,2012,25414
7896,9669,4781,4888,2012,25419
7897,4012,2174,1838,2012,25420
7898,1914,913,1001,2012,25422
7899,12184,6319,5865,2012,25425
7900,13699,6932,6767,2012,25427
7901,9615,4456,5159,2012,25428
7902,8721,4545,4176,2012,25430
7903,301,126,175,2012,25431
7904,225,120,105,2012,25432
7905,2805,1439,1366,2012,25434
7906,282,153,129,2012,25437
7907,6295,3185,3110,2012,25438
7908,1714,758,956,2012,25442
7909,7024,3410,3614,2012,25443
7910,250,126,124,2012,25444
7911,1754,969,785,2012,25446
7912,1442,782,660,2012,25501
7913,1226,690,536,2012,25502
7914,438,190,248,2012,25503
7915,13156,6545,6611,2012,25504
7916,397,171,226,2012,25505
7917,4893,2404,2489,2012,25506
7918,1094,538,556,2012,25507
7919,9567,4781,4786,2012,25508
7920,5162,2666,2496,2012,25510
7921,1078,443,635,2012,25511
7922,1319,670,649,2012,25512
7923,3744,1706,2038,2012,25514
7924,2633,1319,1314,2012,25515
7925,2467,1215,1252,2012,25517
7926,1397,752,645,2012,25520
7927,1012,480,532,2012,25521
7928,2626,1201,1425,2012,25523
7929,3267,1707,1560,2012,25524
7930,21926,10543,11383,2012,25526
7931,1357,812,545,2012,25529
7932,5550,2542,3008,2012,25530
7933,231,120,111,2012,25534
7934,2852,1516,1336,2012,25535
7935,1512,704,808,2012,25537
7936,183,84,99,2012,25540
7937,8785,4171,4614,2012,25541
7938,4758,2383,2375,2012,25545
7939,1238,648,590,2012,25547
7940,9154,4476,4678,2012,25550
7941,2065,1105,960,2012,25555
7942,1415,680,735,2012,25557
7943,2132,1108,1024,2012,25559
7944,8080,3997,4083,2012,25560
7945,1287,618,669,2012,25564
7946,465,203,262,2012,25565
7947,1304,595,709,2012,25567
7948,7043,3419,3624,2012,25570
7949,2462,1149,1313,2012,25571
7950,932,482,450,2012,25573
7951,5554,2598,2956,2012,25601
7952,816,394,422,2012,25606
7953,1077,489,588,2012,25607
7954,1124,547,577,2012,25608
7955,562,255,307,2012,25611
7956,683,304,379,2012,25617
7957,2483,1214,1269,2012,25621
7958,210,108,102,2012,25624
7959,1616,976,640,2012,25625
7960,396,176,220,2012,25628
7961,964,481,483,2012,25630
7962,1127,618,509,2012,25632
7963,897,473,424,2012,25634
7964,1397,716,681,2012,25635
7965,982,473,509,2012,25637
7966,1435,691,744,2012,25638
7967,574,368,206,2012,25639
7968,389,189,200,2012,25644
7969,1025,534,491,2012,25646
7970,767,422,345,2012,25647
7971,813,373,440,2012,25649
7972,789,347,442,2012,25650
7973,470,222,248,2012,25651
7974,1550,631,919,2012,25652
7975,600,299,301,2012,25653
7976,189,111,78,2012,25654
7977,6118,2937,3181,2012,25661
7978,855,479,376,2012,25666
7979,865,433,432,2012,25669
7980,7242,3667,3575,2012,25670
7981,1090,569,521,2012,25671
7982,218,139,79,2012,25672
7983,2269,1031,1238,2012,25674
7984,924,475,449,2012,25676
7985,2039,952,1087,2012,25678
7986,337,138,199,2012,25688
7987,175,79,96,2012,25690
7988,883,372,511,2012,25692
7989,88,45,43,2012,25696
7990,58,36,22,2012,25699
7991,23903,11711,12192,2012,25701
7992,8048,3761,4287,2012,25702
7993,6396,2883,3513,2012,25703
7994,16280,8184,8096,2012,25704
7995,20684,10121,10563,2012,25705
7996,33458,16265,17193,2012,25801
7997,80,49,31,2012,25810
7998,225,97,128,2012,25811
7999,2149,1148,1001,2012,25812
8000,8414,5228,3186,2012,25813
8001,564,343,221,2012,25817
8002,611,264,347,2012,25818
8003,513,263,250,2012,25820
8004,2284,1024,1260,2012,25823
8005,2414,1290,1124,2012,25825
8006,185,86,99,2012,25826
8007,2596,1255,1341,2012,25827
8008,1256,647,609,2012,25831
8009,4159,1758,2401,2012,25832
8010,239,126,113,2012,25836
8011,314,146,168,2012,25837
8012,550,328,222,2012,25839
8013,7117,3264,3853,2012,25840
8014,675,365,310,2012,25841
8015,882,461,421,2012,25843
8016,1969,1006,963,2012,25844
8017,466,271,195,2012,25845
8018,521,213,308,2012,25846
8019,548,326,222,2012,25848
8020,484,262,222,2012,25849
8021,126,0,126,2012,25853
8022,1063,494,569,2012,25854
8023,206,80,126,2012,25855
8024,719,361,358,2012,25857
8025,208,85,123,2012,25862
8026,192,80,112,2012,25864
8027,1419,759,660,2012,25865
8028,496,231,265,2012,25868
8029,110,29,81,2012,25870
8030,554,279,275,2012,25871
8031,904,409,495,2012,25873
8032,494,242,252,2012,25875
8033,199,134,65,2012,25876
8034,800,358,442,2012,25878
8035,494,334,160,2012,25879
8036,6842,3338,3504,2012,25880
8037,2799,1341,1458,2012,25882
8038,11303,5447,5856,2012,25901
8039,533,242,291,2012,25902
8040,252,115,137,2012,25904
8041,354,152,202,2012,25906
8042,178,54,124,2012,25907
8043,18,18,0,2012,25908
8044,135,119,16,2012,25911
8045,487,224,263,2012,25913
8046,249,124,125,2012,25915
8047,123,31,92,2012,25916
8048,1922,977,945,2012,25917
8049,3741,1886,1855,2012,25918
8050,320,155,165,2012,25920
8051,1996,891,1105,2012,25921
8052,209,107,102,2012,25922
8053,429,221,208,2012,25928
8054,101,52,49,2012,25932
8055,48,28,20,2012,25936
8056,1264,609,655,2012,25938
8057,87,50,37,2012,25942
8058,6155,3007,3148,2012,25951
8059,704,334,370,2012,25958
8060,4001,2001,2000,2012,25962
8061,1327,759,568,2012,25969
8062,953,547,406,2012,25971
8063,212,137,75,2012,25972
8064,2224,1050,1174,2012,25976
8065,120,60,60,2012,25977
8066,615,232,383,2012,25978
8067,746,303,443,2012,25979
8068,1196,642,554,2012,25981
8069,2092,1060,1032,2012,25984
8070,325,196,129,2012,25985
8071,219,105,114,2012,25989
8072,43671,20990,22681,2012,26003
8073,488,231,257,2012,26030
8074,1657,770,887,2012,26031
8075,1389,813,576,2012,26032
8076,2673,1299,1374,2012,26033
8077,5040,2358,2682,2012,26034
8078,2694,1339,1355,2012,26035
8079,435,232,203,2012,26036
8080,7013,3414,3599,2012,26037
8081,2980,1340,1640,2012,26038
8082,1090,543,547,2012,26039
8083,1723,865,858,2012,26040
8084,16243,7979,8264,2012,26041
8085,6540,3281,3259,2012,26047
8086,1046,477,569,2012,26050
8087,1725,883,842,2012,26055
8088,107,47,60,2012,26056
8089,2610,1254,1356,2012,26059
8090,1780,853,927,2012,26060
8091,21586,10440,11146,2012,26062
8092,8122,3828,4294,2012,26070
8093,1100,292,808,2012,26074
8094,441,225,216,2012,26075
8095,29858,14033,15825,2012,26101
8096,17682,8234,9448,2012,26104
8097,12132,5767,6365,2012,26105
8098,1316,647,669,2012,26133
8099,1021,431,590,2012,26134
8100,534,328,206,2012,26136
8101,734,380,354,2012,26137
8102,109,75,34,2012,26138
8103,84,52,32,2012,26141
8104,2806,1461,1345,2012,26142
8105,4389,2119,2270,2012,26143
8106,800,350,450,2012,26146
8107,2032,972,1060,2012,26147
8108,219,109,110,2012,26148
8109,2700,1275,1425,2012,26149
8110,6179,3177,3002,2012,26150
8111,784,372,412,2012,26151
8112,41,14,27,2012,26152
8113,8875,4302,4573,2012,26155
8114,2691,1226,1465,2012,26159
8115,1087,637,450,2012,26160
8116,285,179,106,2012,26161
8117,8110,3767,4343,2012,26164
8118,1051,517,534,2012,26167
8119,946,508,438,2012,26169
8120,6034,3393,2641,2012,26170
8121,3536,1736,1800,2012,26175
8122,284,137,147,2012,26178
8123,1791,934,857,2012,26180
8124,5991,3075,2916,2012,26181
8125,2190,1104,1086,2012,26184
8126,6064,2952,3112,2012,26187
8127,20064,9880,10184,2012,26201
8128,641,357,284,2012,26202
8129,195,131,64,2012,26203
8130,3406,1541,1865,2012,26205
8131,2719,1318,1401,2012,26206
8132,885,425,460,2012,26208
8133,74,21,53,2012,26209
8134,273,123,150,2012,26215
8135,429,218,211,2012,26217
8136,2360,1241,1119,2012,26218
8137,361,178,183,2012,26222
8138,239,129,110,2012,26224
8139,75,55,20,2012,26228
8140,151,62,89,2012,26230
8141,1575,796,779,2012,26234
8142,11,11,0,2012,26236
8143,287,130,157,2012,26237
8144,404,195,209,2012,26238
8145,14068,6905,7163,2012,26241
8146,5336,2475,2861,2012,26250
8147,3136,1673,1463,2012,26253
8148,484,256,228,2012,26254
8149,998,406,592,2012,26257
8150,119,85,34,2012,26259
8151,1218,639,579,2012,26260
8152,3114,1407,1707,2012,26261
8153,190,94,96,2012,26263
8154,730,385,345,2012,26264
8155,207,122,85,2012,26266
8156,296,178,118,2012,26267
8157,69,23,46,2012,26268
8158,1003,546,457,2012,26269
8159,689,322,367,2012,26270
8160,381,192,189,2012,26271
8161,1515,1000,515,2012,26273
8162,643,387,256,2012,26275
8163,493,233,260,2012,26276
8164,798,411,387,2012,26278
8165,2617,1630,987,2012,26280
8166,56,41,15,2012,26282
8167,2003,972,1031,2012,26283
8168,255,138,117,2012,26285
8169,3272,1559,1713,2012,26287
8170,3906,1929,1977,2012,26288
8171,94,61,33,2012,26291
8172,723,342,381,2012,26292
8173,691,335,356,2012,26293
8174,1046,552,494,2012,26294
8175,321,171,150,2012,26296
8176,24,9,15,2012,26298
8177,29735,13932,15803,2012,26301
8178,828,474,354,2012,26320
8179,844,423,421,2012,26321
8180,671,325,346,2012,26323
8181,392,176,216,2012,26325
8182,146,61,85,2012,26327
8183,14053,6691,7362,2012,26330
8184,1412,708,704,2012,26335
8185,1383,743,640,2012,26337
8186,557,335,222,2012,26338
8187,213,165,48,2012,26339
8188,491,260,231,2012,26342
8189,481,204,277,2012,26343
8190,955,458,497,2012,26346
8191,2022,976,1046,2012,26347
8192,140,62,78,2012,26348
8193,119,75,44,2012,26349
8194,5000,3184,1816,2012,26351
8195,11027,5620,5407,2012,26354
8196,108,29,79,2012,26361
8197,3405,1774,1631,2012,26362
8198,279,131,148,2012,26366
8199,593,249,344,2012,26369
8200,700,409,291,2012,26372
8201,1651,821,830,2012,26374
8202,716,385,331,2012,26376
8203,765,368,397,2012,26377
8204,4197,2028,2169,2012,26378
8205,503,282,221,2012,26384
8206,3953,2079,1874,2012,26385
8207,2666,1509,1157,2012,26386
8208,329,107,222,2012,26404
8209,1237,695,542,2012,26405
8210,2559,1217,1342,2012,26408
8211,1253,637,616,2012,26410
8212,637,373,264,2012,26411
8213,310,159,151,2012,26412
8214,3913,1925,1988,2012,26415
8215,7409,3658,3751,2012,26416
8216,1019,479,540,2012,26419
8217,281,111,170,2012,26421
8218,607,237,370,2012,26422
8219,536,254,282,2012,26424
8220,1345,645,700,2012,26425
8221,6796,3681,3115,2012,26426
8222,677,396,281,2012,26430
8223,6019,3095,2924,2012,26431
8224,161,82,79,2012,26435
8225,56,29,27,2012,26436
8226,583,354,229,2012,26437
8227,198,114,84,2012,26438
8228,955,449,506,2012,26440
8229,232,139,93,2012,26443
8230,3486,1798,1688,2012,26444
8231,1014,480,534,2012,26447
8232,1831,931,900,2012,26448
8233,915,456,459,2012,26451
8234,9281,4548,4733,2012,26452
8235,4432,2304,2128,2012,26456
8236,19176,10221,8955,2012,26501
8237,37257,19787,17470,2012,26505
8238,31318,15309,16009,2012,26508
8239,1374,737,637,2012,26519
8240,744,302,442,2012,26520
8241,217,88,129,2012,26521
8242,6613,3878,2735,2012,26525
8243,661,348,313,2012,26534
8244,5683,2834,2849,2012,26537
8245,3259,1583,1676,2012,26541
8246,2802,1375,1427,2012,26542
8247,245,75,170,2012,26543
8248,2707,1307,1400,2012,26547
8249,40919,19697,21222,2012,26554
8250,1302,631,671,2012,26559
8251,66,30,36,2012,26560
8252,734,343,391,2012,26562
8253,461,228,233,2012,26563
8254,732,329,403,2012,26568
8255,3289,1789,1500,2012,26570
8256,1955,1112,843,2012,26571
8257,85,26,59,2012,26572
8258,560,257,303,2012,26574
8259,877,433,444,2012,26575
8260,285,152,133,2012,26576
8261,1100,618,482,2012,26581
8262,5173,2497,2676,2012,26582
8263,596,381,215,2012,26585
8264,0,0,0,2012,26586
8265,531,280,251,2012,26587
8266,2930,1443,1487,2012,26588
8267,937,535,402,2012,26590
8268,1820,884,936,2012,26591
8269,5633,3005,2628,2012,26601
8270,871,477,394,2012,26610
8271,141,87,54,2012,26611
8272,317,126,191,2012,26615
8273,104,67,37,2012,26617
8274,732,294,438,2012,26619
8275,680,383,297,2012,26621
8276,1050,578,472,2012,26623
8277,2582,1227,1355,2012,26624
8278,484,191,293,2012,26627
8279,329,162,167,2012,26629
8280,260,118,142,2012,26631
8281,499,291,208,2012,26636
8282,223,100,123,2012,26638
8283,10022,5090,4932,2012,26651
8284,404,207,197,2012,26656
8285,321,115,206,2012,26660
8286,958,329,629,2012,26662
8287,689,440,249,2012,26676
8288,1315,612,703,2012,26678
8289,1777,935,842,2012,26679
8290,181,102,79,2012,26680
8291,1421,668,753,2012,26681
8292,0,0,0,2012,26684
8293,670,338,332,2012,26690
8294,469,210,259,2012,26691
8295,5935,3119,2816,2012,26704
8296,1385,711,674,2012,26705
8297,434,217,217,2012,26707
8298,2115,963,1152,2012,26710
8299,2357,1248,1109,2012,26711
8300,379,272,107,2012,26714
8301,649,314,335,2012,26716
8302,1204,668,536,2012,26717
8303,2645,1239,1406,2012,26719
8304,190,57,133,2012,26720
8305,739,367,372,2012,26722
8306,13229,6618,6611,2012,26726
8307,276,157,119,2012,26731
8308,1132,614,518,2012,26739
8309,1544,626,918,2012,26743
8310,990,535,455,2012,26750
8311,6329,3068,3261,2012,26753
8312,922,454,468,2012,26755
8313,6928,3268,3660,2012,26757
8314,511,159,352,2012,26761
8315,1594,881,713,2012,26763
8316,4298,2105,2193,2012,26764
8317,506,316,190,2012,26767
8318,1060,598,462,2012,26801
8319,1405,729,676,2012,26802
8320,566,295,271,2012,26804
8321,2886,1477,1409,2012,26807
8322,705,360,345,2012,26808
8323,192,68,124,2012,26810
8324,1973,994,979,2012,26812
8325,471,259,212,2012,26814
8326,618,335,283,2012,26815
8327,405,199,206,2012,26817
8328,1183,452,731,2012,26818
8329,143,93,50,2012,26823
8330,2393,1277,1116,2012,26833
8331,6544,3204,3340,2012,26836
8332,728,362,366,2012,26845
8333,6393,2992,3401,2012,26847
8334,1843,993,850,2012,26851
8335,911,520,391,2012,26852
8336,714,384,330,2012,26855
8337,125,52,73,2012,26865
8338,956,436,520,2012,26866
8339,675,340,335,2012,26884
8340,13802,6715,7087,2012,27006
8341,2101,961,1140,2012,27007
8342,2997,1439,1558,2012,27009
8343,5232,2423,2809,2012,27011
8344,25957,12748,13209,2012,27012
8345,6053,3157,2896,2012,27013
8346,786,340,446,2012,27014
8347,1956,1035,921,2012,27016
8348,9794,4889,4905,2012,27017
8349,7856,4009,3847,2012,27018
8350,3305,1638,1667,2012,27019
8351,6753,3354,3399,2012,27020
8352,17622,8484,9138,2012,27021
8353,1948,903,1045,2012,27022
8354,11159,5229,5930,2012,27023
8355,2689,1533,1156,2012,27024
8356,11541,5580,5961,2012,27025
8357,4305,2040,2265,2012,27027
8358,25805,12699,13106,2012,27028
8359,37914,18557,19357,2012,27030
8360,11409,5719,5690,2012,27040
8361,7444,3534,3910,2012,27041
8362,615,295,320,2012,27042
8363,6300,3208,3092,2012,27043
8364,8661,4308,4353,2012,27045
8365,2354,1280,1074,2012,27046
8366,1079,557,522,2012,27047
8367,8476,4128,4348,2012,27048
8368,4495,2205,2290,2012,27050
8369,7092,3636,3456,2012,27051
8370,10700,5012,5688,2012,27052
8371,3346,1550,1796,2012,27053
8372,2363,1206,1157,2012,27054
8373,13589,6813,6776,2012,27055
8374,17758,9087,8671,2012,27101
8375,33713,16067,17646,2012,27103
8376,28056,12521,15535,2012,27104
8377,41083,18606,22477,2012,27105
8378,45540,21619,23921,2012,27106
8379,46962,23112,23850,2012,27107
8380,2525,1125,1400,2012,27109
8381,1606,593,1013,2012,27110
8382,33831,15709,18122,2012,27127
8383,45,22,23,2012,27201
8384,20917,9902,11015,2012,27203
8385,33252,16799,16453,2012,27205
8386,3622,1724,1898,2012,27207
8387,1827,984,843,2012,27208
8388,4369,2138,2231,2012,27209
8389,2535,1559,976,2012,27212
8390,11587,5709,5878,2012,27214
8391,39630,18595,21035,2012,27215
8392,35155,16339,18816,2012,27217
8393,4399,2094,2305,2012,27229
8394,1892,939,953,2012,27231
8395,3447,1714,1733,2012,27233
8396,4476,2184,2292,2012,27235
8397,9471,4699,4772,2012,27239
8398,1882,880,1002,2012,27242
8399,4130,1928,2202,2012,27243
8400,13967,6968,6999,2012,27244
8401,4570,2258,2312,2012,27248
8402,11897,6077,5820,2012,27249
8403,1872,969,903,2012,27252
8404,29069,14146,14923,2012,27253
8405,6534,3160,3374,2012,27258
8406,23795,11195,12600,2012,27260
8407,24534,11781,12753,2012,27262
8408,21636,10526,11110,2012,27263
8409,45688,21858,23830,2012,27265
8410,23505,11303,12202,2012,27278
8411,2432,1119,1313,2012,27281
8412,16332,7621,8711,2012,27282
8413,3326,1649,1677,2012,27283
8414,51114,24329,26785,2012,27284
8415,23633,10954,12679,2012,27288
8416,1821,869,952,2012,27291
8417,38548,19434,19114,2012,27292
8418,37680,18641,19039,2012,27295
8419,8896,4237,4659,2012,27298
8420,5388,2635,2753,2012,27299
8421,9982,4817,5165,2012,27301
8422,26889,12730,14159,2012,27302
8423,1693,823,870,2012,27305
8424,6398,2891,3507,2012,27306
8425,6738,3453,3285,2012,27310
8426,3470,1666,1804,2012,27311
8427,18500,8249,10251,2012,27312
8428,6876,3413,3463,2012,27313
8429,1373,739,634,2012,27314
8430,2001,1033,968,2012,27315
8431,6817,3446,3371,2012,27316
8432,17005,8138,8867,2012,27317
8433,39080,19001,20079,2012,27320
8434,6838,3108,3730,2012,27325
8435,3953,2047,1906,2012,27326
8436,38982,19221,19761,2012,27330
8437,29402,14667,14735,2012,27332
8438,26,0,26,2012,27340
8439,6105,3144,2961,2012,27341
8440,1644,827,817,2012,27343
8441,18552,9189,9363,2012,27344
8442,6232,2769,3463,2012,27349
8443,6328,3026,3302,2012,27350
8444,2376,1090,1286,2012,27355
8445,2749,1383,1366,2012,27356
8446,7434,3557,3877,2012,27357
8447,15048,7505,7543,2012,27358
8448,47157,22968,24189,2012,27360
8449,14754,7325,7429,2012,27370
8450,8225,4074,4151,2012,27371
8451,9873,4740,5133,2012,27376
8452,7332,3795,3537,2012,27377
8453,4882,2385,2497,2012,27379
8454,20643,9595,11048,2012,27401
8455,21602,10764,10838,2012,27403
8456,43758,20073,23685,2012,27405
8457,54292,25079,29213,2012,27406
8458,47955,24081,23874,2012,27407
8459,18291,8410,9881,2012,27408
8460,15240,7128,8112,2012,27409
8461,51890,24423,27467,2012,27410
8462,28989,13140,15849,2012,27455
8463,16741,7956,8785,2012,27501
8464,31178,15303,15875,2012,27502
8465,6389,4765,1624,2012,27503
8466,14983,7321,7662,2012,27504
8467,5213,2557,2656,2012,27505
8468,1466,875,591,2012,27507
8469,2441,1548,893,2012,27508
8470,5084,3130,1954,2012,27509
8471,14762,7057,7705,2012,27510
8472,33341,17004,16337,2012,27511
8473,40296,19520,20776,2012,27513
8474,31576,15325,16251,2012,27514
8475,37212,17734,19478,2012,27516
8476,23701,10844,12857,2012,27517
8477,20030,9506,10524,2012,27518
8478,38661,18918,19743,2012,27519
8479,36657,17961,18696,2012,27520
8480,5967,2978,2989,2012,27521
8481,12132,6605,5527,2012,27522
8482,9390,4723,4667,2012,27523
8483,11372,5489,5883,2012,27524
8484,12972,6186,6786,2012,27525
8485,40323,19408,20915,2012,27526
8486,17799,9398,8401,2012,27527
8487,42161,19946,22215,2012,27529
8488,41043,20303,20740,2012,27530
8489,479,452,27,2012,27531
8490,31762,15139,16623,2012,27534
8491,15968,7210,8758,2012,27536
8492,26282,12446,13836,2012,27537
8493,18614,9103,9511,2012,27539
8494,28604,14482,14122,2012,27540
8495,3818,2090,1728,2012,27541
8496,8404,3965,4439,2012,27542
8497,4158,2113,2045,2012,27544
8498,23302,10878,12424,2012,27545
8499,20091,10246,9845,2012,27546
8500,24942,12371,12571,2012,27549
8501,2316,1228,1088,2012,27551
8502,2231,1343,888,2012,27553
8503,338,147,191,2012,27555
8504,349,158,191,2012,27556
8505,5736,2609,3127,2012,27557
8506,2208,1019,1189,2012,27559
8507,22148,10663,11485,2012,27560
8508,1770,940,830,2012,27562
8509,4312,2196,2116,2012,27563
8510,28253,13643,14610,2012,27565
8511,384,168,216,2012,27568
8512,7211,3632,3579,2012,27569
8513,3975,2150,1825,2012,27571
8514,6805,3745,3060,2012,27572
8515,11078,5271,5807,2012,27573
8516,14806,6830,7976,2012,27574
8517,16391,8285,8106,2012,27576
8518,24664,12088,12576,2012,27577
8519,5254,3420,1834,2012,27581
8520,111,62,49,2012,27582
8521,6920,3352,3568,2012,27583
8522,52521,25919,26602,2012,27587
8523,9350,4488,4862,2012,27589
8524,20492,10452,10040,2012,27591
8525,14956,7279,7677,2012,27592
8526,15059,7551,7508,2012,27596
8527,23154,11545,11609,2012,27597
8528,9514,5195,4319,2012,27601
8529,45416,23186,22230,2012,27603
8530,40644,19452,21192,2012,27604
8531,4472,2475,1997,2012,27605
8532,44058,23450,20608,2012,27606
8533,27912,14175,13737,2012,27607
8534,10451,5030,5421,2012,27608
8535,32260,15004,17256,2012,27609
8536,67170,30746,36424,2012,27610
8537,34825,16755,18070,2012,27612
8538,42944,20496,22448,2012,27613
8539,31881,15531,16350,2012,27614
8540,41266,19762,21504,2012,27615
8541,45028,21810,23218,2012,27616
8542,14571,6606,7965,2012,27617
8543,20222,9945,10277,2012,27701
8544,42845,21078,21767,2012,27703
8545,34058,14976,19082,2012,27704
8546,46833,23181,23652,2012,27705
8547,45528,21644,23884,2012,27707
8548,658,261,397,2012,27709
8549,20133,9602,10531,2012,27712
8550,46540,20449,26091,2012,27713
8551,21658,9799,11859,2012,27801
8552,20824,10126,10698,2012,27803
8553,29033,13362,15671,2012,27804
8554,3580,1714,1866,2012,27805
8555,2543,1118,1425,2012,27806
8556,6646,3195,3451,2012,27807
8557,2209,1073,1136,2012,27808
8558,4405,2072,2333,2012,27809
8559,3943,1842,2101,2012,27810
8560,2565,1125,1440,2012,27812
8561,695,326,369,2012,27813
8562,1277,738,539,2012,27814
8563,2549,1201,1348,2012,27816
8564,7335,3699,3636,2012,27817
8565,1735,899,836,2012,27818
8566,428,216,212,2012,27819
8567,2544,1353,1191,2012,27820
8568,434,244,190,2012,27821
8569,8429,4083,4346,2012,27822
8570,7371,3498,3873,2012,27823
8571,1954,768,1186,2012,27824
8572,71,37,34,2012,27825
8573,885,615,270,2012,27826
8574,51,35,16,2012,27827
8575,8035,3524,4511,2012,27828
8576,1972,941,1031,2012,27829
8577,5312,2442,2870,2012,27830
8578,3590,1479,2111,2012,27831
8579,2969,1302,1667,2012,27832
8580,54429,25253,29176,2012,27834
8581,6254,3087,3167,2012,27837
8582,4387,2588,1799,2012,27839
8583,437,194,243,2012,27840
8584,54,30,24,2012,27841
8585,1358,697,661,2012,27842
8586,1335,582,753,2012,27843
8587,3233,1600,1633,2012,27844
8588,2736,1657,1079,2012,27845
8589,3067,1464,1603,2012,27846
8590,983,530,453,2012,27847
8591,1643,743,900,2012,27849
8592,6899,3190,3709,2012,27850
8593,5093,2706,2387,2012,27851
8594,2449,1209,1240,2012,27852
8595,726,379,347,2012,27853
8596,6139,2778,3361,2012,27855
8597,16597,8775,7822,2012,27856
8598,1436,779,657,2012,27857
8599,55793,26880,28913,2012,27858
8600,3176,1785,1391,2012,27860
8601,96,35,61,2012,27861
8602,857,387,470,2012,27862
8603,11736,5802,5934,2012,27863
8604,4902,2519,2383,2012,27864
8605,1780,806,974,2012,27865
8606,743,337,406,2012,27866
8607,2558,1129,1429,2012,27869
8608,27352,12911,14441,2012,27870
8609,4178,1948,2230,2012,27871
8610,317,145,172,2012,27872
8611,424,222,202,2012,27873
8612,4841,2273,2568,2012,27874
8613,500,285,215,2012,27875
8614,1606,775,831,2012,27876
8615,1898,938,960,2012,27878
8616,279,122,157,2012,27879
8617,3084,1652,1432,2012,27880
8618,79,37,42,2012,27881
8619,8121,3931,4190,2012,27882
8620,3474,1566,1908,2012,27883
8621,842,470,372,2012,27884
8622,1449,914,535,2012,27885
8623,22263,10262,12001,2012,27886
8624,2534,1270,1264,2012,27888
8625,26911,12554,14357,2012,27889
8626,2646,1263,1383,2012,27890
8627,5583,2560,3023,2012,27891
8628,14854,6846,8008,2012,27892
8629,40667,18687,21980,2012,27893
8630,19778,9586,10192,2012,27896
8631,2151,1016,1135,2012,27897
8632,40605,19787,20818,2012,27909
8633,11839,5624,6215,2012,27910
8634,577,278,299,2012,27915
8635,316,166,150,2012,27916
8636,1171,596,575,2012,27917
8637,1016,439,577,2012,27919
8638,882,340,542,2012,27920
8639,5004,2446,2558,2012,27921
8640,958,463,495,2012,27922
8641,262,125,137,2012,27923
8642,2649,1345,1304,2012,27924
8643,4185,2293,1892,2012,27925
8644,1556,776,780,2012,27926
8645,639,366,273,2012,27927
8646,2389,1075,1314,2012,27928
8647,1261,643,618,2012,27929
8648,12970,6270,6700,2012,27932
8649,1338,590,748,2012,27935
8650,1046,507,539,2012,27936
8651,4248,2026,2222,2012,27937
8652,1495,703,792,2012,27938
8653,2810,1357,1453,2012,27939
8654,601,324,277,2012,27941
8655,837,358,479,2012,27942
8656,543,296,247,2012,27943
8657,11998,5681,6317,2012,27944
8658,1683,838,845,2012,27946
8659,1291,705,586,2012,27947
8660,10423,5349,5074,2012,27948
8661,6996,3332,3664,2012,27949
8662,2196,945,1251,2012,27950
8663,1273,743,530,2012,27953
8664,6864,3426,3438,2012,27954
8665,277,140,137,2012,27956
8666,1535,848,687,2012,27957
8667,9738,4839,4899,2012,27958
8668,2802,1556,1246,2012,27959
8669,591,313,278,2012,27960
8670,6999,3390,3609,2012,27962
8671,449,179,270,2012,27964
8672,626,333,293,2012,27965
8673,1064,581,483,2012,27966
8674,270,111,159,2012,27967
8675,339,144,195,2012,27968
8676,3661,1580,2081,2012,27970
8677,52,28,24,2012,27972
8678,1255,697,558,2012,27973
8679,1446,794,652,2012,27974
8680,3182,1565,1617,2012,27976
8681,221,115,106,2012,27978
8682,1930,1112,818,2012,27979
8683,1811,831,980,2012,27980
8684,1934,849,1085,2012,27981
8685,67,38,29,2012,27982
8686,10848,5274,5574,2012,27983
8687,263,87,176,2012,27985
8688,2538,1880,658,2012,27986
8689,26339,12646,13693,2012,28001
8690,1242,584,658,2012,28006
8691,667,309,358,2012,28007
8692,897,374,523,2012,28009
8693,20920,10030,10890,2012,28012
8694,13138,6541,6597,2012,28016
8695,693,197,496,2012,28017
8696,6179,2916,3263,2012,28018
8697,75,37,38,2012,28019
8698,2333,1260,1073,2012,28020
8699,12610,5955,6655,2012,28021
8700,13691,7012,6679,2012,28023
8701,49494,23935,25559,2012,28025
8702,55688,26914,28774,2012,28027
8703,23960,11783,12177,2012,28031
8704,2926,1338,1588,2012,28032
8705,2473,1196,1277,2012,28033
8706,17068,8627,8441,2012,28034
8707,14837,7314,7523,2012,28036
8708,17754,9010,8744,2012,28037
8709,96,22,74,2012,28039
8710,7694,3920,3774,2012,28040
8711,21846,10172,11674,2012,28043
8712,34924,16590,18334,2012,28052
8713,34956,16718,18238,2012,28054
8714,32637,16008,16629,2012,28056
8715,3310,1716,1594,2012,28071
8716,1347,640,707,2012,28072
8717,4975,2118,2857,2012,28073
8718,16050,7605,8445,2012,28075
8719,1003,538,465,2012,28076
8720,291,136,155,2012,28077
8721,51715,26143,25572,2012,28078
8722,31918,15607,16311,2012,28079
8723,7907,3874,4033,2012,28080
8724,25359,12151,13208,2012,28081
8725,23161,11067,12094,2012,28083
8726,26308,13009,13299,2012,28086
8727,2809,1334,1475,2012,28088
8728,222,82,140,2012,28089
8729,8291,3996,4295,2012,28090
8730,2320,1144,1176,2012,28091
8731,38145,18705,19440,2012,28092
8732,5901,3038,2863,2012,28097
8733,3701,1774,1927,2012,28098
8734,551,255,296,2012,28101
8735,101,51,50,2012,28102
8736,9890,4978,4912,2012,28103
8737,28752,14388,14364,2012,28104
8738,39354,18887,20467,2012,28105
8739,6940,3598,3342,2012,28107
8740,40,27,13,2012,28108
8741,290,173,117,2012,28109
8742,50264,24854,25410,2012,28110
8743,26263,12640,13623,2012,28112
8744,6823,3478,3345,2012,28114
8745,33493,16849,16644,2012,28115
8746,34878,17567,17311,2012,28117
8747,2883,1479,1404,2012,28119
8748,20200,9740,10460,2012,28120
8749,5922,3036,2886,2012,28124
8750,2544,1181,1363,2012,28125
8751,8005,4344,3661,2012,28127
8752,6658,3224,3434,2012,28128
8753,5538,2770,2768,2012,28129
8754,2980,1656,1324,2012,28133
8755,9255,4674,4581,2012,28134
8756,5872,3745,2127,2012,28135
8757,3052,1568,1484,2012,28137
8758,10587,5327,5260,2012,28138
8759,19715,9315,10400,2012,28139
8760,25159,12202,12957,2012,28144
8761,26597,12777,13820,2012,28146
8762,25923,13214,12709,2012,28147
8763,28173,13308,14865,2012,28150
8764,25668,12439,13229,2012,28152
8765,3202,1628,1574,2012,28159
8766,3681,1799,1882,2012,28160
8767,5689,3072,2617,2012,28163
8768,13153,6533,6620,2012,28164
8769,8772,4352,4420,2012,28166
8770,2498,1381,1117,2012,28167
8771,10989,5518,5471,2012,28168
8772,207,105,102,2012,28169
8773,11888,5539,6349,2012,28170
8774,45304,22816,22488,2012,28173
8775,8371,3837,4534,2012,28174
8776,9565,5195,4370,2012,28202
8777,11921,5435,6486,2012,28203
8778,5235,2717,2518,2012,28204
8779,43299,22396,20903,2012,28205
8780,11354,5386,5968,2012,28206
8781,9178,4223,4955,2012,28207
8782,35156,16856,18300,2012,28208
8783,21224,10464,10760,2012,28209
8784,42313,20279,22034,2012,28210
8785,28349,13454,14895,2012,28211
8786,38553,18394,20159,2012,28212
8787,36484,17974,18510,2012,28213
8788,34146,16336,17810,2012,28214
8789,54362,25424,28938,2012,28215
8790,47086,21711,25375,2012,28216
8791,26723,13142,13581,2012,28217
8792,36844,17440,19404,2012,28226
8793,50574,25018,25556,2012,28227
8794,0,0,0,2012,28244
8795,39905,20325,19580,2012,28262
8796,72749,34996,37753,2012,28269
8797,32131,15333,16798,2012,28270
8798,31113,14474,16639,2012,28273
8799,59365,27898,31467,2012,28277
8800,20905,10120,10785,2012,28278
8801,0,0,0,2012,28280
8802,0,0,0,2012,28282
8803,17903,8016,9887,2012,28301
8804,29486,13911,15575,2012,28303
8805,38048,17052,20996,2012,28304
8806,5931,2816,3115,2012,28305
8807,40524,19303,21221,2012,28306
8808,19690,10079,9611,2012,28307
8809,298,244,54,2012,28308
8810,5024,4580,444,2012,28310
8811,32851,15647,17204,2012,28311
8812,17471,8172,9299,2012,28312
8813,52612,25998,26614,2012,28314
8814,11601,5256,6345,2012,28315
8815,4856,2401,2455,2012,28318
8816,9866,4526,5340,2012,28320
8817,3463,1645,1818,2012,28323
8818,557,233,324,2012,28325
8819,16999,8068,8931,2012,28326
8820,14701,7421,7280,2012,28327
8821,27095,13116,13979,2012,28328
8822,349,188,161,2012,28330
8823,450,263,187,2012,28332
8824,11493,5471,6022,2012,28333
8825,25118,12024,13094,2012,28334
8826,9851,4490,5361,2012,28337
8827,4713,2160,2553,2012,28338
8828,6945,3417,3528,2012,28339
8829,10901,5462,5439,2012,28340
8830,4373,2261,2112,2012,28341
8831,369,190,179,2012,28342
8832,1666,662,1004,2012,28343
8833,2895,1453,1442,2012,28344
8834,12629,5997,6632,2012,28345
8835,1478,976,502,2012,28347
8836,32928,15069,17859,2012,28348
8837,3779,1917,1862,2012,28349
8838,316,213,103,2012,28350
8839,3866,1783,2083,2012,28351
8840,26233,12842,13391,2012,28352
8841,5036,2809,2227,2012,28356
8842,3079,1570,1509,2012,28357
8843,39058,19032,20026,2012,28358
8844,16183,7989,8194,2012,28360
8845,1516,742,774,2012,28363
8846,15767,7256,8511,2012,28364
8847,16839,8408,8431,2012,28365
8848,5226,2678,2548,2012,28366
8849,135,48,87,2012,28367
8850,2418,1185,1233,2012,28369
8851,6602,3255,3347,2012,28371
8852,12586,6174,6412,2012,28372
8853,2431,1182,1249,2012,28373
8854,15382,7239,8143,2012,28374
8855,92,46,46,2012,28375
8856,38377,18800,19577,2012,28376
8857,13660,6585,7075,2012,28377
8858,26181,12835,13346,2012,28379
8859,7548,3557,3991,2012,28382
8860,6828,3259,3569,2012,28383
8861,12060,5912,6148,2012,28384
8862,2613,1186,1427,2012,28385
8863,5984,2966,3018,2012,28386
8864,14750,7162,7588,2012,28387
8865,21122,10343,10779,2012,28390
8866,5602,3016,2586,2012,28391
8867,988,535,453,2012,28392
8868,1607,801,806,2012,28393
8869,5653,2621,3032,2012,28394
8870,2230,1073,1157,2012,28395
8871,2951,1545,1406,2012,28396
8872,7024,3070,3954,2012,28398
8873,2172,1061,1111,2012,28399
8874,22661,11353,11308,2012,28401
8875,37161,18017,19144,2012,28403
8876,28214,13986,14228,2012,28405
8877,30813,14733,16080,2012,28409
8878,31821,15581,16240,2012,28411
8879,35002,16306,18696,2012,28412
8880,3878,1935,1943,2012,28420
8881,1252,656,596,2012,28421
8882,6490,3517,2973,2012,28422
8883,2474,1090,1384,2012,28423
8884,74,29,45,2012,28424
8885,11807,5859,5948,2012,28425
8886,6044,3005,3039,2012,28428
8887,9019,4191,4828,2012,28429
8888,1721,680,1041,2012,28430
8889,6081,2743,3338,2012,28431
8890,1992,1066,926,2012,28432
8891,4732,2484,2248,2012,28433
8892,1326,664,662,2012,28434
8893,2505,1253,1252,2012,28435
8894,2210,965,1245,2012,28436
8895,1578,900,678,2012,28438
8896,1587,750,837,2012,28439
8897,3341,1692,1649,2012,28441
8898,1146,594,552,2012,28442
8899,16703,8320,8383,2012,28443
8900,2932,1351,1581,2012,28444
8901,6384,3158,3226,2012,28445
8902,1544,737,807,2012,28447
8903,1104,465,639,2012,28448
8904,1627,749,878,2012,28449
8905,2379,1118,1261,2012,28450
8906,27841,13622,14219,2012,28451
8907,982,406,576,2012,28452
8908,5001,2712,2289,2012,28453
8909,1913,864,1049,2012,28454
8910,2118,949,1169,2012,28455
8911,3511,1895,1616,2012,28456
8912,9719,4950,4769,2012,28457
8913,5577,2805,2772,2012,28458
8914,8180,4242,3938,2012,28460
8915,14842,7317,7525,2012,28461
8916,11844,5630,6214,2012,28462
8917,10915,5730,5185,2012,28463
8918,2615,1230,1385,2012,28464
8919,6927,3365,3562,2012,28465
8920,11296,5783,5513,2012,28466
8921,8798,4198,4600,2012,28467
8922,4435,2146,2289,2012,28468
8923,6393,3026,3367,2012,28469
8924,9694,4612,5082,2012,28470
8925,20387,10286,10101,2012,28472
8926,4517,2211,2306,2012,28478
8927,5458,2584,2874,2012,28479
8928,2504,1388,1116,2012,28480
8929,20797,9556,11241,2012,28501
8930,21468,10675,10793,2012,28504
8931,2573,1199,1374,2012,28508
8932,1614,795,819,2012,28510
8933,587,291,296,2012,28511
8934,3315,1692,1623,2012,28512
8935,9644,4400,5244,2012,28513
8936,2703,1595,1108,2012,28515
8937,11491,5422,6069,2012,28516
8938,8089,3551,4538,2012,28518
8939,251,102,149,2012,28519
8940,365,152,213,2012,28520
8941,2312,1134,1178,2012,28521
8942,2441,1143,1298,2012,28523
8943,429,217,212,2012,28524
8944,2686,1271,1415,2012,28525
8945,2432,1166,1266,2012,28526
8946,1380,671,709,2012,28527
8947,388,188,200,2012,28528
8948,2411,1200,1211,2012,28529
8949,7203,3453,3750,2012,28530
8950,1244,547,697,2012,28531
8951,25002,12970,12032,2012,28532
8952,1851,1709,142,2012,28533
8953,240,87,153,2012,28537
8954,2238,1239,999,2012,28538
8955,14977,7635,7342,2012,28539
8956,50280,25497,24783,2012,28540
8957,4602,2250,2352,2012,28543
8958,5773,2991,2782,2012,28544
8959,43723,21839,21884,2012,28546
8960,19363,15929,3434,2012,28547
8961,13632,6788,6844,2012,28551
8962,164,85,79,2012,28552
8963,338,175,163,2012,28553
8964,231,85,146,2012,28554
8965,4969,2521,2448,2012,28555
8966,905,456,449,2012,28556
8967,14149,6581,7568,2012,28557
8968,29022,14004,15018,2012,28560
8969,35509,16685,18824,2012,28562
8970,21801,11155,10646,2012,28570
8971,2671,1283,1388,2012,28571
8972,6233,2971,3262,2012,28572
8973,2733,1259,1474,2012,28573
8974,14226,6909,7317,2012,28574
8975,210,138,72,2012,28575
8976,513,289,224,2012,28577
8977,5652,3443,2209,2012,28578
8978,404,144,260,2012,28579
8979,13148,7244,5904,2012,28580
8980,163,80,83,2012,28581
8981,1688,884,804,2012,28582
8982,282,127,155,2012,28583
8983,11444,5616,5828,2012,28584
8984,3642,1935,1707,2012,28585
8985,7101,3966,3135,2012,28586
8986,346,121,225,2012,28587
8987,347,133,214,2012,28589
8988,23896,11399,12497,2012,28590
8989,3649,1914,1735,2012,28594
8990,49304,23607,25697,2012,28601
8991,28895,14139,14756,2012,28602
8992,6743,3311,3432,2012,28604
8993,3670,1632,2038,2012,28605
8994,1577,763,814,2012,28606
8995,33255,16984,16271,2012,28607
8996,5749,2985,2764,2012,28609
8997,9762,4695,5067,2012,28610
8998,1045,607,438,2012,28611
8999,12846,6367,6479,2012,28612
9000,23755,12250,11505,2012,28613
9001,1876,943,933,2012,28615
9002,344,144,200,2012,28616
9003,2581,1212,1369,2012,28617
9004,1795,976,819,2012,28618
9005,1217,517,700,2012,28619
9006,10987,5210,5777,2012,28621
9007,2427,1175,1252,2012,28622
9008,1413,692,721,2012,28623
9009,1551,790,761,2012,28624
9010,36639,18124,18515,2012,28625
9011,1950,1033,917,2012,28626
9012,1523,700,823,2012,28627
9013,389,175,214,2012,28628
9014,99,54,45,2012,28629
9015,20232,9827,10405,2012,28630
9016,583,256,327,2012,28631
9017,5996,3135,2861,2012,28634
9018,3704,1951,1753,2012,28635
9019,5950,2783,3167,2012,28636
9020,1493,821,672,2012,28637
9021,12019,6111,5908,2012,28638
9022,5020,2319,2701,2012,28640
9023,6090,2888,3202,2012,28642
9024,3165,1657,1508,2012,28643
9025,1266,528,738,2012,28644
9026,47037,23040,23997,2012,28645
9027,647,309,338,2012,28646
9028,140,91,49,2012,28647
9029,1082,487,595,2012,28649
9030,11941,5757,6184,2012,28650
9031,6730,3402,3328,2012,28651
9032,98,61,37,2012,28652
9033,4072,1877,2195,2012,28654
9034,55894,28188,27706,2012,28655
9035,9275,4662,4613,2012,28657
9036,26406,12902,13504,2012,28658
9037,21065,10457,10608,2012,28659
9038,2170,997,1173,2012,28660
9039,13,13,0,2012,28662
9040,542,298,244,2012,28663
9041,2744,1295,1449,2012,28665
9042,285,157,128,2012,28666
9043,567,242,325,2012,28667
9044,407,193,214,2012,28668
9045,3482,1579,1903,2012,28669
9046,3148,1380,1768,2012,28670
9047,658,288,370,2012,28671
9048,35,13,22,2012,28672
9049,5440,2937,2503,2012,28673
9050,6312,3328,2984,2012,28675
9051,3338,1626,1712,2012,28676
9052,33547,15712,17835,2012,28677
9053,5307,2758,2549,2012,28678
9054,2277,1133,1144,2012,28679
9055,25679,12877,12802,2012,28681
9056,1115,473,642,2012,28682
9057,1788,858,930,2012,28683
9058,2753,1379,1374,2012,28684
9059,1561,866,695,2012,28685
9060,1806,967,839,2012,28689
9061,9172,4376,4796,2012,28690
9062,3671,1851,1820,2012,28692
9063,1508,741,767,2012,28693
9064,8163,3937,4226,2012,28694
9065,12790,6283,6507,2012,28697
9066,2340,1077,1263,2012,28698
9067,4376,2106,2270,2012,28701
9068,442,222,220,2012,28702
9069,20637,9880,10757,2012,28704
9070,6712,3420,3292,2012,28705
9071,178,117,61,2012,28707
9072,540,315,225,2012,28708
9073,1776,851,925,2012,28709
9074,12857,6031,6826,2012,28711
9075,18081,8450,9631,2012,28712
9076,9243,4788,4455,2012,28713
9077,16680,8026,8654,2012,28714
9078,24336,12052,12284,2012,28715
9079,16872,8356,8516,2012,28716
9080,2044,914,1130,2012,28717
9081,499,295,204,2012,28718
9082,7917,3611,4306,2012,28719
9083,147,85,62,2012,28720
9084,10042,4868,5174,2012,28721
9085,6714,3143,3571,2012,28722
9086,10809,5513,5296,2012,28723
9087,17,12,5,2012,28725
9088,3579,1801,1778,2012,28726
9089,2682,1362,1320,2012,28729
9090,9783,4772,5011,2012,28730
9091,7498,3652,3846,2012,28731
9092,15365,7439,7926,2012,28732
9093,63,17,46,2012,28733
9094,26707,12914,13793,2012,28734
9095,188,71,117,2012,28735
9096,951,507,444,2012,28736
9097,20912,10184,10728,2012,28739
9098,1747,939,808,2012,28740
9099,3637,1756,1881,2012,28741
9100,2727,1136,1591,2012,28742
9101,1809,802,1007,2012,28743
9102,478,279,199,2012,28745
9103,2355,1189,1166,2012,28746
9104,2603,1364,1239,2012,28747
9105,11806,5818,5988,2012,28748
9106,38,30,8,2012,28749
9107,3029,1448,1581,2012,28751
9108,31275,15224,16051,2012,28752
9109,11516,5879,5637,2012,28753
9110,7874,3852,4022,2012,28754
9111,4171,2149,2022,2012,28756
9112,333,149,184,2012,28757
9113,6865,3371,3494,2012,28759
9114,7157,3759,3398,2012,28761
9115,6780,3592,3188,2012,28762
9116,2641,1394,1247,2012,28763
9117,1370,800,570,2012,28766
9118,7349,3386,3963,2012,28768
9119,8261,4077,4184,2012,28771
9120,1112,570,542,2012,28772
9121,2452,1283,1169,2012,28773
9122,1113,511,602,2012,28774
9123,355,114,241,2012,28775
9124,10125,5662,4463,2012,28777
9125,10987,5221,5766,2012,28778
9126,16472,8105,8367,2012,28779
9127,806,427,379,2012,28781
9128,6680,3181,3499,2012,28782
9129,1048,560,488,2012,28783
9130,7928,3812,4116,2012,28785
9131,20599,9741,10858,2012,28786
9132,18381,8851,9530,2012,28787
9133,4709,2213,2496,2012,28789
9134,3323,1713,1610,2012,28790
9135,15161,6870,8291,2012,28791
9136,31708,15652,16056,2012,28792
9137,14101,6599,7502,2012,28801
9138,29666,14317,15349,2012,28803
9139,20408,9997,10411,2012,28804
9140,17798,8293,9505,2012,28805
9141,37736,17884,19852,2012,28806
9142,5048,2343,2705,2012,28901
9143,1386,675,711,2012,28902
9144,8504,4122,4382,2012,28904
9145,2943,1312,1631,2012,28905
9146,19057,9451,9606,2012,28906
9147,761,394,367,2012,28909
9148,1825,839,986,2012,29001
9149,6766,3067,3699,2012,29003
9150,9897,4802,5095,2012,29006
9151,2346,1171,1175,2012,29009
9152,11877,6382,5495,2012,29010
9153,1808,898,910,2012,29014
9154,1425,727,698,2012,29015
9155,15771,7685,8086,2012,29016
9156,3663,1767,1896,2012,29018
9157,22542,10929,11613,2012,29020
9158,2241,1107,1134,2012,29030
9159,1449,666,783,2012,29031
9160,4455,1966,2489,2012,29032
9161,12227,5868,6359,2012,29033
9162,17939,8885,9054,2012,29036
9163,725,339,386,2012,29037
9164,2736,1347,1389,2012,29038
9165,4460,1863,2597,2012,29039
9166,10149,5105,5044,2012,29040
9167,5578,2885,2693,2012,29042
9168,5393,2521,2872,2012,29044
9169,20649,10500,10149,2012,29045
9170,340,173,167,2012,29046
9171,3902,1950,1952,2012,29047
9172,5026,2385,2641,2012,29048
9173,1434,1023,411,2012,29051
9174,2520,1244,1276,2012,29052
9175,18340,8971,9369,2012,29053
9176,9749,5060,4689,2012,29054
9177,4419,2168,2251,2012,29055
9178,2399,1047,1352,2012,29056
9179,4843,2664,2179,2012,29058
9180,6111,2658,3453,2012,29059
9181,14471,6632,7839,2012,29061
9182,107,46,61,2012,29062
9183,33162,15744,17418,2012,29063
9184,708,251,457,2012,29065
9185,10691,5885,4806,2012,29067
9186,5322,2711,2611,2012,29069
9187,14541,6807,7734,2012,29070
9188,48560,23447,25113,2012,29072
9189,40799,19657,21142,2012,29073
9190,246,120,126,2012,29074
9191,3268,1636,1632,2012,29075
9192,15035,7365,7670,2012,29078
9193,116,71,45,2012,29079
9194,3036,1391,1645,2012,29080
9195,1139,497,642,2012,29081
9196,620,291,329,2012,29082
9197,3263,1536,1727,2012,29101
9198,18351,8712,9639,2012,29102
9199,1638,725,913,2012,29104
9200,1075,526,549,2012,29105
9201,2872,1466,1406,2012,29107
9202,20928,9975,10953,2012,29108
9203,1783,858,925,2012,29111
9204,4624,2359,2265,2012,29112
9205,1757,825,932,2012,29113
9206,2366,1006,1360,2012,29114
9207,29029,13332,15697,2012,29115
9208,1209,714,495,2012,29117
9209,16223,7749,8474,2012,29118
9210,46,21,25,2012,29122
9211,7181,3453,3728,2012,29123
9212,2311,1042,1269,2012,29125
9213,2214,1170,1044,2012,29126
9214,7851,3854,3997,2012,29127
9215,5411,2951,2460,2012,29128
9216,3833,2170,1663,2012,29129
9217,7067,3772,3295,2012,29130
9218,1240,638,602,2012,29133
9219,8505,4121,4384,2012,29135
9220,2760,1360,1400,2012,29137
9221,10714,5655,5059,2012,29138
9222,5111,2584,2527,2012,29142
9223,664,344,320,2012,29145
9224,1854,798,1056,2012,29146
9225,0,0,0,2012,29147
9226,6766,3253,3513,2012,29148
9227,40679,18562,22117,2012,29150
9228,1716,988,728,2012,29152
9229,16149,7807,8342,2012,29153
9230,29769,14715,15054,2012,29154
9231,8701,4235,4466,2012,29160
9232,11860,5795,6065,2012,29161
9233,3338,1876,1462,2012,29162
9234,2195,1002,1193,2012,29163
9235,4054,2130,1924,2012,29164
9236,924,447,477,2012,29166
9237,2659,1319,1340,2012,29168
9238,21985,10929,11056,2012,29169
9239,20480,10461,10019,2012,29170
9240,8627,4260,4367,2012,29172
9241,523,224,299,2012,29175
9242,3201,1567,1634,2012,29178
9243,14409,6745,7664,2012,29180
9244,20116,9915,10201,2012,29201
9245,179,86,93,2012,29202
9246,40870,18706,22164,2012,29203
9247,20869,9708,11161,2012,29204
9248,26321,13907,12414,2012,29205
9249,19052,8673,10379,2012,29206
9250,9875,6660,3215,2012,29207
9251,860,417,443,2012,29208
9252,32098,15560,16538,2012,29209
9253,40528,21197,19331,2012,29210
9254,30158,14884,15274,2012,29212
9255,51255,24284,26971,2012,29223
9256,1050,6,1044,2012,29225
9257,43109,19831,23278,2012,29229
9258,29851,14442,15409,2012,29301
9259,17569,8376,9193,2012,29302
9260,25602,12477,13125,2012,29303
9261,15703,6544,9159,2012,29306
9262,19756,9359,10397,2012,29307
9263,22144,10629,11515,2012,29316
9264,526,237,289,2012,29320
9265,2326,1115,1211,2012,29321
9266,9051,4142,4909,2012,29322
9267,13692,6985,6707,2012,29323
9268,188,114,74,2012,29324
9269,14924,7437,7487,2012,29325
9270,215,92,123,2012,29329
9271,7904,3690,4214,2012,29330
9272,152,70,82,2012,29331
9273,2605,1351,1254,2012,29332
9274,569,216,353,2012,29333
9275,12722,6404,6318,2012,29334
9276,6019,3743,2276,2012,29335
9277,11,0,11,2012,29338
9278,20567,9950,10617,2012,29340
9279,19285,9189,10096,2012,29341
9280,102,55,47,2012,29346
9281,29529,14599,14930,2012,29349
9282,1425,595,830,2012,29351
9283,3859,1987,1872,2012,29353
9284,867,372,495,2012,29355
9285,7769,3869,3900,2012,29356
9286,20438,9459,10979,2012,29360
9287,575,268,307,2012,29364
9288,9739,5067,4672,2012,29365
9289,14,0,14,2012,29368
9290,14241,7095,7146,2012,29369
9291,661,301,360,2012,29370
9292,4830,2323,2507,2012,29372
9293,158,98,60,2012,29373
9294,3239,1719,1520,2012,29374
9295,143,69,74,2012,29375
9296,6609,3165,3444,2012,29376
9297,532,323,209,2012,29377
9298,120,68,52,2012,29378
9299,19267,9082,10185,2012,29379
9300,4066,1920,2146,2012,29384
9301,6664,2994,3670,2012,29385
9302,13962,6629,7333,2012,29388
9303,10814,4640,6174,2012,29401
9304,22115,10741,11374,2012,29403
9305,1370,875,495,2012,29404
9306,27904,14831,13073,2012,29405
9307,29487,13945,15542,2012,29406
9308,34438,15700,18738,2012,29407
9309,2167,1945,222,2012,29409
9310,17893,9175,8718,2012,29410
9311,35533,17296,18237,2012,29412
9312,32617,15231,17386,2012,29414
9313,22298,11214,11084,2012,29418
9314,22614,10930,11684,2012,29420
9315,504,228,276,2012,29423
9316,352,114,238,2012,29424
9317,1492,683,809,2012,29426
9318,3009,1314,1695,2012,29429
9319,6546,2995,3551,2012,29431
9320,2700,1291,1409,2012,29432
9321,446,220,226,2012,29434
9322,3700,1785,1915,2012,29435
9323,3974,2082,1892,2012,29436
9324,2157,1224,933,2012,29437
9325,2430,1294,1136,2012,29438
9326,2215,1323,892,2012,29439
9327,29100,14011,15089,2012,29440
9328,55376,28599,26777,2012,29445
9329,1209,748,461,2012,29446
9330,2526,1179,1347,2012,29448
9331,7746,3656,4090,2012,29449
9332,2828,1313,1515,2012,29450
9333,4217,2165,2052,2012,29451
9334,383,146,237,2012,29452
9335,1425,725,700,2012,29453
9336,20114,9859,10255,2012,29455
9337,28940,13532,15408,2012,29456
9338,2286,1217,1069,2012,29458
9339,30270,14835,15435,2012,29461
9340,44677,21247,23430,2012,29464
9341,28087,13229,14858,2012,29466
9342,1856,876,980,2012,29468
9343,550,279,271,2012,29469
9344,4131,2078,2053,2012,29470
9345,1428,724,704,2012,29471
9346,9237,5189,4048,2012,29472
9347,2327,1209,1118,2012,29474
9348,2946,1520,1426,2012,29475
9349,6581,3001,3580,2012,29477
9350,7636,3748,3888,2012,29479
9351,1958,1003,955,2012,29481
9352,1905,883,1022,2012,29482
9353,66029,31278,34751,2012,29483
9354,46879,23235,23644,2012,29485
9355,2883,1351,1532,2012,29487
9356,21779,10104,11675,2012,29488
9357,10419,5190,5229,2012,29492
9358,98,57,41,2012,29493
9359,43004,20041,22963,2012,29501
9360,26174,12086,14088,2012,29505
9361,21246,9727,11519,2012,29506
9362,10970,4742,6228,2012,29510
9363,4483,2007,2476,2012,29511
9364,19051,10485,8566,2012,29512
9365,881,501,380,2012,29516
9366,1210,495,715,2012,29518
9367,231,81,150,2012,29519
9368,14276,6646,7630,2012,29520
9369,1638,807,831,2012,29525
9370,38063,18348,19715,2012,29526
9371,24722,11901,12821,2012,29527
9372,2361,1169,1192,2012,29530
9373,20539,9549,10990,2012,29532
9374,17204,8278,8926,2012,29536
9375,6249,3022,3227,2012,29540
9376,8092,4002,4090,2012,29541
9377,487,196,291,2012,29543
9378,5048,2573,2475,2012,29544
9379,1803,804,999,2012,29545
9380,2581,1204,1377,2012,29546
9381,1916,931,985,2012,29547
9382,31525,14987,16538,2012,29550
9383,9122,4454,4668,2012,29554
9384,6398,3066,3332,2012,29555
9385,12718,5914,6804,2012,29556
9386,12438,5499,6939,2012,29560
9387,2640,1212,1428,2012,29563
9388,931,433,498,2012,29564
9389,8001,3564,4437,2012,29565
9390,15869,7701,8168,2012,29566
9391,667,271,396,2012,29567
9392,13436,6158,7278,2012,29568
9393,16330,7677,8653,2012,29569
9394,4394,2117,2277,2012,29570
9395,16099,7250,8849,2012,29571
9396,8787,4551,4236,2012,29572
9397,12199,5624,6575,2012,29574
9398,15401,7125,8276,2012,29575
9399,24530,12073,12457,2012,29576
9400,27057,13910,13147,2012,29577
9401,30508,15575,14933,2012,29579
9402,1468,525,943,2012,29580
9403,4376,2048,2328,2012,29581
9404,14541,7229,7312,2012,29582
9405,5584,2791,2793,2012,29583
9406,2622,1272,1350,2012,29584
9407,12935,6059,6876,2012,29585
9408,35860,17638,18222,2012,29588
9409,4095,2874,1221,2012,29590
9410,5420,2759,2661,2012,29591
9411,1020,474,546,2012,29592
9412,2269,1040,1229,2012,29593
9413,122,54,68,2012,29594
9414,2548,1204,1344,2012,29596
9415,10600,5549,5051,2012,29601
9416,34104,15938,18166,2012,29605
9417,34752,17038,17714,2012,29607
9418,27952,13855,14097,2012,29609
9419,29446,14564,14882,2012,29611
9420,1551,799,752,2012,29613
9421,2895,1130,1765,2012,29614
9422,32752,15966,16786,2012,29615
9423,25939,12411,13528,2012,29617
9424,13497,6224,7273,2012,29620
9425,40388,19417,20971,2012,29621
9426,14599,6724,7875,2012,29624
9427,27150,13813,13337,2012,29625
9428,13305,6492,6813,2012,29626
9429,17740,8381,9359,2012,29627
9430,2593,1410,1183,2012,29628
9431,13958,6863,7095,2012,29630
9432,13471,7304,6167,2012,29631
9433,6752,3348,3404,2012,29634
9434,1376,656,720,2012,29635
9435,2888,1529,1359,2012,29638
9436,1752,928,824,2012,29639
9437,30838,15503,15335,2012,29640
9438,29506,14274,15232,2012,29642
9439,2700,1313,1387,2012,29643
9440,19553,10050,9503,2012,29644
9441,10058,4757,5301,2012,29645
9442,28763,13181,15582,2012,29646
9443,24618,11483,13135,2012,29649
9444,33654,16733,16921,2012,29650
9445,43880,21357,22523,2012,29651
9446,5465,2868,2597,2012,29653
9447,10106,4714,5392,2012,29654
9448,7013,3411,3602,2012,29655
9449,14068,6757,7311,2012,29657
9450,292,177,115,2012,29658
9451,201,94,107,2012,29659
9452,5725,3029,2696,2012,29661
9453,14590,6591,7999,2012,29662
9454,1599,776,823,2012,29664
9455,63,8,55,2012,29665
9456,6525,3058,3467,2012,29666
9457,218,106,112,2012,29667
9458,12056,5894,6162,2012,29669
9459,8852,4477,4375,2012,29670
9460,17133,8412,8721,2012,29671
9461,11449,5984,5465,2012,29672
9462,24737,11087,13650,2012,29673
9463,5221,2650,2571,2012,29676
9464,21871,10447,11424,2012,29678
9465,28232,14250,13982,2012,29680
9466,48191,23504,24687,2012,29681
9467,3678,1756,1922,2012,29682
9468,293,196,97,2012,29683
9469,4869,2507,2362,2012,29684
9470,1048,561,487,2012,29685
9471,1119,566,553,2012,29686
9472,41931,19758,22173,2012,29687
9473,3913,1945,1968,2012,29689
9474,19985,9644,10341,2012,29690
9475,11446,5199,6247,2012,29691
9476,5333,2491,2842,2012,29692
9477,14442,7118,7324,2012,29693
9478,3808,2146,1662,2012,29696
9479,12175,5677,6498,2012,29697
9480,10240,5030,5210,2012,29702
9481,3429,1822,1607,2012,29704
9482,20258,9829,10429,2012,29706
9483,16577,7884,8693,2012,29707
9484,25831,12581,13250,2012,29708
9485,6432,2937,3495,2012,29709
9486,28340,13790,14550,2012,29710
9487,2345,1110,1235,2012,29712
9488,2660,1333,1327,2012,29714
9489,24708,11708,13000,2012,29715
9490,987,439,548,2012,29717
9491,3694,1865,1829,2012,29718
9492,47480,22922,24558,2012,29720
9493,0,0,0,2012,29724
9494,1892,989,903,2012,29726
9495,1374,648,726,2012,29727
9496,10461,5410,5051,2012,29728
9497,2321,1038,1283,2012,29729
9498,52071,24834,27237,2012,29730
9499,54743,26373,28370,2012,29732
9500,1780,612,1168,2012,29733
9501,1906,1069,837,2012,29741
9502,2425,1195,1230,2012,29742
9503,995,549,446,2012,29743
9504,29556,14469,15087,2012,29745
9505,26158,12349,13809,2012,29801
9506,37249,18094,19155,2012,29803
9507,5756,2890,2866,2012,29805
9508,2211,1131,1080,2012,29809
9509,5116,2622,2494,2012,29810
9510,11308,5461,5847,2012,29812
9511,1331,486,845,2012,29816
9512,5751,2656,3095,2012,29817
9513,1302,684,618,2012,29819
9514,887,397,490,2012,29821
9515,8662,5145,3517,2012,29824
9516,82,41,41,2012,29826
9517,4480,2631,1849,2012,29827
9518,1247,525,722,2012,29828
9519,8406,4038,4368,2012,29829
9520,3613,1608,2005,2012,29831
9521,5503,2678,2825,2012,29832
9522,1615,831,784,2012,29834
9523,7052,3456,3596,2012,29835
9524,759,345,414,2012,29836
9525,564,296,268,2012,29838
9526,170,45,125,2012,29840
9527,32511,15589,16922,2012,29841
9528,8908,4446,4462,2012,29842
9529,1735,807,928,2012,29843
9530,48,27,21,2012,29844
9531,1067,545,522,2012,29845
9532,4839,2633,2206,2012,29847
9533,1000,457,543,2012,29848
9534,163,70,93,2012,29849
9535,192,126,66,2012,29850
9536,7190,3741,3449,2012,29851
9537,6504,3201,3303,2012,29853
9538,3701,1719,1982,2012,29856
9539,14476,7007,7469,2012,29860
9540,1078,1078,0,2012,29899
9541,14187,6975,7212,2012,29902
9542,349,317,32,2012,29904
9543,4189,3447,742,2012,29905
9544,22068,10845,11223,2012,29906
9545,12124,5791,6333,2012,29907
9546,16883,7833,9050,2012,29909
9547,33809,16868,16941,2012,29910
9548,1722,914,808,2012,29911
9549,0,0,0,2012,29912
9550,599,373,226,2012,29915
9551,1613,726,887,2012,29916
9552,5412,3080,2332,2012,29918
9553,9070,4214,4856,2012,29920
9554,225,119,106,2012,29921
9555,1208,702,506,2012,29922
9556,576,295,281,2012,29923
9557,4024,1923,2101,2012,29924
9558,24293,11833,12460,2012,29926
9559,8037,4305,3732,2012,29927
9560,15740,7796,7944,2012,29928
9561,1044,539,505,2012,29929
9562,116,75,41,2012,29932
9563,1283,677,606,2012,29934
9564,3180,1151,2029,2012,29935
9565,13684,7160,6524,2012,29936
9566,235,123,112,2012,29939
9567,3997,1756,2241,2012,29940
9568,500,270,230,2012,29941
9569,468,261,207,2012,29943
9570,5435,2530,2905,2012,29944
9571,4455,2179,2276,2012,29945
9572,6405,3087,3318,2012,30002
9573,53642,26659,26983,2012,30004
9574,36215,18603,17612,2012,30005
9575,30991,16190,14801,2012,30008
9576,13706,6446,7260,2012,30009
9577,15099,7390,7709,2012,30011
9578,27376,13050,14326,2012,30012
9579,25141,11668,13473,2012,30013
9580,37899,18004,19895,2012,30014
9581,49267,23652,25615,2012,30016
9582,21135,10573,10562,2012,30017
9583,40979,20119,20860,2012,30019
9584,23212,11397,11815,2012,30021
9585,64632,31825,32807,2012,30022
9586,67734,34399,33335,2012,30024
9587,8889,4423,4466,2012,30025
9588,19120,10001,9119,2012,30028
9589,26103,11750,14353,2012,30030
9590,47003,23149,23854,2012,30032
9591,29527,13468,16059,2012,30033
9592,45723,20363,25360,2012,30034
9593,20637,9882,10755,2012,30035
9594,38068,16267,21801,2012,30038
9595,41311,19323,21988,2012,30039
9596,56177,27453,28724,2012,30040
9597,54612,27106,27506,2012,30041
9598,81716,40693,41023,2012,30043
9599,79381,39032,40349,2012,30044
9600,31777,15616,16161,2012,30045
9601,34255,16883,17372,2012,30046
9602,60898,30033,30865,2012,30047
9603,58780,28999,29781,2012,30052
9604,11829,5602,6227,2012,30054
9605,2743,1432,1311,2012,30055
9606,2225,1217,1008,2012,30056
9607,53773,24425,29348,2012,30058
9608,35259,17326,17933,2012,30060
9609,63193,30864,32329,2012,30062
9610,46330,22545,23785,2012,30064
9611,53953,26734,27219,2012,30066
9612,44729,21980,22749,2012,30067
9613,32775,16064,16711,2012,30068
9614,315,124,191,2012,30070
9615,19926,10608,9318,2012,30071
9616,615,274,341,2012,30072
9617,53693,25792,27901,2012,30075
9618,41630,20517,21113,2012,30076
9619,33984,15283,18701,2012,30078
9620,3521,1600,1921,2012,30079
9621,51389,24235,27154,2012,30080
9622,25005,11833,13172,2012,30082
9623,50612,22663,27949,2012,30083
9624,35867,17676,18191,2012,30084
9625,36016,17137,18879,2012,30087
9626,27215,13081,14134,2012,30088
9627,31081,15287,15794,2012,30092
9628,54540,28546,25994,2012,30093
9629,30975,14845,16130,2012,30094
9630,66521,31291,35230,2012,30096
9631,40712,19791,20921,2012,30097
9632,55262,27682,27580,2012,30101
9633,34146,17480,16666,2012,30102
9634,15835,7719,8116,2012,30103
9635,4886,2440,2446,2012,30104
9636,2572,1371,1201,2012,30105
9637,18102,8365,9737,2012,30106
9638,13145,6635,6510,2012,30107
9639,7476,3323,4153,2012,30108
9640,12541,5784,6757,2012,30110
9641,5951,3068,2883,2012,30113
9642,48930,23987,24943,2012,30114
9643,37630,18463,19167,2012,30115
9644,23524,12146,11378,2012,30116
9645,34151,16390,17761,2012,30117
9646,2218,1076,1142,2012,30118
9647,37100,18481,18619,2012,30120
9648,21895,10877,11018,2012,30121
9649,22526,11044,11482,2012,30122
9650,2775,1344,1431,2012,30124
9651,25134,12385,12749,2012,30125
9652,38216,18216,20000,2012,30126
9653,61312,29219,32093,2012,30127
9654,32133,15666,16467,2012,30132
9655,43585,21206,22379,2012,30134
9656,60809,28841,31968,2012,30135
9657,1781,901,880,2012,30137
9658,4086,2018,2068,2012,30139
9659,21446,10295,11151,2012,30141
9660,20955,10495,10460,2012,30143
9661,50590,24317,26273,2012,30144
9662,9165,4607,4558,2012,30145
9663,5525,2936,2589,2012,30147
9664,542,239,303,2012,30148
9665,1372,210,1162,2012,30149
9666,41249,19640,21609,2012,30152
9667,18379,9041,9338,2012,30153
9668,44761,21881,22880,2012,30157
9669,35392,17173,18219,2012,30161
9670,0,0,0,2012,30164
9671,38480,18315,20165,2012,30165
9672,26110,12556,13554,2012,30168
9673,3862,1936,1926,2012,30170
9674,3758,2025,1733,2012,30171
9675,5557,2793,2764,2012,30173
9676,6110,3025,3085,2012,30175
9677,7208,3711,3497,2012,30176
9678,1548,798,750,2012,30177
9679,3663,1729,1934,2012,30178
9680,16581,8799,7782,2012,30179
9681,32978,15739,17239,2012,30180
9682,3297,1626,1671,2012,30182
9683,5407,2729,2678,2012,30183
9684,6787,3130,3657,2012,30184
9685,3788,1849,1939,2012,30185
9686,8619,4376,4243,2012,30187
9687,51768,25136,26632,2012,30188
9688,37382,18546,18836,2012,30189
9689,13272,6140,7132,2012,30204
9690,2824,1439,1385,2012,30205
9691,3135,1567,1568,2012,30206
9692,28374,12394,15980,2012,30213
9693,29208,13925,15283,2012,30214
9694,31996,15615,16381,2012,30215
9695,1864,936,928,2012,30216
9696,9459,4759,4700,2012,30217
9697,2230,1154,1076,2012,30218
9698,5244,2226,3018,2012,30220
9699,4610,2310,2300,2012,30222
9700,36371,17433,18938,2012,30223
9701,24708,12229,12479,2012,30224
9702,35968,16840,19128,2012,30228
9703,8561,4136,4425,2012,30230
9704,23194,12581,10613,2012,30233
9705,2045,1073,972,2012,30234
9706,46139,23127,23012,2012,30236
9707,35499,16387,19112,2012,30238
9708,28441,13243,15198,2012,30240
9709,24742,11941,12801,2012,30241
9710,23163,11291,11872,2012,30248
9711,76,51,25,2012,30250
9712,2552,1211,1341,2012,30251
9713,43146,20879,22267,2012,30252
9714,51403,23830,27573,2012,30253
9715,2312,1133,1179,2012,30256
9716,4036,1942,2094,2012,30257
9717,2922,1508,1414,2012,30258
9718,3296,1663,1633,2012,30259
9719,25183,11743,13440,2012,30260
9720,52419,25938,26481,2012,30263
9721,31702,15419,16283,2012,30265
9722,9085,4412,4673,2012,30268
9723,34804,16525,18279,2012,30269
9724,14651,6792,7859,2012,30273
9725,34151,16539,17612,2012,30274
9726,0,0,0,2012,30275
9727,13987,6858,7129,2012,30276
9728,20830,10180,10650,2012,30277
9729,64962,31075,33887,2012,30281
9730,55,35,20,2012,30284
9731,642,288,354,2012,30285
9732,23938,11367,12571,2012,30286
9733,10798,4619,6179,2012,30288
9734,47,15,32,2012,30289
9735,8425,4310,4115,2012,30290
9736,21206,9174,12032,2012,30291
9737,6462,2889,3573,2012,30292
9738,2742,1421,1321,2012,30293
9739,37768,18475,19293,2012,30294
9740,4300,2151,2149,2012,30295
9741,27238,12488,14750,2012,30296
9742,27252,14632,12620,2012,30297
9743,4255,2374,1881,2012,30303
9744,20780,9824,10956,2012,30305
9745,21584,10579,11005,2012,30306
9746,17344,8505,8839,2012,30307
9747,15106,8423,6683,2012,30308
9748,21069,11282,9787,2012,30309
9749,26062,12394,13668,2012,30310
9750,35741,15758,19983,2012,30311
9751,18060,8656,9404,2012,30312
9752,10085,6395,3690,2012,30313
9753,21767,10739,11028,2012,30314
9754,33761,16665,17096,2012,30315
9755,31282,15310,15972,2012,30316
9756,11520,5301,6219,2012,30317
9757,54248,28181,26067,2012,30318
9758,36148,18140,18008,2012,30319
9759,2226,1065,1161,2012,30322
9760,25695,14488,11207,2012,30324
9761,4777,2341,2436,2012,30326
9762,22715,11034,11681,2012,30327
9763,31326,14505,16821,2012,30328
9764,26631,13650,12981,2012,30329
9765,58640,26078,32562,2012,30331
9766,3453,2174,1279,2012,30332
9767,0,0,0,2012,30334
9768,542,348,194,2012,30336
9769,10745,5109,5636,2012,30337
9770,33286,15950,17336,2012,30338
9771,18531,9192,9339,2012,30339
9772,31152,17228,13924,2012,30340
9773,28474,15130,13344,2012,30341
9774,30950,15698,15252,2012,30342
9775,32425,15730,16695,2012,30344
9776,23757,12454,11303,2012,30345
9777,4750,2180,2570,2012,30346
9778,67332,31590,35742,2012,30349
9779,33625,16167,17458,2012,30350
9780,15347,7048,8299,2012,30354
9781,15225,8314,6911,2012,30360
9782,2491,1347,1144,2012,30363
9783,13663,6372,7291,2012,30401
9784,2135,1306,829,2012,30410
9785,5397,4269,1128,2012,30411
9786,73,31,42,2012,30412
9787,1557,763,794,2012,30413
9788,7441,3831,3610,2012,30415
9789,10977,5294,5683,2012,30417
9790,1355,706,649,2012,30420
9791,3348,1743,1605,2012,30421
9792,80,21,59,2012,30423
9793,1299,679,620,2012,30425
9794,919,553,366,2012,30426
9795,11700,6694,5006,2012,30427
9796,2111,871,1240,2012,30428
9797,325,177,148,2012,30429
9798,6160,3061,3099,2012,30434
9799,11597,5696,5901,2012,30436
9800,65,37,28,2012,30438
9801,10900,5318,5582,2012,30439
9802,1904,1003,901,2012,30441
9803,7012,3087,3925,2012,30442
9804,3297,1588,1709,2012,30445
9805,1872,1015,857,2012,30446
9806,109,74,35,2012,30448
9807,72,39,33,2012,30449
9808,2499,1237,1262,2012,30450
9809,41,21,20,2012,30451
9810,1473,699,774,2012,30452
9811,9969,5956,4013,2012,30453
9812,197,77,120,2012,30454
9813,463,244,219,2012,30455
9814,2192,1085,1107,2012,30456
9815,6506,3404,3102,2012,30457
9816,41574,20444,21130,2012,30458
9817,510,230,280,2012,30460
9818,13617,6882,6735,2012,30461
9819,86,51,35,2012,30464
9820,12412,5879,6533,2012,30467
9821,547,240,307,2012,30470
9822,4506,2437,2069,2012,30471
9823,2893,1516,1377,2012,30473
9824,16694,7611,9083,2012,30474
9825,0,0,0,2012,30475
9826,3142,1418,1724,2012,30477
9827,25900,12885,13015,2012,30501
9828,22075,11461,10614,2012,30504
9829,42387,20812,21575,2012,30506
9830,29310,14622,14688,2012,30507
9831,8228,3491,4737,2012,30510
9832,3467,1833,1634,2012,30511
9833,19432,9402,10030,2012,30512
9834,10394,4942,5452,2012,30513
9835,1968,1077,891,2012,30516
9836,12582,6245,6337,2012,30517
9837,46466,22677,23789,2012,30518
9838,40455,20739,19716,2012,30519
9839,4191,2154,2037,2012,30520
9840,4600,2236,2364,2012,30521
9841,836,360,476,2012,30522
9842,12466,6101,6365,2012,30523
9843,7612,3439,4173,2012,30525
9844,3813,1963,1850,2012,30527
9845,22757,11445,11312,2012,30528
9846,10737,5073,5664,2012,30529
9847,7446,3812,3634,2012,30530
9848,11595,5443,6152,2012,30531
9849,25314,12615,12699,2012,30533
9850,27537,13479,14058,2012,30534
9851,7221,3311,3910,2012,30535
9852,7807,4098,3709,2012,30536
9853,1577,789,788,2012,30537
9854,2697,1329,1368,2012,30538
9855,17921,8763,9158,2012,30540
9856,2055,1079,976,2012,30541
9857,32810,16373,16437,2012,30542
9858,3941,1976,1965,2012,30543
9859,646,261,385,2012,30545
9860,7074,3463,3611,2012,30546
9861,3522,1681,1841,2012,30547
9862,15578,7651,7927,2012,30548
9863,21950,11139,10811,2012,30549
9864,1648,981,667,2012,30552
9865,7283,3592,3691,2012,30553
9866,7819,3788,4031,2012,30554
9867,2199,1104,1095,2012,30555
9868,4220,2108,2112,2012,30557
9869,5896,3025,2871,2012,30558
9870,3883,1863,2020,2012,30559
9871,4881,2405,2476,2012,30560
9872,766,327,439,2012,30562
9873,5188,2698,2490,2012,30563
9874,4371,2456,1915,2012,30564
9875,4002,2001,2001,2012,30565
9876,8609,4111,4498,2012,30566
9877,2830,1406,1424,2012,30567
9878,2106,1166,940,2012,30568
9879,3838,1865,1973,2012,30571
9880,1263,646,617,2012,30572
9881,68,30,38,2012,30573
9882,1659,931,728,2012,30575
9883,2395,1116,1279,2012,30576
9884,22525,10703,11822,2012,30577
9885,0,0,0,2012,30581
9886,4176,1948,2228,2012,30582
9887,20414,10105,10309,2012,30601
9888,2670,1089,1581,2012,30602
9889,39582,18704,20878,2012,30605
9890,40575,19338,21237,2012,30606
9891,12094,5987,6107,2012,30607
9892,1751,411,1340,2012,30609
9893,1576,773,803,2012,30619
9894,11700,5899,5801,2012,30620
9895,4324,2097,2227,2012,30621
9896,10016,4737,5279,2012,30622
9897,96,49,47,2012,30623
9898,3031,1536,1495,2012,30624
9899,2090,1057,1033,2012,30625
9900,1944,945,999,2012,30627
9901,6433,3343,3090,2012,30628
9902,4399,2017,2382,2012,30629
9903,2670,1395,1275,2012,30630
9904,1672,754,918,2012,30631
9905,8705,4427,4278,2012,30633
9906,2445,1376,1069,2012,30634
9907,16296,7641,8655,2012,30635
9908,1965,972,993,2012,30641
9909,10711,5383,5328,2012,30642
9910,16019,7647,8372,2012,30643
9911,7079,3272,3807,2012,30646
9912,2833,1284,1549,2012,30648
9913,12238,5713,6525,2012,30650
9914,23156,10943,12213,2012,30655
9915,15378,7673,7705,2012,30656
9916,1086,478,608,2012,30660
9917,8849,4395,4454,2012,30662
9918,3110,1579,1531,2012,30663
9919,12,6,6,2012,30664
9920,65,37,28,2012,30665
9921,8596,4075,4521,2012,30666
9922,1001,447,554,2012,30667
9923,2096,1110,986,2012,30668
9924,3614,1718,1896,2012,30669
9925,7752,3707,4045,2012,30673
9926,16576,8292,8284,2012,30677
9927,1286,694,592,2012,30678
9928,38799,19607,19192,2012,30680
9929,7398,3812,3586,2012,30683
9930,39890,19726,20164,2012,30701
9931,33934,16648,17286,2012,30705
9932,16435,8031,8404,2012,30707
9933,357,147,210,2012,30708
9934,6543,3345,3198,2012,30710
9935,3528,1838,1690,2012,30711
9936,28363,13591,14772,2012,30720
9937,51841,26280,25561,2012,30721
9938,3309,1547,1762,2012,30725
9939,0,0,0,2012,30726
9940,19281,9438,9843,2012,30728
9941,1627,802,825,2012,30730
9942,2142,1119,1023,2012,30731
9943,1810,765,1045,2012,30733
9944,3113,1591,1522,2012,30734
9945,5945,3116,2829,2012,30735
9946,41739,20492,21247,2012,30736
9947,3426,1680,1746,2012,30738
9948,5989,3063,2926,2012,30739
9949,8514,4270,4244,2012,30740
9950,30631,14979,15652,2012,30741
9951,6978,3126,3852,2012,30742
9952,1416,762,654,2012,30746
9953,16454,8735,7719,2012,30747
9954,4687,2114,2573,2012,30750
9955,104,50,54,2012,30751
9956,9326,4647,4679,2012,30752
9957,7789,3749,4040,2012,30753
9958,9007,4547,4460,2012,30755
9959,227,115,112,2012,30756
9960,2399,1304,1095,2012,30757
9961,5928,2811,3117,2012,30802
9962,662,358,304,2012,30803
9963,2130,984,1146,2012,30805
9964,97,35,62,2012,30807
9965,4710,2123,2587,2012,30808
9966,39972,19380,20592,2012,30809
9967,2173,1018,1155,2012,30810
9968,460,254,206,2012,30812
9969,31189,16142,15047,2012,30813
9970,8236,3725,4511,2012,30814
9971,41247,19432,21815,2012,30815
9972,2006,992,1014,2012,30816
9973,7679,3705,3974,2012,30817
9974,406,208,198,2012,30818
9975,1227,608,619,2012,30820
9976,1061,447,614,2012,30821
9977,975,523,452,2012,30822
9978,1707,780,927,2012,30823
9979,16999,8153,8846,2012,30824
9980,4058,1874,2184,2012,30828
9981,14444,6736,7708,2012,30830
9982,3969,1998,1971,2012,30833
9983,16838,8328,8510,2012,30901
9984,357,170,187,2012,30903
9985,26221,12760,13461,2012,30904
9986,6820,4333,2487,2012,30905
9987,61149,28614,32535,2012,30906
9988,49460,23937,25523,2012,30907
9989,37964,18222,19742,2012,30909
9990,247,110,137,2012,30912
9991,4706,3223,1483,2012,31001
9992,2984,1638,1346,2012,31002
9993,172,78,94,2012,31003
9994,14355,7266,7089,2012,31005
9995,4942,2549,2393,2012,31006
9996,1141,539,602,2012,31007
9997,18144,9021,9123,2012,31008
9998,1338,767,571,2012,31009
9999,1033,496,537,2012,31011
10000,3052,2343,709,2012,31012
10001,14215,6957,7258,2012,31014
10002,22152,10703,11449,2012,31015
10003,1101,569,532,2012,31016
10004,1707,666,1041,2012,31017
10005,3102,2205,897,2012,31018
10006,2359,1122,1237,2012,31019
10007,2367,1152,1215,2012,31020
10008,28702,13558,15144,2012,31021
10009,1251,617,634,2012,31022
10010,14479,6937,7542,2012,31023
10011,20573,10134,10439,2012,31024
10012,1657,856,801,2012,31025
10013,11039,5247,5792,2012,31027
10014,5540,2830,2710,2012,31028
10015,15989,7959,8030,2012,31029
10016,19834,9353,10481,2012,31030
10017,7065,3722,3343,2012,31031
10018,13179,6291,6888,2012,31032
10019,1682,735,947,2012,31033
10020,1330,621,709,2012,31035
10021,12551,5353,7198,2012,31036
10022,3654,2337,1317,2012,31037
10023,711,381,330,2012,31038
10024,0,0,0,2012,31039
10025,1092,612,480,2012,31041
10026,2101,936,1165,2012,31042
10027,2686,1327,1359,2012,31044
10028,83,44,39,2012,31045
10029,3434,1754,1680,2012,31046
10030,11071,5420,5651,2012,31047
10031,1621,706,915,2012,31049
10032,903,601,302,2012,31050
10033,161,71,90,2012,31051
10034,8274,4425,3849,2012,31052
10035,1698,731,967,2012,31054
10036,9379,5365,4014,2012,31055
10037,2107,983,1124,2012,31057
10038,1844,989,855,2012,31058
10039,1932,1019,913,2012,31060
10040,44340,22212,22128,2012,31061
10041,255,182,73,2012,31062
10042,5499,2539,2960,2012,31063
10043,9099,4468,4631,2012,31064
10044,921,501,420,2012,31065
10045,1091,596,495,2012,31066
10046,193,106,87,2012,31067
10047,5387,3362,2025,2012,31068
10048,20206,10365,9841,2012,31069
10049,1512,694,818,2012,31070
10050,1419,627,792,2012,31071
10051,1710,777,933,2012,31072
10052,1985,901,1084,2012,31075
10053,3203,1430,1773,2012,31076
10054,1068,495,573,2012,31077
10055,3308,1777,1531,2012,31078
10056,2036,1065,971,2012,31079
10057,47,0,47,2012,31081
10058,10065,4556,5509,2012,31082
10059,279,133,146,2012,31083
10060,96,5,91,2012,31084
10061,1313,633,680,2012,31085
10062,9463,5225,4238,2012,31087
10063,50323,24454,25869,2012,31088
10064,5107,2600,2507,2012,31089
10065,643,337,306,2012,31090
10066,5119,3355,1764,2012,31091
10067,6464,3067,3397,2012,31092
10068,28575,13010,15565,2012,31093
10069,719,336,383,2012,31094
10070,7389,4148,3241,2012,31096
10071,1036,504,532,2012,31097
10072,3150,1777,1373,2012,31098
10073,9176,4593,4583,2012,31201
10074,30395,13406,16989,2012,31204
10075,30332,13874,16458,2012,31206
10076,1323,281,1042,2012,31207
10077,31568,14571,16997,2012,31210
10078,16174,7761,8413,2012,31211
10079,0,0,0,2012,31213
10080,16127,8662,7465,2012,31216
10081,19512,9333,10179,2012,31217
10082,13963,6355,7608,2012,31220
10083,5264,2354,2910,2012,31301
10084,8689,4465,4224,2012,31302
10085,2253,1196,1057,2012,31303
10086,0,0,0,2012,31304
10087,7297,3525,3772,2012,31305
10088,392,172,220,2012,31307
10089,6452,3151,3301,2012,31308
10090,1078,565,513,2012,31309
10091,15190,7620,7570,2012,31312
10092,40706,19562,21144,2012,31313
10093,1600,1541,59,2012,31314
10094,8531,4175,4356,2012,31315
10095,9479,4598,4881,2012,31316
10096,360,157,203,2012,31318
10097,9280,4581,4699,2012,31320
10098,6406,3414,2992,2012,31321
10099,21012,10141,10871,2012,31322
10100,1627,750,877,2012,31323
10101,20717,10127,10590,2012,31324
10102,20062,9806,10256,2012,31326
10103,111,66,45,2012,31327
10104,3224,1493,1731,2012,31328
10105,9057,4304,4753,2012,31329
10106,6509,2843,3666,2012,31331
10107,20254,9496,10758,2012,31401
10108,31355,14775,16580,2012,31404
10109,36453,17796,18657,2012,31405
10110,34865,17114,17751,2012,31406
10111,7118,3410,3708,2012,31407
10112,10315,5638,4677,2012,31408
10113,290,268,22,2012,31409
10114,24102,11770,12332,2012,31410
10115,8082,3893,4189,2012,31411
10116,11366,5319,6047,2012,31415
10117,53818,25115,28703,2012,31419
10118,15346,7976,7370,2012,31501
10119,21432,10369,11063,2012,31503
10120,9875,4923,4952,2012,31510
10121,2284,1040,1244,2012,31512
10122,16686,8382,8304,2012,31513
10123,14293,6905,7388,2012,31516
10124,766,392,374,2012,31518
10125,3259,1499,1760,2012,31519
10126,21585,10501,11084,2012,31520
10127,14570,6870,7700,2012,31522
10128,13932,6580,7352,2012,31523
10129,0,0,0,2012,31524
10130,28217,13271,14946,2012,31525
10131,844,383,461,2012,31527
10132,1071,542,529,2012,31532
10133,16625,7684,8941,2012,31533
10134,12506,6101,6405,2012,31535
10135,10753,6054,4699,2012,31537
10136,13980,6991,6989,2012,31539
10137,2289,1038,1251,2012,31542
10138,4374,2300,2074,2012,31543
10139,608,279,329,2012,31544
10140,16115,7704,8411,2012,31545
10141,7990,4925,3065,2012,31546
10142,927,763,164,2012,31547
10143,20608,10027,10581,2012,31548
10144,1883,864,1019,2012,31549
10145,885,435,450,2012,31550
10146,1138,552,586,2012,31551
10147,1039,527,512,2012,31552
10148,4477,2392,2085,2012,31553
10149,7265,4816,2449,2012,31554
10150,2847,1572,1275,2012,31555
10151,155,68,87,2012,31556
10152,2999,1638,1361,2012,31557
10153,20171,10544,9627,2012,31558
10154,2856,1420,1436,2012,31560
10155,306,125,181,2012,31561
10156,2244,1297,947,2012,31562
10157,1138,618,520,2012,31563
10158,1929,1017,912,2012,31565
10159,4527,2108,2419,2012,31566
10160,1086,586,500,2012,31567
10161,988,541,447,2012,31568
10162,5706,2897,2809,2012,31569
10163,33958,16764,17194,2012,31601
10164,33643,16620,17023,2012,31602
10165,20985,10546,10439,2012,31605
10166,3775,1889,1886,2012,31606
10167,10629,5001,5628,2012,31620
10168,2004,910,1094,2012,31622
10169,74,47,27,2012,31623
10170,1001,464,537,2012,31624
10171,1331,652,679,2012,31625
10172,3732,1728,2004,2012,31626
10173,208,91,117,2012,31627
10174,931,444,487,2012,31629
10175,478,208,270,2012,31630
10176,698,389,309,2012,31631
10177,10277,4968,5309,2012,31632
10178,5835,2739,3096,2012,31634
10179,5825,2891,2934,2012,31635
10180,9771,4593,5178,2012,31636
10181,2783,1483,1300,2012,31637
10182,827,438,389,2012,31638
10183,10141,4838,5303,2012,31639
10184,2001,875,1126,2012,31641
10185,4861,2475,2386,2012,31642
10186,9107,4368,4739,2012,31643
10187,5559,2907,2652,2012,31645
10188,3411,1675,1736,2012,31647
10189,1096,434,662,2012,31648
10190,1496,677,819,2012,31649
10191,3275,1710,1565,2012,31650
10192,1667,371,1296,2012,31698
10193,296,253,43,2012,31699
10194,21677,9937,11740,2012,31701
10195,34725,16488,18237,2012,31705
10196,25700,11382,14318,2012,31707
10197,15395,7098,8297,2012,31709
10198,1027,396,631,2012,31711
10199,983,498,485,2012,31712
10200,6606,3166,3440,2012,31714
10201,2761,1246,1515,2012,31716
10202,10738,5266,5472,2012,31719
10203,447,171,276,2012,31720
10204,19728,9499,10229,2012,31721
10205,529,228,301,2012,31722
10206,9105,4344,4761,2012,31730
10207,1842,961,881,2012,31733
10208,828,344,484,2012,31735
10209,1996,1060,936,2012,31738
10210,447,232,215,2012,31743
10211,3122,1376,1746,2012,31744
10212,158,67,91,2012,31747
10213,3319,1778,1541,2012,31749
10214,19222,9268,9954,2012,31750
10215,1249,438,811,2012,31756
10216,10248,5066,5182,2012,31757
10217,23293,12136,11157,2012,31763
10218,1447,679,768,2012,31764
10219,2862,1347,1515,2012,31765
10220,23338,11694,11644,2012,31768
10221,6293,2869,3424,2012,31771
10222,568,206,362,2012,31772
10223,3328,1795,1533,2012,31773
10224,6150,3184,2966,2012,31774
10225,2827,1653,1174,2012,31775
10226,2267,1128,1139,2012,31778
10227,10328,5959,4369,2012,31779
10228,2298,1247,1051,2012,31780
10229,1829,907,922,2012,31781
10230,1073,535,538,2012,31783
10231,847,449,398,2012,31784
10232,1673,784,889,2012,31787
10233,10575,5650,4925,2012,31788
10234,1703,839,864,2012,31789
10235,1800,1062,738,2012,31790
10236,12008,5731,6277,2012,31791
10237,23646,10857,12789,2012,31792
10238,8558,4280,4278,2012,31793
10239,26905,12461,14444,2012,31794
10240,2317,1098,1219,2012,31795
10241,1377,696,681,2012,31796
10242,789,393,396,2012,31798
10243,2208,1073,1135,2012,31801
10244,6306,3147,3159,2012,31803
10245,5351,2601,2750,2012,31804
10246,3111,1574,1537,2012,31805
10247,4818,2450,2368,2012,31806
10248,2116,1223,893,2012,31807
10249,6455,3387,3068,2012,31808
10250,189,113,76,2012,31810
10251,5549,2906,2643,2012,31811
10252,448,203,245,2012,31812
10253,230,118,112,2012,31814
10254,2746,1825,921,2012,31815
10255,5376,2280,3096,2012,31816
10256,8916,4328,4588,2012,31820
10257,447,265,182,2012,31821
10258,5680,2819,2861,2012,31822
10259,913,447,466,2012,31823
10260,1878,882,996,2012,31824
10261,2846,1604,1242,2012,31825
10262,2476,1114,1362,2012,31826
10263,2828,1312,1516,2012,31827
10264,1406,625,781,2012,31829
10265,2110,1011,1099,2012,31830
10266,3163,1397,1766,2012,31831
10267,181,86,95,2012,31832
10268,6980,3682,3298,2012,31833
10269,906,494,412,2012,31836
10270,7650,3833,3817,2012,31901
10271,21748,9711,12037,2012,31903
10272,31007,14408,16599,2012,31904
10273,19459,14232,5227,2012,31905
10274,20729,9494,11235,2012,31906
10275,57265,26965,30300,2012,31907
10276,33801,14871,18930,2012,31909
10277,28493,13971,14522,2012,32003
10278,5159,2511,2648,2012,32008
10279,2937,1548,1389,2012,32009
10280,14034,7211,6823,2012,32011
10281,20287,10419,9868,2012,32024
10282,22463,12206,10257,2012,32025
10283,1016,1016,0,2012,32026
10284,4618,2316,2302,2012,32033
10285,30605,14685,15920,2012,32034
10286,8274,4101,4173,2012,32038
10287,7497,3862,3635,2012,32040
10288,24462,11923,12539,2012,32043
10289,2071,1121,950,2012,32044
10290,9580,4618,4962,2012,32046
10291,9217,5880,3337,2012,32052
10292,3673,1856,1817,2012,32053
10293,11850,7205,4645,2012,32054
10294,17163,8594,8569,2012,32055
10295,5197,3217,1980,2012,32058
10296,2208,1007,1201,2012,32059
10297,22524,11511,11013,2012,32060
10298,189,80,109,2012,32061
10299,2140,1087,1053,2012,32062
10300,13794,6571,7223,2012,32063
10301,6848,3456,3392,2012,32064
10302,33901,16970,16931,2012,32065
10303,7082,4090,2992,2012,32066
10304,48758,23668,25090,2012,32068
10305,2731,1409,1322,2012,32071
10306,62,26,36,2012,32072
10307,40087,19310,20777,2012,32073
10308,299,83,216,2012,32079
10309,20841,9860,10981,2012,32080
10310,3880,1814,2066,2012,32081
10311,29094,13888,15206,2012,32082
10312,4808,3914,894,2012,32083
10313,30710,14421,16289,2012,32084
10314,25031,12031,13000,2012,32086
10315,5553,3534,2019,2012,32087
10316,14438,7245,7193,2012,32091
10317,28308,14204,14104,2012,32092
10318,1968,1060,908,2012,32094
10319,7055,3637,3418,2012,32095
10320,2585,1450,1135,2012,32096
10321,16018,7814,8204,2012,32097
10322,2030,1110,920,2012,32102
10323,7407,3202,4205,2012,32110
10324,8058,4161,3897,2012,32112
10325,5170,2185,2985,2012,32113
10326,33221,16295,16926,2012,32114
10327,24564,11418,13146,2012,32117
10328,16392,7839,8553,2012,32118
10329,20063,9817,10246,2012,32119
10330,5066,3418,1648,2012,32124
10331,29075,13680,15395,2012,32127
10332,16744,8114,8630,2012,32128
10333,20354,9816,10538,2012,32129
10334,6528,2886,3642,2012,32130
10335,4597,2448,2149,2012,32131
10336,6421,2971,3450,2012,32132
10337,80,40,40,2012,32133
10338,8397,4157,4240,2012,32134
10339,7540,3785,3755,2012,32136
10340,36548,17922,18626,2012,32137
10341,1077,489,588,2012,32139
10342,1034,573,461,2012,32140
10343,18492,9339,9153,2012,32141
10344,4762,2584,2178,2012,32145
10345,247,196,51,2012,32147
10346,10713,5498,5215,2012,32148
10347,488,271,217,2012,32157
10348,29698,13728,15970,2012,32159
10349,43460,20398,23062,2012,32162
10350,43200,20523,22677,2012,32164
10351,25333,12383,12950,2012,32168
10352,9983,4720,5263,2012,32169
10353,45625,22087,23538,2012,32174
10354,14508,7211,7297,2012,32176
10355,27408,12863,14545,2012,32177
10356,6924,3732,3192,2012,32179
10357,4313,2300,2013,2012,32180
10358,2434,1213,1221,2012,32181
10359,1891,1064,827,2012,32187
10360,6052,3037,3015,2012,32189
10361,448,273,175,2012,32190
10362,1051,543,508,2012,32193
10363,2904,1368,1536,2012,32195
10364,6127,4199,1928,2012,32202
10365,6384,3136,3248,2012,32204
10366,28612,13528,15084,2012,32205
10367,17140,8342,8798,2012,32206
10368,31990,15826,16164,2012,32207
10369,30229,14633,15596,2012,32208
10370,34511,15210,19301,2012,32209
10371,57704,26592,31112,2012,32210
10372,30265,15169,15096,2012,32211
10373,1370,945,425,2012,32212
10374,34458,16841,17617,2012,32216
10375,20200,10367,9833,2012,32217
10376,55200,27022,28178,2012,32218
10377,11929,5622,6307,2012,32219
10378,14163,7148,7015,2012,32220
10379,27760,13169,14591,2012,32221
10380,10171,5084,5087,2012,32222
10381,24543,12032,12511,2012,32223
10382,37153,17458,19695,2012,32224
10383,53143,26238,26905,2012,32225
10384,15372,7284,8088,2012,32226
10385,3006,1915,1091,2012,32227
10386,178,145,33,2012,32228
10387,23134,11752,11382,2012,32233
10388,5439,2646,2793,2012,32234
10389,60796,29740,31056,2012,32244
10390,48285,23234,25051,2012,32246
10391,25903,13173,12730,2012,32250
10392,13807,6344,7463,2012,32254
10393,39862,18408,21454,2012,32256
10394,35542,16376,19166,2012,32257
10395,26253,12933,13320,2012,32258
10396,37163,18246,18917,2012,32259
10397,6886,3491,3395,2012,32266
10398,30361,15039,15322,2012,32277
10399,28199,12746,15453,2012,32301
10400,47953,23390,24563,2012,32303
10401,46695,23308,23387,2012,32304
10402,19938,8876,11062,2012,32305
10403,21363,9516,11847,2012,32308
10404,31077,14974,16103,2012,32309
10405,17602,9249,8353,2012,32310
10406,18437,8091,10346,2012,32311
10407,31586,14681,16905,2012,32312
10408,13656,6605,7051,2012,32317
10409,3465,1789,1676,2012,32320
10410,6660,4274,2386,2012,32321
10411,4264,2865,1399,2012,32322
10412,135,74,61,2012,32323
10413,4870,2684,2186,2012,32324
10414,27113,15053,12060,2012,32327
10415,3192,1694,1498,2012,32328
10416,946,460,486,2012,32330
10417,5133,2676,2457,2012,32331
10418,1691,832,859,2012,32332
10419,10215,5090,5125,2012,32333
10420,1639,918,721,2012,32334
10421,1357,615,742,2012,32336
10422,11326,6342,4984,2012,32340
10423,2996,1352,1644,2012,32343
10424,12762,6667,6095,2012,32344
10425,1653,830,823,2012,32346
10426,8471,4562,3909,2012,32347
10427,11719,6727,4992,2012,32348
10428,1814,828,986,2012,32350
10429,19663,9462,10201,2012,32351
10430,6442,3232,3210,2012,32352
10431,253,136,117,2012,32355
10432,56,36,20,2012,32356
10433,1906,882,1024,2012,32358
10434,1806,840,966,2012,32359
10435,157,64,93,2012,32361
10436,0,0,0,2012,32399
10437,23395,10731,12664,2012,32401
10438,3885,2496,1389,2012,32403
10439,36090,18587,17503,2012,32404
10440,30653,14769,15884,2012,32405
10441,8882,4381,4501,2012,32407
10442,16418,8505,7913,2012,32408
10443,8056,4126,3930,2012,32409
10444,823,371,452,2012,32410
10445,12328,5745,6583,2012,32413
10446,2057,977,1080,2012,32420
10447,4414,2296,2118,2012,32421
10448,1343,724,619,2012,32423
10449,7946,4362,3584,2012,32424
10450,14164,7851,6313,2012,32425
10451,822,473,349,2012,32426
10452,1445,660,785,2012,32427
10453,17015,9366,7649,2012,32428
10454,1020,505,515,2012,32430
10455,4414,2086,2328,2012,32431
10456,0,0,0,2012,32432
10457,15484,8525,6959,2012,32433
10458,7162,3659,3503,2012,32435
10459,754,373,381,2012,32437
10460,4046,2191,1855,2012,32438
10461,8238,4168,4070,2012,32439
10462,7455,4394,3061,2012,32440
10463,3582,1767,1815,2012,32442
10464,2849,1359,1490,2012,32443
10465,19254,9339,9915,2012,32444
10466,3121,2242,879,2012,32445
10467,11582,5948,5634,2012,32446
10468,339,322,17,2012,32447
10469,8325,4424,3901,2012,32448
10470,659,359,300,2012,32449
10471,4431,2444,1987,2012,32455
10472,7554,3706,3848,2012,32456
10473,11977,5878,6099,2012,32459
10474,5858,3747,2111,2012,32460
10475,28,13,15,2012,32461
10476,3938,2164,1774,2012,32462
10477,97,40,57,2012,32463
10478,3716,1649,2067,2012,32464
10479,8655,5542,3113,2012,32465
10480,6239,2806,3433,2012,32466
10481,12277,6754,5523,2012,32501
10482,2895,1504,1391,2012,32502
10483,34416,15891,18525,2012,32503
10484,22055,10590,11465,2012,32504
10485,25619,12176,13443,2012,32505
10486,35414,16503,18911,2012,32506
10487,27496,14130,13366,2012,32507
10488,6524,5206,1318,2012,32508
10489,668,668,0,2012,32509
10490,977,812,165,2012,32511
10491,38406,18100,20306,2012,32514
10492,35105,17229,17876,2012,32526
10493,95,0,95,2012,32530
10494,5079,2355,2724,2012,32531
10495,26962,13045,13917,2012,32533
10496,13264,6159,7105,2012,32534
10497,6334,3859,2475,2012,32535
10498,19921,9802,10119,2012,32536
10499,25090,12679,12411,2012,32539
10500,15558,7969,7589,2012,32541
10501,3542,2060,1482,2012,32542
10502,1862,1228,634,2012,32544
10503,34201,17315,16886,2012,32547
10504,19808,10401,9407,2012,32548
10505,5957,2678,3279,2012,32550
10506,8714,4516,4198,2012,32561
10507,23863,11517,12346,2012,32563
10508,2792,1495,1297,2012,32564
10509,6100,3056,3044,2012,32565
10510,34005,16987,17018,2012,32566
10511,3420,1698,1722,2012,32567
10512,2836,1345,1491,2012,32568
10513,10638,5197,5441,2012,32569
10514,28004,13929,14075,2012,32570
10515,30282,15079,15203,2012,32571
10516,4744,2454,2290,2012,32577
10517,30374,14785,15589,2012,32578
10518,9944,4540,5404,2012,32579
10519,4197,2175,2022,2012,32580
10520,24415,13442,10973,2012,32583
10521,18997,9372,9625,2012,32601
10522,8396,4107,4289,2012,32603
10523,23302,11393,11909,2012,32605
10524,22510,11310,11200,2012,32606
10525,30023,14222,15801,2012,32607
10526,43101,20514,22587,2012,32608
10527,18778,9789,8989,2012,32609
10528,6707,2565,4142,2012,32612
10529,15365,7349,8016,2012,32615
10530,614,197,417,2012,32616
10531,4045,2059,1986,2012,32617
10532,7008,3546,3462,2012,32618
10533,5170,2694,2476,2012,32619
10534,5495,2743,2752,2012,32621
10535,1245,568,677,2012,32622
10536,1570,749,821,2012,32625
10537,8702,4098,4604,2012,32626
10538,5220,2888,2332,2012,32628
10539,303,140,163,2012,32631
10540,189,83,106,2012,32639
10541,10547,5319,5228,2012,32640
10542,13054,6281,6773,2012,32641
10543,9903,4745,5158,2012,32643
10544,429,231,198,2012,32648
10545,13580,6785,6795,2012,32653
10546,14100,7300,6800,2012,32656
10547,109,60,49,2012,32658
10548,356,146,210,2012,32664
10549,6478,3351,3127,2012,32666
10550,3641,1834,1807,2012,32667
10551,4696,2375,2321,2012,32668
10552,11478,5437,6041,2012,32669
10553,9810,4984,4826,2012,32680
10554,150,138,12,2012,32681
10555,321,143,178,2012,32683
10556,5823,3070,2753,2012,32686
10557,285,157,128,2012,32692
10558,13203,6757,6446,2012,32693
10559,2416,1121,1295,2012,32694
10560,10616,5190,5426,2012,32696
10561,228,116,112,2012,32697
10562,21844,10088,11756,2012,32701
10563,2662,1240,1422,2012,32702
10564,46987,23503,23484,2012,32703
10565,34690,17175,17515,2012,32707
10566,42716,20257,22459,2012,32708
10567,2796,1220,1576,2012,32709
10568,41354,20127,21227,2012,32712
10569,19424,9983,9441,2012,32713
10570,34763,16603,18160,2012,32714
10571,31760,15310,16450,2012,32720
10572,31551,14745,16806,2012,32724
10573,45165,21786,23379,2012,32725
10574,19680,9300,10380,2012,32726
10575,5543,2705,2838,2012,32730
10576,4043,2104,1939,2012,32732
10577,3317,1457,1860,2012,32735
10578,8478,4530,3948,2012,32736
10579,43369,22169,21200,2012,32738
10580,3294,1588,1706,2012,32744
10581,40677,19730,20947,2012,32746
10582,22761,11160,11601,2012,32750
10583,20264,9487,10777,2012,32751
10584,10158,5251,4907,2012,32754
10585,22867,10715,12152,2012,32757
10586,2969,1530,1439,2012,32759
10587,21006,10170,10836,2012,32763
10588,3603,1724,1879,2012,32764
10589,57953,28236,29717,2012,32765
10590,15387,7790,7597,2012,32766
10591,3400,1913,1487,2012,32767
10592,47212,22488,24724,2012,32771
10593,28361,14452,13909,2012,32773
10594,9358,4646,4712,2012,32776
10595,19289,9570,9719,2012,32778
10596,28563,13722,14841,2012,32779
10597,34722,16727,17995,2012,32780
10598,11389,5888,5501,2012,32784
10599,24808,12091,12717,2012,32789
10600,47716,23848,23868,2012,32792
10601,20854,10065,10789,2012,32796
10602,2450,1197,1253,2012,32798
10603,10112,5071,5041,2012,32801
10604,18245,8802,9443,2012,32803
10605,16581,8382,8199,2012,32804
10606,22369,10207,12162,2012,32805
10607,24748,12489,12259,2012,32806
10608,32265,17036,15229,2012,32807
10609,51794,24647,27147,2012,32808
10610,24741,11948,12793,2012,32809
10611,32269,15481,16788,2012,32810
10612,37385,17990,19395,2012,32811
10613,37164,17846,19318,2012,32812
10614,5181,2341,2840,2012,32814
10615,32798,17205,15593,2012,32817
10616,45955,22000,23955,2012,32818
10617,24925,12213,12712,2012,32819
10618,8652,4426,4226,2012,32820
10619,15685,7740,7945,2012,32821
10620,54772,27622,27150,2012,32822
10621,36212,17319,18893,2012,32824
10622,58250,27889,30361,2012,32825
10623,27126,13788,13338,2012,32826
10624,6261,3101,3160,2012,32827
10625,58633,28949,29684,2012,32828
10626,20142,9550,10592,2012,32829
10627,6,2,4,2012,32830
10628,2518,2387,131,2012,32831
10629,15043,7050,7993,2012,32832
10630,9621,4862,4759,2012,32833
10631,44329,22163,22166,2012,32835
10632,17717,8993,8724,2012,32836
10633,51812,25351,26461,2012,32837
10634,44036,22820,21216,2012,32839
10635,24533,11928,12605,2012,32901
10636,13363,6791,6572,2012,32903
10637,26395,12806,13589,2012,32904
10638,21424,9988,11436,2012,32905
10639,41425,20684,20741,2012,32907
10640,10828,5072,5756,2012,32908
10641,30944,13982,16962,2012,32909
10642,9884,5168,4716,2012,32920
10643,15207,7012,8195,2012,32922
10644,1320,793,527,2012,32925
10645,22820,12231,10589,2012,32926
10646,26517,13743,12774,2012,32927
10647,13793,6396,7397,2012,32931
10648,18248,9039,9209,2012,32934
10649,39151,19261,19890,2012,32935
10650,25124,12397,12727,2012,32937
10651,32363,15772,16591,2012,32940
10652,7484,3921,3563,2012,32948
10653,2412,1289,1123,2012,32949
10654,3939,1970,1969,2012,32950
10655,11542,5714,5828,2012,32951
10656,20300,10290,10010,2012,32952
10657,22112,10874,11238,2012,32953
10658,35983,16945,19038,2012,32955
10659,25247,12395,12852,2012,32958
10660,20123,9834,10289,2012,32960
10661,21730,10600,11130,2012,32962
10662,15395,7001,8394,2012,32963
10663,15180,6829,8351,2012,32966
10664,19439,9459,9980,2012,32967
10665,13224,6578,6646,2012,32968
10666,535,240,295,2012,32970
10667,8852,4276,4576,2012,32976
10668,243,148,95,2012,33001
10669,14818,6785,8033,2012,33004
10670,39499,19028,20471,2012,33009
10671,45600,22621,22979,2012,33010
10672,74418,35465,38953,2012,33012
10673,32220,15370,16850,2012,33013
10674,40816,19049,21767,2012,33014
10675,63733,28898,34835,2012,33015
10676,46394,21633,24761,2012,33016
10677,46409,22135,24274,2012,33018
10678,14685,6964,7721,2012,33019
10679,41257,20506,20751,2012,33020
10680,48005,22893,25112,2012,33021
10681,63587,29806,33781,2012,33023
10682,67043,32415,34628,2012,33024
10683,56388,26908,29480,2012,33025
10684,29525,13922,15603,2012,33026
10685,57114,25776,31338,2012,33027
10686,26566,13156,13410,2012,33028
10687,45984,22386,23598,2012,33029
10688,32808,16490,16318,2012,33030
10689,6552,3360,3192,2012,33031
10690,35227,16758,18469,2012,33032
10691,50018,25174,24844,2012,33033
10692,27587,18097,9490,2012,33034
10693,12762,5818,6944,2012,33035
10694,3671,2029,1642,2012,33036
10695,12510,6145,6365,2012,33037
10696,205,85,120,2012,33039
10697,32543,17816,14727,2012,33040
10698,6039,3276,2763,2012,33042
10699,3821,2077,1744,2012,33043
10700,8923,5003,3920,2012,33050
10701,565,280,285,2012,33051
10702,29426,13046,16380,2012,33054
10703,43781,20318,23463,2012,33055
10704,35217,15955,19262,2012,33056
10705,32853,17257,15596,2012,33060
10706,23033,11328,11705,2012,33062
10707,52264,24619,27645,2012,33063
10708,54866,27461,27405,2012,33064
10709,51600,24570,27030,2012,33065
10710,15859,6828,9031,2012,33066
10711,24952,11846,13106,2012,33067
10712,49007,23238,25769,2012,33068
10713,24914,13009,11905,2012,33069
10714,5053,2450,2603,2012,33070
10715,38877,18615,20262,2012,33071
10716,29344,14337,15007,2012,33073
10717,30840,15514,15326,2012,33076
10718,0,0,0,2012,33101
10719,482,190,292,2012,33109
10720,0,0,0,2012,33122
10721,52821,25493,27328,2012,33125
10722,46880,22066,24814,2012,33126
10723,29801,14529,15272,2012,33127
10724,7652,4026,3626,2012,33128
10725,13086,6426,6660,2012,33129
10726,23717,12296,11421,2012,33130
10727,13082,6221,6861,2012,33131
10728,8424,5184,3240,2012,33132
10729,33553,16487,17066,2012,33133
10730,37554,17215,20339,2012,33134
10731,35709,17312,18397,2012,33135
10732,13162,6363,6799,2012,33136
10733,19737,10807,8930,2012,33137
10734,28101,14032,14069,2012,33138
10735,38665,22783,15882,2012,33139
10736,21424,10917,10507,2012,33140
10737,36319,17534,18785,2012,33141
10738,55089,27154,27935,2012,33142
10739,31110,14724,16386,2012,33143
10740,25976,12754,13222,2012,33144
10741,31124,15062,16062,2012,33145
10742,15510,7603,7907,2012,33146
10743,44278,20567,23711,2012,33147
10744,12385,5998,6387,2012,33149
10745,27929,13199,14730,2012,33150
10746,14078,6909,7169,2012,33154
10747,46603,22655,23948,2012,33155
10748,31537,15571,15966,2012,33156
10749,66756,32146,34610,2012,33157
10750,6719,3303,3416,2012,33158
10751,36968,18216,18752,2012,33160
10752,52622,24857,27765,2012,33161
10753,45754,21456,24298,2012,33162
10754,55492,26207,29285,2012,33165
10755,21993,11359,10634,2012,33166
10756,18835,8858,9977,2012,33167
10757,27739,13487,14252,2012,33168
10758,38309,17960,20349,2012,33169
10759,12096,5813,6283,2012,33170
10760,36940,17519,19421,2012,33172
10761,35455,16001,19454,2012,33173
10762,29094,13525,15569,2012,33174
10763,53933,25990,27943,2012,33175
10764,50661,24397,26264,2012,33176
10765,54808,27951,26857,2012,33177
10766,41780,21627,20153,2012,33178
10767,40591,18446,22145,2012,33179
10768,32159,14878,17281,2012,33180
10769,17509,8835,8674,2012,33181
10770,15317,8171,7146,2012,33182
10771,35708,16440,19268,2012,33183
10772,20877,9571,11306,2012,33184
10773,28271,13772,14499,2012,33185
10774,70969,33285,37684,2012,33186
10775,15995,7411,8584,2012,33187
10776,21812,10263,11549,2012,33189
10777,11647,5837,5810,2012,33190
10778,44175,21520,22655,2012,33193
10779,7581,4384,3197,2012,33194
10780,44702,21447,23255,2012,33196
10781,13459,7897,5562,2012,33301
10782,18120,10256,7864,2012,33304
10783,11292,6702,4590,2012,33305
10784,3243,1970,1273,2012,33306
10785,27548,14139,13409,2012,33308
10786,35254,18370,16884,2012,33309
10787,63598,29647,33951,2012,33311
10788,53571,27751,25820,2012,33312
10789,57469,27247,30222,2012,33313
10790,21445,10742,10703,2012,33314
10791,11494,6118,5376,2012,33315
10792,11098,5854,5244,2012,33316
10793,35691,18212,17479,2012,33317
10794,45335,20732,24603,2012,33319
10795,44235,20107,24128,2012,33321
10796,35852,15976,19876,2012,33322
10797,19212,9161,10051,2012,33323
10798,44706,20755,23951,2012,33324
10799,28417,13556,14861,2012,33325
10800,31655,15353,16302,2012,33326
10801,21296,10305,10991,2012,33327
10802,28101,13380,14721,2012,33328
10803,13150,6448,6702,2012,33330
10804,23127,11195,11932,2012,33331
10805,12328,5705,6623,2012,33332
10806,28296,15407,12889,2012,33334
10807,34708,16208,18500,2012,33351
10808,23587,10928,12659,2012,33401
10809,11841,5706,6135,2012,33403
10810,26755,12908,13847,2012,33404
10811,21256,10859,10397,2012,33405
10812,25896,13470,12426,2012,33406
10813,29351,14766,14585,2012,33407
10814,17689,8529,9160,2012,33408
10815,29651,15324,14327,2012,33409
10816,32979,15028,17951,2012,33410
10817,63313,30209,33104,2012,33411
10818,14600,7077,7523,2012,33412
10819,14293,7090,7203,2012,33413
10820,53682,25836,27846,2012,33414
10821,43742,21032,22710,2012,33415
10822,30644,13744,16900,2012,33417
10823,35775,16773,19002,2012,33418
10824,20081,9751,10330,2012,33426
10825,38504,18915,19589,2012,33428
10826,21316,11304,10012,2012,33430
10827,17651,8845,8806,2012,33431
10828,18958,9567,9391,2012,33432
10829,42538,18390,24148,2012,33433
10830,19322,8777,10545,2012,33434
10831,32668,15284,17384,2012,33435
10832,41700,18889,22811,2012,33436
10833,36181,16720,19461,2012,33437
10834,494,315,179,2012,33438
10835,18690,9965,8725,2012,33440
10836,26714,13098,13616,2012,33441
10837,28699,13217,15482,2012,33442
10838,20165,10326,9839,2012,33444
10839,30655,14569,16086,2012,33445
10840,22086,10220,11866,2012,33446
10841,9449,4652,4797,2012,33449
10842,20002,9538,10464,2012,33455
10843,49514,24089,25425,2012,33458
10844,30497,17221,13276,2012,33460
10845,40826,20378,20448,2012,33461
10846,31473,15803,15670,2012,33462
10847,55310,27590,27720,2012,33463
10848,51134,24340,26794,2012,33467
10849,13555,6553,7002,2012,33469
10850,26204,13506,12698,2012,33470
10851,7049,4040,3009,2012,33471
10852,19115,9201,9914,2012,33472
10853,5628,2845,2783,2012,33473
10854,7767,3748,4019,2012,33476
10855,11947,5481,6466,2012,33477
10856,11797,5775,6022,2012,33478
10857,9605,4247,5358,2012,33480
10858,12692,6208,6484,2012,33483
10859,23595,10119,13476,2012,33484
10860,21899,10667,11232,2012,33486
10861,17113,8567,8546,2012,33487
10862,4954,3350,1604,2012,33493
10863,22675,10860,11815,2012,33496
10864,15417,7389,8028,2012,33498
10865,17,4,13,2012,33503
10866,26792,12546,14246,2012,33510
10867,51784,25207,26577,2012,33511
10868,11946,6968,4978,2012,33513
10869,2227,1124,1103,2012,33514
10870,634,271,363,2012,33521
10871,19710,9990,9720,2012,33523
10872,18494,9314,9180,2012,33525
10873,14986,8022,6964,2012,33527
10874,14344,7127,7217,2012,33534
10875,5244,2635,2609,2012,33538
10876,9498,4262,5236,2012,33540
10877,20983,10613,10370,2012,33541
10878,20957,9994,10963,2012,33542
10879,22220,10664,11556,2012,33543
10880,23806,11452,12354,2012,33544
10881,12365,6059,6306,2012,33545
10882,20024,9516,10508,2012,33547
10883,5989,2799,3190,2012,33548
10884,16024,7569,8455,2012,33549
10885,21212,10769,10443,2012,33556
10886,19754,9556,10198,2012,33558
10887,16176,7793,8383,2012,33559
10888,25178,12104,13074,2012,33563
10889,18416,8905,9511,2012,33565
10890,20593,10208,10385,2012,33566
10891,10118,4951,5167,2012,33567
10892,23528,11461,12067,2012,33569
10893,19713,9892,9821,2012,33570
10894,14594,7479,7115,2012,33572
10895,20258,8681,11577,2012,33573
10896,3931,1777,2154,2012,33576
10897,36632,17976,18656,2012,33578
10898,23680,12177,11503,2012,33579
10899,25706,12547,13159,2012,33584
10900,1375,811,564,2012,33585
10901,10498,5410,5088,2012,33592
10902,32759,16281,16478,2012,33594
10903,29207,14797,14410,2012,33596
10904,8117,4028,4089,2012,33597
10905,12662,6118,6544,2012,33598
10906,11484,5931,5553,2012,33602
10907,18805,9352,9453,2012,33603
10908,37801,18373,19428,2012,33604
10909,16381,8052,8329,2012,33605
10910,17173,8870,8303,2012,33606
10911,24140,10974,13166,2012,33607
10912,17197,8613,8584,2012,33609
10913,41120,19165,21955,2012,33610
10914,30147,15134,15013,2012,33611
10915,44965,21780,23185,2012,33612
10916,31389,14091,17298,2012,33613
10917,47421,23870,23551,2012,33614
10918,45916,22737,23179,2012,33615
10919,13478,6641,6837,2012,33616
10920,42831,20003,22828,2012,33617
10921,24522,11730,12792,2012,33618
10922,34483,17872,16611,2012,33619
10923,3765,1687,2078,2012,33620
10924,1862,985,877,2012,33621
10925,39780,18964,20816,2012,33624
10926,24563,11719,12844,2012,33625
10927,26533,13294,13239,2012,33626
10928,24430,11726,12704,2012,33629
10929,19186,9544,9642,2012,33634
10930,15322,7462,7860,2012,33635
10931,15326,7243,8083,2012,33637
10932,59098,29018,30080,2012,33647
10933,13727,7082,6645,2012,33701
10934,30125,14185,15940,2012,33702
10935,24271,12044,12227,2012,33703
10936,16925,8379,8546,2012,33704
10937,25829,12145,13684,2012,33705
10938,16051,7854,8197,2012,33706
10939,24752,11518,13234,2012,33707
10940,14757,7256,7501,2012,33708
10941,24607,11726,12881,2012,33709
10942,32565,15085,17480,2012,33710
10943,19303,8582,10721,2012,33711
10944,25261,11160,14101,2012,33712
10945,30045,15577,14468,2012,33713
10946,18930,9522,9408,2012,33714
10947,6510,3046,3464,2012,33715
10948,14840,6977,7863,2012,33716
10949,129,102,27,2012,33744
10950,24550,11948,12602,2012,33755
10951,29839,14783,15056,2012,33756
10952,16742,7880,8862,2012,33759
10953,15092,7849,7243,2012,33760
10954,18986,8778,10208,2012,33761
10955,7370,4177,3193,2012,33762
10956,18702,8672,10030,2012,33763
10957,25394,12515,12879,2012,33764
10958,13888,6560,7328,2012,33765
10959,7873,3782,4091,2012,33767
10960,25200,12328,12872,2012,33770
10961,28431,13363,15068,2012,33771
10962,22093,10480,11613,2012,33772
10963,17302,8210,9092,2012,33773
10964,18772,9172,9600,2012,33774
10965,13460,6659,6801,2012,33776
10966,17171,8277,8894,2012,33777
10967,14740,7275,7465,2012,33778
10968,26007,12589,13418,2012,33781
10969,21153,10293,10860,2012,33782
10970,5656,2785,2871,2012,33785
10971,1609,768,841,2012,33786
10972,32288,15946,16342,2012,33801
10973,27818,13113,14705,2012,33803
10974,23131,11468,11663,2012,33805
10975,29874,14247,15627,2012,33809
10976,48057,22969,25088,2012,33810
10977,20050,10024,10026,2012,33811
10978,13661,6845,6816,2012,33812
10979,31590,15130,16460,2012,33813
10980,13662,6752,6910,2012,33815
10981,29046,14467,14579,2012,33823
10982,25888,12328,13560,2012,33825
10983,2612,1242,1370,2012,33827
10984,26274,12693,13581,2012,33830
10985,7554,4841,2713,2012,33834
10986,19794,9712,10082,2012,33837
10987,3618,1751,1867,2012,33838
10988,2944,1550,1394,2012,33839
10989,9140,4652,4488,2012,33841
10990,12137,7373,4764,2012,33843
10991,32669,16202,16467,2012,33844
10992,199,82,117,2012,33847
10993,1210,518,692,2012,33848
10994,1049,491,558,2012,33849
10995,7036,3475,3561,2012,33850
10996,745,384,361,2012,33851
10997,20669,10435,10234,2012,33852
10998,10781,4883,5898,2012,33853
10999,155,87,68,2012,33854
11000,16,8,8,2012,33855
11001,351,163,188,2012,33856
11002,1937,1097,840,2012,33857
11003,9975,4620,5355,2012,33859
11004,22793,11500,11293,2012,33860
11005,806,344,462,2012,33865
11006,350,192,158,2012,33867
11007,12876,7378,5498,2012,33868
11008,21952,11372,10580,2012,33870
11009,14306,6836,7470,2012,33872
11010,13229,7158,6071,2012,33873
11011,10197,4919,5278,2012,33875
11012,4713,2149,2564,2012,33876
11013,221,52,169,2012,33877
11014,36329,17182,19147,2012,33880
11015,30428,14311,16117,2012,33881
11016,28925,13927,14998,2012,33884
11017,5825,2781,3044,2012,33890
11018,7591,3489,4102,2012,33896
11019,14599,7200,7399,2012,33897
11020,15488,7840,7648,2012,33898
11021,18529,9219,9310,2012,33901
11022,18987,8906,10081,2012,33903
11023,29933,14585,15348,2012,33904
11024,30511,16560,13951,2012,33905
11025,19895,9357,10538,2012,33907
11026,34013,15856,18157,2012,33908
11027,22633,11271,11362,2012,33909
11028,16041,7711,8330,2012,33912
11029,17868,8507,9361,2012,33913
11030,37842,18751,19091,2012,33914
11031,22819,11184,11635,2012,33916
11032,29759,14374,15385,2012,33917
11033,28509,13160,15349,2012,33919
11034,5439,2608,2831,2012,33920
11035,1186,574,612,2012,33921
11036,4133,2313,1820,2012,33922
11037,225,110,115,2012,33924
11038,20235,9991,10244,2012,33928
11039,884,495,389,2012,33930
11040,10509,5004,5505,2012,33931
11041,19356,9828,9528,2012,33935
11042,22197,11197,11000,2012,33936
11043,590,268,322,2012,33944
11044,33,33,0,2012,33945
11045,1801,793,1008,2012,33946
11046,8466,4068,4398,2012,33947
11047,16168,7458,8710,2012,33948
11048,19618,9615,10003,2012,33950
11049,29968,14519,15449,2012,33952
11050,5031,2613,2418,2012,33953
11051,9806,4873,4933,2012,33954
11052,9329,5035,4294,2012,33955
11053,3435,1831,1604,2012,33956
11054,6604,3257,3347,2012,33957
11055,1043,583,460,2012,33960
11056,983,487,496,2012,33965
11057,8786,4057,4729,2012,33966
11058,24228,13080,11148,2012,33967
11059,22705,11352,11353,2012,33971
11060,10967,5432,5535,2012,33972
11061,11406,5008,6398,2012,33973
11062,11703,5726,5977,2012,33974
11063,14014,7055,6959,2012,33976
11064,9787,4834,4953,2012,33980
11065,9306,4694,4612,2012,33981
11066,9837,5136,4701,2012,33982
11067,14229,6298,7931,2012,33983
11068,29797,14731,15066,2012,33990
11069,15885,7987,7898,2012,33991
11070,21285,10460,10825,2012,33993
11071,0,0,0,2012,34101
11072,10754,4958,5796,2012,34102
11073,12352,5914,6438,2012,34103
11074,23901,11763,12138,2012,34104
11075,14450,7002,7448,2012,34105
11076,17185,8391,8794,2012,34108
11077,24459,11271,13188,2012,34109
11078,20822,9650,11172,2012,34110
11079,26422,12767,13655,2012,34112
11080,18078,9579,8499,2012,34113
11081,14120,7303,6817,2012,34114
11082,31798,16391,15407,2012,34116
11083,15229,7931,7298,2012,34117
11084,23713,10818,12895,2012,34119
11085,27325,13351,13974,2012,34120
11086,14188,6605,7583,2012,34134
11087,37330,18331,18999,2012,34135
11088,129,58,71,2012,34137
11089,523,358,165,2012,34138
11090,373,181,192,2012,34139
11091,261,180,81,2012,34140
11092,129,114,15,2012,34141
11093,25075,14262,10813,2012,34142
11094,16570,8361,8209,2012,34145
11095,3832,1708,2124,2012,34201
11096,20802,10182,10620,2012,34202
11097,35824,17086,18738,2012,34203
11098,29971,14852,15119,2012,34205
11099,29230,14133,15097,2012,34207
11100,34069,16959,17110,2012,34208
11101,32610,14858,17752,2012,34209
11102,15323,7573,7750,2012,34210
11103,2494,1255,1239,2012,34211
11104,15443,7784,7659,2012,34212
11105,873,433,440,2012,34215
11106,1389,589,800,2012,34216
11107,5142,2508,2634,2012,34217
11108,16642,7873,8769,2012,34219
11109,39306,19542,19764,2012,34221
11110,11470,5255,6215,2012,34222
11111,17322,8201,9121,2012,34223
11112,15443,7475,7968,2012,34224
11113,6612,3014,3598,2012,34228
11114,6997,3727,3270,2012,34229
11115,29592,14072,15520,2012,34231
11116,31574,15095,16479,2012,34232
11117,17363,8176,9187,2012,34233
11118,20509,9546,10963,2012,34234
11119,13922,6544,7378,2012,34235
11120,10337,4699,5638,2012,34236
11121,17033,9184,7849,2012,34237
11122,17153,7331,9822,2012,34238
11123,16809,7907,8902,2012,34239
11124,11715,6306,5409,2012,34240
11125,13930,6588,7342,2012,34241
11126,8673,4177,4496,2012,34242
11127,26315,12536,13779,2012,34243
11128,6031,3097,2934,2012,34251
11129,30640,17592,13048,2012,34266
11130,214,122,92,2012,34268
11131,3774,1848,1926,2012,34269
11132,16020,7800,8220,2012,34275
11133,17910,8249,9661,2012,34285
11134,20157,9617,10540,2012,34286
11135,24037,11368,12669,2012,34287
11136,11001,5049,5952,2012,34288
11137,1405,758,647,2012,34289
11138,4487,2211,2276,2012,34291
11139,13645,6334,7311,2012,34292
11140,32840,15526,17314,2012,34293
11141,16994,8353,8641,2012,34420
11142,9630,4722,4908,2012,34428
11143,7919,3844,4075,2012,34429
11144,7616,3687,3929,2012,34431
11145,12845,6079,6766,2012,34432
11146,6013,2995,3018,2012,34433
11147,8071,3990,4081,2012,34434
11148,7252,3597,3655,2012,34436
11149,14066,6819,7247,2012,34442
11150,0,0,0,2012,34445
11151,17492,8579,8913,2012,34446
11152,11158,5503,5655,2012,34448
11153,3051,1495,1556,2012,34449
11154,10867,5101,5766,2012,34450
11155,11548,5314,6234,2012,34452
11156,10579,4775,5804,2012,34453
11157,10021,5234,4787,2012,34461
11158,15822,7511,8311,2012,34465
11159,18196,8317,9879,2012,34470
11160,24454,11365,13089,2012,34471
11161,25929,11711,14218,2012,34472
11162,17280,8560,8720,2012,34473
11163,15691,7341,8350,2012,34474
11164,13275,6844,6431,2012,34475
11165,22764,10919,11845,2012,34476
11166,14013,6930,7083,2012,34479
11167,18388,8713,9675,2012,34480
11168,16529,7587,8942,2012,34481
11169,22964,11100,11864,2012,34482
11170,2976,1339,1637,2012,34484
11171,10723,5339,5384,2012,34488
11172,27256,13012,14244,2012,34491
11173,565,287,278,2012,34498
11174,21691,10028,11663,2012,34601
11175,7457,3645,3812,2012,34602
11176,10327,5180,5147,2012,34604
11177,25331,11875,13456,2012,34606
11178,7815,3707,4108,2012,34607
11179,32131,14563,17568,2012,34608
11180,37921,18510,19411,2012,34609
11181,11553,5519,6034,2012,34610
11182,17970,8972,8998,2012,34613
11183,6085,2944,3141,2012,34614
11184,6167,3152,3015,2012,34637
11185,20556,9762,10794,2012,34638
11186,24146,11449,12697,2012,34639
11187,23506,11708,11798,2012,34652
11188,30684,15003,15681,2012,34653
11189,21619,11056,10563,2012,34654
11190,37625,18285,19340,2012,34655
11191,249,160,89,2012,34661
11192,32000,15017,16983,2012,34667
11193,42317,20474,21843,2012,34668
11194,12533,6199,6334,2012,34669
11195,20712,9775,10937,2012,34677
11196,11,5,6,2012,34679
11197,1808,951,857,2012,34681
11198,32110,15369,16741,2012,34683
11199,27372,12159,15213,2012,34684
11200,17624,8577,9047,2012,34685
11201,7936,3827,4109,2012,34688
11202,25933,12328,13605,2012,34689
11203,12696,6146,6550,2012,34690
11204,20685,10047,10638,2012,34691
11205,17572,8779,8793,2012,34695
11206,37665,17257,20408,2012,34698
11207,2673,1395,1278,2012,34705
11208,53748,26778,26970,2012,34711
11209,14577,6414,8163,2012,34714
11210,15359,7299,8060,2012,34715
11211,10533,4971,5562,2012,34731
11212,3996,1878,2118,2012,34734
11213,14191,7603,6588,2012,34736
11214,2379,1177,1202,2012,34737
11215,944,571,373,2012,34739
11216,41694,20405,21289,2012,34741
11217,36340,17820,18520,2012,34743
11218,44902,22118,22784,2012,34744
11219,33630,15964,17666,2012,34746
11220,13690,6759,6931,2012,34747
11221,40141,18638,21503,2012,34748
11222,5435,2776,2659,2012,34753
11223,3115,1517,1598,2012,34756
11224,30408,14838,15570,2012,34758
11225,31411,14868,16543,2012,34759
11226,736,366,370,2012,34760
11227,37882,18151,19731,2012,34761
11228,642,364,278,2012,34762
11229,20909,10165,10744,2012,34769
11230,14212,7047,7165,2012,34771
11231,22734,11793,10941,2012,34772
11232,3432,1715,1717,2012,34773
11233,17480,11333,6147,2012,34785
11234,27543,13350,14193,2012,34786
11235,46101,22581,23520,2012,34787
11236,16827,8044,8783,2012,34788
11237,1184,604,580,2012,34797
11238,5048,2738,2310,2012,34945
11239,6418,3149,3269,2012,34946
11240,12291,5759,6532,2012,34947
11241,6077,2954,3123,2012,34949
11242,15770,7262,8508,2012,34950
11243,14880,7454,7426,2012,34951
11244,37535,17661,19874,2012,34952
11245,60648,29990,30658,2012,34953
11246,10865,6237,4628,2012,34956
11247,22304,11019,11285,2012,34957
11248,20050,10933,9117,2012,34972
11249,23917,12324,11593,2012,34974
11250,3802,2103,1699,2012,34981
11251,25470,12691,12779,2012,34982
11252,38875,19150,19725,2012,34983
11253,14160,6986,7174,2012,34984
11254,23887,11410,12477,2012,34986
11255,5940,2956,2984,2012,34987
11256,27331,12775,14556,2012,34990
11257,16548,8354,8194,2012,34994
11258,10328,4957,5371,2012,34996
11259,40650,20465,20185,2012,34997
11260,10080,5135,4945,2012,35004
11261,8353,4476,3877,2012,35005
11262,3403,1871,1532,2012,35006
11263,26757,12741,14016,2012,35007
11264,21055,10022,11033,2012,35010
11265,41,26,15,2012,35013
11266,5140,3475,1665,2012,35014
11267,16507,8282,8225,2012,35016
11268,1763,945,818,2012,35019
11269,25924,11639,14285,2012,35020
11270,19053,9235,9818,2012,35022
11271,25278,12893,12385,2012,35023
11272,7681,3885,3796,2012,35031
11273,89,48,41,2012,35032
11274,3276,1679,1597,2012,35033
11275,4936,3188,1748,2012,35034
11276,1465,768,697,2012,35035
11277,233,79,154,2012,35036
11278,14828,7514,7314,2012,35040
11279,6172,3167,3005,2012,35042
11280,8674,4411,4263,2012,35043
11281,7850,3695,4155,2012,35044
11282,13993,6844,7149,2012,35045
11283,5203,2667,2536,2012,35046
11284,4306,2277,2029,2012,35049
11285,9179,4375,4804,2012,35051
11286,115,16,99,2012,35052
11287,2836,1324,1512,2012,35053
11288,3979,1793,2186,2012,35054
11289,20543,10054,10489,2012,35055
11290,11904,6062,5842,2012,35057
11291,9020,4656,4364,2012,35058
11292,289,127,162,2012,35060
11293,1272,645,627,2012,35061
11294,7076,3460,3616,2012,35062
11295,3701,1956,1745,2012,35063
11296,11605,5079,6526,2012,35064
11297,7141,3415,3726,2012,35068
11298,292,117,175,2012,35070
11299,16256,7576,8680,2012,35071
11300,4991,2497,2494,2012,35072
11301,2618,1291,1327,2012,35073
11302,111,40,71,2012,35074
11303,13478,6534,6944,2012,35077
11304,2422,1109,1313,2012,35078
11305,9170,4625,4545,2012,35079
11306,16333,7989,8344,2012,35080
11307,0,0,0,2012,35082
11308,3411,1539,1872,2012,35083
11309,8588,4241,4347,2012,35085
11310,1379,607,772,2012,35087
11311,2621,1297,1324,2012,35089
11312,2760,1290,1470,2012,35091
11313,14465,6766,7699,2012,35094
11314,8332,3961,4371,2012,35096
11315,1733,835,898,2012,35097
11316,1624,858,766,2012,35098
11317,15915,7855,8060,2012,35111
11318,352,173,179,2012,35112
11319,6666,3374,3292,2012,35114
11320,13928,6336,7592,2012,35115
11321,3995,1997,1998,2012,35116
11322,5574,2842,2732,2012,35117
11323,3103,1398,1705,2012,35118
11324,72,32,40,2012,35119
11325,14663,7038,7625,2012,35120
11326,15059,7352,7707,2012,35121
11327,22839,11178,11661,2012,35124
11328,10477,5299,5178,2012,35125
11329,20971,10101,10870,2012,35126
11330,10277,4841,5436,2012,35127
11331,9154,4544,4610,2012,35128
11332,3141,1459,1682,2012,35130
11333,4575,2296,2279,2012,35131
11334,3959,1892,2067,2012,35133
11335,1662,819,843,2012,35135
11336,1996,1143,853,2012,35136
11337,198,70,128,2012,35139
11338,3010,1464,1546,2012,35143
11339,11897,6411,5486,2012,35146
11340,6049,3111,2938,2012,35147
11341,3293,1519,1774,2012,35148
11342,452,85,367,2012,35149
11343,18936,8809,10127,2012,35150
11344,7481,3663,3818,2012,35151
11345,25342,12203,13139,2012,35160
11346,3776,1823,1953,2012,35171
11347,3463,1740,1723,2012,35172
11348,24991,12198,12793,2012,35173
11349,4999,2475,2524,2012,35175
11350,859,372,487,2012,35176
11351,3452,1709,1743,2012,35178
11352,9171,4383,4788,2012,35179
11353,13511,6698,6813,2012,35180
11354,536,244,292,2012,35183
11355,6628,3300,3328,2012,35184
11356,4690,2434,2256,2012,35186
11357,16,11,5,2012,35187
11358,2500,1056,1444,2012,35188
11359,3382,2002,1380,2012,35203
11360,10881,5345,5536,2012,35204
11361,18840,9709,9131,2012,35205
11362,17797,8163,9634,2012,35206
11363,9584,5007,4577,2012,35207
11364,15294,7006,8288,2012,35208
11365,28437,13448,14989,2012,35209
11366,13974,6985,6989,2012,35210
11367,26505,11645,14860,2012,35211
11368,12875,5932,6943,2012,35212
11369,13599,6130,7469,2012,35213
11370,18735,8332,10403,2012,35214
11371,46884,21213,25671,2012,35215
11372,35954,17680,18274,2012,35216
11373,13854,6220,7634,2012,35217
11374,7952,3963,3989,2012,35218
11375,5342,2190,3152,2012,35221
11376,8492,3834,4658,2012,35222
11377,10668,5005,5663,2012,35223
11378,6560,3037,3523,2012,35224
11379,31427,14763,16664,2012,35226
11380,9810,4383,5427,2012,35228
11381,1309,470,839,2012,35229
11382,626,287,339,2012,35233
11383,6109,3061,3048,2012,35234
11384,20363,9058,11305,2012,35235
11385,49551,24279,25272,2012,35242
11386,17207,8432,8775,2012,35243
11387,32218,15595,16623,2012,35244
11388,820,460,360,2012,35254
11389,37089,17422,19667,2012,35401
11390,22048,10889,11159,2012,35404
11391,42068,19902,22166,2012,35405
11392,14132,6541,7591,2012,35406
11393,933,456,477,2012,35441
11394,5242,2398,2844,2012,35442
11395,1680,779,901,2012,35443
11396,3935,2189,1746,2012,35444
11397,1842,911,931,2012,35446
11398,3467,1732,1735,2012,35447
11399,3380,1729,1651,2012,35452
11400,10728,5253,5475,2012,35453
11401,3132,1560,1572,2012,35456
11402,106,50,56,2012,35457
11403,307,153,154,2012,35458
11404,915,360,555,2012,35459
11405,386,155,231,2012,35460
11406,1772,791,981,2012,35461
11407,5198,2561,2637,2012,35462
11408,1801,865,936,2012,35463
11409,848,399,449,2012,35464
11410,5540,2632,2908,2012,35466
11411,81,34,47,2012,35469
11412,5227,2524,2703,2012,35470
11413,15245,6910,8335,2012,35473
11414,5783,2993,2790,2012,35474
11415,14070,7262,6808,2012,35475
11416,7170,3500,3670,2012,35476
11417,192,79,113,2012,35477
11418,1082,615,467,2012,35480
11419,3934,1871,2063,2012,35481
11420,4329,2303,2026,2012,35490
11421,10931,5285,5646,2012,35501
11422,7831,3888,3943,2012,35503
11423,13405,6361,7044,2012,35504
11424,2043,1033,1010,2012,35540
11425,3538,1771,1767,2012,35541
11426,1349,690,659,2012,35542
11427,1786,846,940,2012,35543
11428,1021,413,608,2012,35544
11429,50,30,20,2012,35545
11430,3831,1857,1974,2012,35546
11431,1736,792,944,2012,35548
11432,4601,2178,2423,2012,35549
11433,5638,2769,2869,2012,35550
11434,1130,540,590,2012,35552
11435,4639,2266,2373,2012,35553
11436,997,446,551,2012,35554
11437,9738,4873,4865,2012,35555
11438,25,12,13,2012,35559
11439,4312,2013,2299,2012,35563
11440,2266,1107,1159,2012,35564
11441,12437,6088,6349,2012,35565
11442,11484,5891,5593,2012,35570
11443,969,528,441,2012,35571
11444,1187,543,644,2012,35572
11445,1225,629,596,2012,35574
11446,923,447,476,2012,35575
11447,2860,1426,1434,2012,35576
11448,38,23,15,2012,35577
11449,5610,2688,2922,2012,35578
11450,3197,1579,1618,2012,35579
11451,4504,2229,2275,2012,35580
11452,5351,2623,2728,2012,35581
11453,4060,1914,2146,2012,35582
11454,655,369,286,2012,35584
11455,1258,639,619,2012,35585
11456,4456,2103,2353,2012,35586
11457,1227,609,618,2012,35587
11458,4375,2094,2281,2012,35592
11459,2106,1094,1012,2012,35593
11460,7790,3794,3996,2012,35594
11461,33794,16861,16933,2012,35601
11462,30687,14615,16072,2012,35603
11463,2042,1049,993,2012,35610
11464,25171,11420,13751,2012,35611
11465,20926,12073,8853,2012,35613
11466,7779,3784,3995,2012,35614
11467,0,0,0,2012,35615
11468,4141,1909,2232,2012,35616
11469,1878,830,1048,2012,35618
11470,5340,2565,2775,2012,35619
11471,8451,4141,4310,2012,35620
11472,2812,1548,1264,2012,35621
11473,7207,3525,3682,2012,35622
11474,33283,15257,18026,2012,35630
11475,20329,10252,10077,2012,35633
11476,9108,4427,4681,2012,35634
11477,25080,12488,12592,2012,35640
11478,2964,1297,1667,2012,35643
11479,15774,7681,8093,2012,35645
11480,4061,1945,2116,2012,35646
11481,1158,609,549,2012,35647
11482,3379,1630,1749,2012,35648
11483,93,53,40,2012,35649
11484,14130,7043,7087,2012,35650
11485,1279,624,655,2012,35651
11486,7507,3637,3870,2012,35652
11487,12097,5787,6310,2012,35653
11488,8292,4336,3956,2012,35654
11489,9060,4363,4697,2012,35660
11490,17601,8503,9098,2012,35661
11491,7578,3782,3796,2012,35670
11492,2175,1119,1056,2012,35671
11493,6293,3187,3106,2012,35672
11494,7715,3875,3840,2012,35673
11495,17889,8537,9352,2012,35674
11496,1589,650,939,2012,35677
11497,5471,2610,2861,2012,35739
11498,3272,1664,1608,2012,35740
11499,3211,1479,1732,2012,35741
11500,2626,1356,1270,2012,35744
11501,205,109,96,2012,35745
11502,803,464,339,2012,35746
11503,5801,2998,2803,2012,35747
11504,6584,3223,3361,2012,35748
11505,19910,10192,9718,2012,35749
11506,12165,5951,6214,2012,35750
11507,440,224,216,2012,35751
11508,1727,952,775,2012,35752
11509,5284,2405,2879,2012,35754
11510,527,314,213,2012,35755
11511,9044,4544,4500,2012,35756
11512,13080,6425,6655,2012,35757
11513,41817,20533,21284,2012,35758
11514,6750,3190,3560,2012,35759
11515,5277,2641,2636,2012,35760
11516,10718,5185,5533,2012,35761
11517,14958,7572,7386,2012,35763
11518,559,240,319,2012,35764
11519,3467,1746,1721,2012,35765
11520,185,106,79,2012,35766
11521,11982,5869,6113,2012,35768
11522,9518,4284,5234,2012,35769
11523,4084,2042,2042,2012,35771
11524,5076,2453,2623,2012,35772
11525,13727,7348,6379,2012,35773
11526,156,90,66,2012,35774
11527,666,378,288,2012,35775
11528,3776,1962,1814,2012,35776
11529,21915,10715,11200,2012,35801
11530,20839,9844,10995,2012,35802
11531,25394,12766,12628,2012,35803
11532,22550,10983,11567,2012,35805
11533,18779,9426,9353,2012,35806
11534,1580,1034,546,2012,35808
11535,31415,15018,16397,2012,35810
11536,25977,12616,13361,2012,35811
11537,14605,7113,7492,2012,35816
11538,5467,2629,2838,2012,35824
11539,612,161,451,2012,35896
11540,20196,9258,10938,2012,35901
11541,18023,8977,9046,2012,35903
11542,13598,6181,7417,2012,35904
11543,6594,3028,3566,2012,35905
11544,9874,4646,5228,2012,35906
11545,8209,4096,4113,2012,35907
11546,21137,10833,10304,2012,35950
11547,14177,6905,7272,2012,35951
11548,7863,3946,3917,2012,35952
11549,6736,3164,3572,2012,35953
11550,13089,6730,6359,2012,35954
11551,8437,4314,4123,2012,35956
11552,15770,7651,8119,2012,35957
11553,3031,1638,1393,2012,35958
11554,4336,2121,2215,2012,35959
11555,10080,4942,5138,2012,35960
11556,6733,3315,3418,2012,35961
11557,7767,3561,4206,2012,35962
11558,1497,716,781,2012,35963
11559,4698,2327,2371,2012,35966
11560,16396,8151,8245,2012,35967
11561,3718,1918,1800,2012,35968
11562,6075,3111,2964,2012,35971
11563,1079,550,529,2012,35972
11564,3924,1908,2016,2012,35973
11565,1515,684,831,2012,35974
11566,1209,596,613,2012,35975
11567,16388,7618,8770,2012,35976
11568,5002,2504,2498,2012,35978
11569,1518,726,792,2012,35979
11570,5394,2631,2763,2012,35980
11571,3098,1579,1519,2012,35981
11572,3430,1682,1748,2012,35983
11573,1931,896,1035,2012,35984
11574,7584,3569,4015,2012,35986
11575,2773,1460,1313,2012,35987
11576,1895,928,967,2012,35988
11577,3074,1601,1473,2012,35989
11578,14,7,7,2012,35990
11579,1764,898,866,2012,36003
11580,1508,745,763,2012,36005
11581,1330,575,755,2012,36006
11582,2777,1326,1451,2012,36009
11583,4752,2296,2456,2012,36010
11584,445,243,202,2012,36013
11585,5054,3202,1852,2012,36016
11586,3072,2255,817,2012,36017
11587,1088,531,557,2012,36020
11588,11163,5787,5376,2012,36022
11589,5178,2300,2878,2012,36024
11590,7109,5294,1815,2012,36025
11591,848,396,452,2012,36026
11592,16224,7745,8479,2012,36027
11593,1841,935,906,2012,36028
11594,847,449,398,2012,36029
11595,360,148,212,2012,36030
11596,57,33,24,2012,36031
11597,2213,988,1225,2012,36032
11598,3900,1935,1965,2012,36033
11599,795,387,408,2012,36034
11600,1856,977,879,2012,36035
11601,1966,912,1054,2012,36036
11602,14131,6505,7626,2012,36037
11603,90,52,38,2012,36038
11604,338,224,114,2012,36039
11605,3730,1847,1883,2012,36040
11606,944,468,476,2012,36041
11607,1143,587,556,2012,36042
11608,3380,1473,1907,2012,36043
11609,1587,828,759,2012,36046
11610,1299,689,610,2012,36047
11611,1534,757,777,2012,36048
11612,5874,2874,3000,2012,36049
11613,2199,1172,1027,2012,36051
11614,1077,663,414,2012,36052
11615,2151,1106,1045,2012,36053
11616,14872,6596,8276,2012,36054
11617,6614,3337,3277,2012,36064
11618,17823,8842,8981,2012,36066
11619,28222,13344,14878,2012,36067
11620,1697,771,926,2012,36069
11621,839,438,401,2012,36071
11622,2457,1231,1226,2012,36075
11623,13750,6579,7171,2012,36078
11624,9124,4385,4739,2012,36079
11625,2469,1148,1321,2012,36080
11626,16223,7542,8681,2012,36081
11627,1190,527,663,2012,36082
11628,8606,3759,4847,2012,36083
11629,4927,2187,2740,2012,36088
11630,8413,4656,3757,2012,36089
11631,3720,1857,1863,2012,36091
11632,20851,9381,11470,2012,36092
11633,9629,4747,4882,2012,36093
11634,9359,4811,4548,2012,36104
11635,11570,5332,6238,2012,36105
11636,14406,6438,7968,2012,36106
11637,8801,4336,4465,2012,36107
11638,21196,9881,11315,2012,36108
11639,25061,12042,13019,2012,36109
11640,13126,6304,6822,2012,36110
11641,13061,5752,7309,2012,36111
11642,352,220,132,2012,36112
11643,1575,1228,347,2012,36113
11644,792,422,370,2012,36115
11645,44877,20434,24443,2012,36116
11646,50979,24901,26078,2012,36117
11647,20425,9776,10649,2012,36201
11648,18743,8724,10019,2012,36203
11649,605,341,264,2012,36205
11650,11588,5835,5753,2012,36206
11651,19808,9476,10332,2012,36207
11652,4709,2405,2304,2012,36250
11653,5013,2430,2583,2012,36251
11654,1060,520,540,2012,36255
11655,1722,836,886,2012,36256
11656,1400,859,541,2012,36258
11657,4173,2033,2140,2012,36260
11658,1353,786,567,2012,36262
11659,888,469,419,2012,36263
11660,9229,4169,5060,2012,36264
11661,20596,9453,11143,2012,36265
11662,5575,2701,2874,2012,36266
11663,83,27,56,2012,36267
11664,5474,2646,2828,2012,36268
11665,1312,696,616,2012,36269
11666,5656,2875,2781,2012,36271
11667,12793,6529,6264,2012,36272
11668,2988,1503,1485,2012,36273
11669,10873,5257,5616,2012,36274
11670,2320,1209,1111,2012,36276
11671,4761,2101,2660,2012,36277
11672,3764,1896,1868,2012,36278
11673,2697,1492,1205,2012,36279
11674,4551,2121,2430,2012,36280
11675,36416,17595,18821,2012,36301
11676,29938,14042,15896,2012,36303
11677,14385,6989,7396,2012,36305
11678,6694,3264,3430,2012,36310
11679,2955,1350,1605,2012,36311
11680,6282,3064,3218,2012,36312
11681,287,140,147,2012,36313
11682,445,243,202,2012,36314
11683,1013,507,506,2012,36316
11684,343,175,168,2012,36317
11685,1369,664,705,2012,36318
11686,2209,1114,1095,2012,36319
11687,3727,1744,1983,2012,36320
11688,1506,713,793,2012,36321
11689,8764,4270,4494,2012,36322
11690,8569,4090,4479,2012,36323
11691,35051,17342,17709,2012,36330
11692,6254,3090,3164,2012,36340
11693,1368,661,707,2012,36343
11694,4896,2401,2495,2012,36344
11695,7783,3556,4227,2012,36345
11696,1214,618,596,2012,36346
11697,7344,3552,3792,2012,36350
11698,3865,2119,1746,2012,36351
11699,4754,2454,2300,2012,36352
11700,1905,978,927,2012,36353
11701,19413,9335,10078,2012,36360
11702,5254,3051,2203,2012,36362
11703,1016,487,529,2012,36370
11704,643,360,283,2012,36371
11705,700,341,359,2012,36373
11706,1051,509,542,2012,36374
11707,8202,3965,4237,2012,36375
11708,2334,1123,1211,2012,36376
11709,7349,3550,3799,2012,36401
11710,10291,5130,5161,2012,36420
11711,8793,4417,4376,2012,36421
11712,1104,436,668,2012,36425
11713,15036,7109,7927,2012,36426
11714,2785,1576,1209,2012,36432
11715,474,224,250,2012,36435
11716,294,173,121,2012,36436
11717,475,220,255,2012,36439
11718,4221,2068,2153,2012,36441
11719,4157,1890,2267,2012,36442
11720,741,375,366,2012,36444
11721,4485,2146,2339,2012,36445
11722,391,210,181,2012,36446
11723,4340,1999,2341,2012,36451
11724,2319,1053,1266,2012,36453
11725,16,7,9,2012,36454
11726,511,266,245,2012,36455
11727,2195,1099,1096,2012,36456
11728,11407,5654,5753,2012,36460
11729,10319,4667,5652,2012,36467
11730,23,23,0,2012,36470
11731,1238,532,706,2012,36471
11732,186,71,115,2012,36473
11733,3044,1446,1598,2012,36474
11734,2436,1069,1367,2012,36475
11735,33,18,15,2012,36476
11736,4522,2011,2511,2012,36477
11737,1816,912,904,2012,36480
11738,354,156,198,2012,36481
11739,846,393,453,2012,36482
11740,390,223,167,2012,36483
11741,19093,10674,8419,2012,36502
11742,1337,785,552,2012,36505
11743,17501,8505,8996,2012,36507
11744,2222,1204,1018,2012,36509
11745,774,220,554,2012,36511
11746,26,0,26,2012,36512
11747,619,305,314,2012,36513
11748,2612,1267,1345,2012,36518
11749,5944,3193,2751,2012,36521
11750,6486,3050,3436,2012,36522
11751,1892,966,926,2012,36523
11752,1211,649,562,2012,36524
11753,1842,906,936,2012,36525
11754,30015,14781,15234,2012,36526
11755,12518,6602,5916,2012,36527
11756,1366,696,670,2012,36528
11757,451,196,255,2012,36529
11758,6837,3428,3409,2012,36530
11759,28676,13612,15064,2012,36532
11760,25729,12446,13283,2012,36535
11761,409,168,241,2012,36538
11762,1050,551,499,2012,36539
11763,678,310,368,2012,36540
11764,14797,7410,7387,2012,36541
11765,12488,5852,6636,2012,36542
11766,110,62,48,2012,36543
11767,11861,5810,6051,2012,36544
11768,10814,5208,5606,2012,36545
11769,1076,570,506,2012,36548
11770,4734,2299,2435,2012,36549
11771,72,32,40,2012,36550
11772,7942,4127,3815,2012,36551
11773,3669,1747,1922,2012,36553
11774,778,349,429,2012,36555
11775,113,55,58,2012,36556
11776,3608,1772,1836,2012,36558
11777,174,91,83,2012,36559
11778,3276,1455,1821,2012,36560
11779,6151,3132,3019,2012,36561
11780,1218,596,622,2012,36562
11781,19,9,10,2012,36564
11782,12845,6347,6498,2012,36567
11783,68,51,17,2012,36568
11784,890,485,405,2012,36569
11785,14632,7052,7580,2012,36571
11786,6419,3159,3260,2012,36572
11787,1601,710,891,2012,36574
11788,19063,9529,9534,2012,36575
11789,4128,1798,2330,2012,36576
11790,1384,717,667,2012,36578
11791,1397,678,719,2012,36579
11792,5876,2732,3144,2012,36580
11793,404,215,189,2012,36581
11794,25805,12770,13035,2012,36582
11795,647,344,303,2012,36583
11796,809,424,385,2012,36584
11797,1050,609,441,2012,36585
11798,11475,5773,5702,2012,36587
11799,0,0,0,2012,36590
11800,631,307,324,2012,36602
11801,10017,5959,4058,2012,36603
11802,9743,4582,5161,2012,36604
11803,29886,13625,16261,2012,36605
11804,20106,9127,10979,2012,36606
11805,7787,3464,4323,2012,36607
11806,37111,17431,19680,2012,36608
11807,23661,11227,12434,2012,36609
11808,12365,5705,6660,2012,36610
11809,6085,2706,3379,2012,36611
11810,5154,2486,2668,2012,36612
11811,13238,6726,6512,2012,36613
11812,248,143,105,2012,36615
11813,0,0,0,2012,36616
11814,13641,6160,7481,2012,36617
11815,16908,8049,8859,2012,36618
11816,13831,6549,7282,2012,36619
11817,723,281,442,2012,36688
11818,17919,8119,9800,2012,36693
11819,44880,21619,23261,2012,36695
11820,22591,10339,12252,2012,36701
11821,14678,6791,7887,2012,36703
11822,883,501,382,2012,36720
11823,598,320,278,2012,36722
11824,131,49,82,2012,36723
11825,5205,2377,2828,2012,36726
11826,213,100,113,2012,36727
11827,437,254,183,2012,36728
11828,8149,3768,4381,2012,36732
11829,1429,848,581,2012,36736
11830,724,385,339,2012,36738
11831,1597,708,889,2012,36740
11832,2126,1008,1118,2012,36742
11833,7456,3554,3902,2012,36744
11834,3070,1330,1740,2012,36748
11835,959,429,530,2012,36749
11836,3065,1511,1554,2012,36750
11837,1025,454,571,2012,36751
11838,1836,727,1109,2012,36752
11839,28,11,17,2012,36753
11840,475,201,274,2012,36754
11841,5844,2845,2999,2012,36756
11842,1783,806,977,2012,36758
11843,1640,814,826,2012,36759
11844,953,417,536,2012,36761
11845,209,137,72,2012,36763
11846,1505,629,876,2012,36765
11847,9,1,8,2012,36766
11848,2213,991,1222,2012,36767
11849,1003,463,540,2012,36768
11850,2633,1223,1410,2012,36769
11851,918,358,560,2012,36773
11852,628,335,293,2012,36775
11853,1604,684,920,2012,36776
11854,2953,1488,1465,2012,36782
11855,891,347,544,2012,36783
11856,8076,3661,4415,2012,36784
11857,1510,749,761,2012,36785
11858,3646,1656,1990,2012,36786
11859,80,49,31,2012,36790
11860,1429,766,663,2012,36792
11861,648,523,125,2012,36793
11862,22043,10410,11633,2012,36801
11863,17096,8710,8386,2012,36804
11864,33079,16838,16241,2012,36830
11865,23207,11777,11430,2012,36832
11866,3071,852,2219,2012,36849
11867,2700,1317,1383,2012,36850
11868,2279,1107,1172,2012,36852
11869,7885,3854,4031,2012,36853
11870,15899,7750,8149,2012,36854
11871,1612,901,711,2012,36855
11872,4047,2050,1997,2012,36856
11873,538,249,289,2012,36858
11874,8,4,4,2012,36859
11875,1479,676,803,2012,36860
11876,2722,1395,1327,2012,36861
11877,6206,2833,3373,2012,36862
11878,12047,5516,6531,2012,36863
11879,12,7,5,2012,36865
11880,3802,1818,1984,2012,36866
11881,21607,9846,11761,2012,36867
11882,17884,9217,8667,2012,36869
11883,18451,9061,9390,2012,36870
11884,1373,677,696,2012,36871
11885,9064,4201,4863,2012,36874
11886,4699,2246,2453,2012,36875
11887,11018,5604,5414,2012,36877
11888,2381,1205,1176,2012,36879
11889,485,201,284,2012,36901
11890,4089,2007,2082,2012,36904
11891,1966,837,1129,2012,36907
11892,2383,1178,1205,2012,36908
11893,26,0,26,2012,36910
11894,1723,824,899,2012,36912
11895,128,66,62,2012,36913
11896,679,315,364,2012,36915
11897,647,312,335,2012,36916
11898,2148,960,1188,2012,36919
11899,1337,624,713,2012,36921
11900,601,347,254,2012,36922
11901,3698,1612,2086,2012,36925
11902,5751,2753,2998,2012,37010
11903,2436,1285,1151,2012,37012
11904,79903,38429,41474,2012,37013
11905,1746,769,977,2012,37014
11906,16985,8608,8377,2012,37015
11907,935,505,430,2012,37016
11908,1821,908,913,2012,37018
11909,959,562,397,2012,37019
11910,5158,2858,2300,2012,37020
11911,5439,2682,2757,2012,37022
11912,1558,884,674,2012,37023
11913,6348,3494,2854,2012,37025
11914,2226,987,1239,2012,37026
11915,49832,24155,25677,2012,37027
11916,1054,509,545,2012,37028
11917,5357,2751,2606,2012,37029
11918,7259,3599,3660,2012,37030
11919,3948,2016,1932,2012,37031
11920,4470,2235,2235,2012,37032
11921,7950,3946,4004,2012,37033
11922,7210,3434,3776,2012,37034
11923,3257,1804,1453,2012,37035
11924,6008,3058,2950,2012,37036
11925,6293,3179,3114,2012,37037
11926,42918,20928,21990,2012,37040
11927,67119,33438,33681,2012,37042
11928,41236,19765,21471,2012,37043
11929,3973,2045,1928,2012,37046
11930,2474,1210,1264,2012,37047
11931,6211,2959,3252,2012,37048
11932,2941,1462,1479,2012,37049
11933,1747,865,882,2012,37050
11934,3991,1959,2032,2012,37051
11935,2183,1128,1055,2012,37052
11936,27476,12877,14599,2012,37055
11937,1070,573,497,2012,37057
11938,7081,3591,3490,2012,37058
11939,1379,658,721,2012,37059
11940,2361,1257,1104,2012,37060
11941,5366,2546,2820,2012,37061
11942,10214,4644,5570,2012,37062
11943,50207,24545,25662,2012,37064
11944,42873,20394,22479,2012,37066
11945,22980,10636,12344,2012,37067
11946,19475,9651,9824,2012,37069
11947,29598,14116,15482,2012,37072
11948,13150,6442,6708,2012,37073
11949,6922,3455,3467,2012,37074
11950,59694,29022,30672,2012,37075
11951,37784,18755,19029,2012,37076
11952,943,492,451,2012,37078
11953,2386,1098,1288,2012,37079
11954,8189,4315,3874,2012,37080
11955,6539,3133,3406,2012,37082
11956,13528,6376,7152,2012,37083
11957,4240,2074,2166,2012,37085
11958,31672,16321,15351,2012,37086
11959,42364,20780,21584,2012,37087
11960,12155,5908,6247,2012,37090
11961,20095,9892,10203,2012,37091
11962,1706,938,768,2012,37095
11963,5350,2573,2777,2012,37096
11964,2466,1343,1123,2012,37097
11965,4638,2246,2392,2012,37098
11966,6465,2958,3507,2012,37101
11967,32982,16350,16632,2012,37110
11968,36171,16719,19452,2012,37115
11969,1757,815,942,2012,37118
11970,46075,22628,23447,2012,37122
11971,15609,7678,7931,2012,37127
11972,39889,19057,20832,2012,37128
11973,49884,24544,25340,2012,37129
11974,50013,25228,24785,2012,37130
11975,2649,1265,1384,2012,37132
11976,2878,1546,1332,2012,37134
11977,9377,4493,4884,2012,37135
11978,2692,1366,1326,2012,37137
11979,21408,10565,10843,2012,37138
11980,1348,1300,48,2012,37140
11981,1190,530,660,2012,37141
11982,2194,1045,1149,2012,37142
11983,3925,1964,1961,2012,37143
11984,3427,1856,1571,2012,37144
11985,2009,1022,987,2012,37145
11986,7074,3545,3529,2012,37146
11987,22092,11171,10921,2012,37148
11988,2039,1090,949,2012,37149
11989,5089,2585,2504,2012,37150
11990,563,261,302,2012,37151
11991,6206,3120,3086,2012,37153
11992,32139,15697,16442,2012,37160
11993,74,26,48,2012,37165
11994,13215,6686,6529,2012,37166
11995,50453,24327,26126,2012,37167
11996,684,356,328,2012,37171
11997,29571,14471,15100,2012,37172
11998,27238,13236,14002,2012,37174
11999,1183,637,546,2012,37175
12000,2007,1053,954,2012,37178
12001,10148,4962,5186,2012,37179
12002,2887,1563,1324,2012,37180
12003,1525,837,688,2012,37181
12004,3520,1749,1771,2012,37183
12005,6672,3306,3366,2012,37184
12006,8271,4025,4246,2012,37185
12007,9223,4643,4580,2012,37186
12008,6328,3188,3140,2012,37187
12009,13731,6720,7011,2012,37188
12010,3299,1381,1918,2012,37189
12011,8910,4261,4649,2012,37190
12012,4458,2175,2283,2012,37191
12013,1784,1376,408,2012,37201
12014,11171,5642,5529,2012,37203
12015,12826,5658,7168,2012,37204
12016,23605,11193,12412,2012,37205
12017,25264,12040,13224,2012,37206
12018,32896,15168,17728,2012,37207
12019,15593,7155,8438,2012,37208
12020,36480,18629,17851,2012,37209
12021,15337,7413,7924,2012,37210
12022,75621,38236,37385,2012,37211
12023,18961,9375,9586,2012,37212
12024,185,122,63,2012,37213
12025,29668,14199,15469,2012,37214
12026,22224,10550,11674,2012,37215
12027,18078,9080,8998,2012,37216
12028,28758,14541,14217,2012,37217
12029,14464,6604,7860,2012,37218
12030,1078,764,314,2012,37219
12031,5876,2901,2975,2012,37220
12032,37582,17971,19611,2012,37221
12033,1570,509,1061,2012,37228
12034,684,382,302,2012,37240
12035,0,0,0,2012,37243
12036,0,0,0,2012,37246
12037,1539,864,675,2012,37301
12038,3139,1700,1439,2012,37302
12039,25504,12042,13462,2012,37303
12040,956,516,440,2012,37305
12041,3042,1450,1592,2012,37306
12042,5394,2738,2656,2012,37307
12043,2159,1142,1017,2012,37308
12044,2130,1153,977,2012,37309
12045,4057,1810,2247,2012,37310
12046,27131,12925,14206,2012,37311
12047,31626,15545,16081,2012,37312
12048,1786,848,938,2012,37313
12049,1242,549,693,2012,37315
12050,3064,1554,1510,2012,37317
12051,1625,754,871,2012,37318
12052,19711,9603,10108,2012,37321
12053,7902,3985,3917,2012,37322
12054,30207,14890,15317,2012,37323
12055,5190,2548,2642,2012,37324
12056,1389,717,672,2012,37325
12057,456,172,284,2012,37326
12058,11384,5743,5641,2012,37327
12059,1398,784,614,2012,37328
12060,6290,3040,3250,2012,37329
12061,7166,3584,3582,2012,37330
12062,7548,3831,3717,2012,37331
12063,2516,1229,1287,2012,37332
12064,634,362,272,2012,37333
12065,21458,9970,11488,2012,37334
12066,2647,1384,1263,2012,37335
12067,4275,2145,2130,2012,37336
12068,1145,611,534,2012,37337
12069,2937,1415,1522,2012,37338
12070,1798,853,945,2012,37339
12071,464,176,288,2012,37340
12072,13542,6814,6728,2012,37341
12073,3285,1754,1531,2012,37342
12074,41213,20154,21059,2012,37343
12075,2059,1069,990,2012,37345
12076,7161,3627,3534,2012,37347
12077,1350,662,688,2012,37348
12078,1864,908,956,2012,37350
12079,687,395,292,2012,37351
12080,3182,1414,1768,2012,37352
12081,4258,2033,2225,2012,37353
12082,16353,8020,8333,2012,37354
12083,25889,12373,13516,2012,37355
12084,2540,1216,1324,2012,37356
12085,5210,2650,2560,2012,37357
12086,886,544,342,2012,37359
12087,1493,584,909,2012,37360
12088,1569,738,831,2012,37361
12089,3135,1620,1515,2012,37362
12090,31668,15833,15835,2012,37363
12091,1366,658,708,2012,37365
12092,889,427,462,2012,37366
12093,9934,5508,4426,2012,37367
12094,741,392,349,2012,37369
12095,5058,2360,2698,2012,37370
12096,2746,1448,1298,2012,37373
12097,2192,1114,1078,2012,37374
12098,4232,1969,2263,2012,37375
12099,504,299,205,2012,37376
12100,15310,7264,8046,2012,37377
12101,26579,13192,13387,2012,37379
12102,5737,2639,3098,2012,37380
12103,8920,4524,4396,2012,37381
12104,8343,4360,3983,2012,37385
12105,3377,1607,1770,2012,37387
12106,24718,12359,12359,2012,37388
12107,1043,483,560,2012,37391
12108,143,61,82,2012,37394
12109,258,126,132,2012,37396
12110,10540,5282,5258,2012,37397
12111,14159,6662,7497,2012,37398
12112,3816,1866,1950,2012,37402
12113,5563,3008,2555,2012,37403
12114,12358,6060,6298,2012,37404
12115,14686,6941,7745,2012,37405
12116,14450,6558,7892,2012,37406
12117,9059,4274,4785,2012,37407
12118,1280,735,545,2012,37408
12119,2928,1590,1338,2012,37409
12120,4628,2092,2536,2012,37410
12121,18232,8547,9685,2012,37411
12122,21029,9216,11813,2012,37412
12123,23464,11479,11985,2012,37415
12124,14694,6400,8294,2012,37416
12125,6164,2700,3464,2012,37419
12126,46835,22514,24321,2012,37421
12127,36864,17056,19808,2012,37601
12128,34683,17025,17658,2012,37604
12129,1783,742,1041,2012,37614
12130,19024,9642,9382,2012,37615
12131,4982,2359,2623,2012,37616
12132,14239,7202,7037,2012,37617
12133,13376,6619,6757,2012,37618
12134,38660,18649,20011,2012,37620
12135,3594,1897,1697,2012,37640
12136,7903,3869,4034,2012,37641
12137,14272,6884,7388,2012,37642
12138,34225,16655,17570,2012,37643
12139,5156,2318,2838,2012,37645
12140,12470,5968,6502,2012,37650
12141,3965,1951,2014,2012,37656
12142,981,498,483,2012,37657
12143,4058,1928,2130,2012,37658
12144,27319,13671,13648,2012,37659
12145,39880,18720,21160,2012,37660
12146,15156,7599,7557,2012,37663
12147,26194,12393,13801,2012,37664
12148,5401,2458,2943,2012,37665
12149,468,151,317,2012,37680
12150,6220,3187,3033,2012,37681
12151,631,229,402,2012,37682
12152,13627,7507,6120,2012,37683
12153,7229,3579,3650,2012,37686
12154,5058,2693,2365,2012,37687
12155,889,450,439,2012,37688
12156,3887,1801,2086,2012,37690
12157,667,393,274,2012,37691
12158,4842,2481,2361,2012,37692
12159,2037,1208,829,2012,37694
12160,6778,3368,3410,2012,37701
12161,4683,2319,2364,2012,37705
12162,6616,3308,3308,2012,37708
12163,3939,2070,1869,2012,37709
12164,1175,645,530,2012,37710
12165,5028,2495,2533,2012,37711
12166,1381,738,643,2012,37713
12167,4287,1933,2354,2012,37714
12168,667,344,323,2012,37715
12169,25544,12521,13023,2012,37716
12170,107,51,56,2012,37719
12171,12795,6132,6663,2012,37721
12172,6622,3329,3293,2012,37722
12173,944,478,466,2012,37723
12174,2556,1208,1348,2012,37724
12175,15716,7979,7737,2012,37725
12176,1462,642,820,2012,37726
12177,2272,1215,1057,2012,37727
12178,1802,874,928,2012,37729
12179,34,20,14,2012,37730
12180,559,289,270,2012,37731
12181,102,46,56,2012,37732
12182,21,15,6,2012,37733
12183,5677,2967,2710,2012,37737
12184,5210,2381,2829,2012,37738
12185,5968,2900,3068,2012,37742
12186,25819,12691,13128,2012,37743
12187,18250,9063,9187,2012,37745
12188,17774,8604,9170,2012,37748
12189,6470,3344,3126,2012,37752
12190,790,371,419,2012,37753
12191,4434,2369,2065,2012,37754
12192,3115,1568,1547,2012,37755
12193,3349,1565,1784,2012,37756
12194,9385,4840,4545,2012,37757
12195,13795,6794,7001,2012,37760
12196,2867,1320,1547,2012,37762
12197,16030,8067,7963,2012,37763
12198,9328,4549,4779,2012,37764
12199,445,206,239,2012,37765
12200,18887,9118,9769,2012,37766
12201,6123,3145,2978,2012,37769
12202,3068,1684,1384,2012,37770
12203,15526,7572,7954,2012,37771
12204,10559,5082,5477,2012,37772
12205,19084,9409,9675,2012,37774
12206,12050,5922,6128,2012,37777
12207,4493,2186,2307,2012,37779
12208,24703,12100,12603,2012,37801
12209,30917,14748,16169,2012,37803
12210,24483,11783,12700,2012,37804
12211,2916,1310,1606,2012,37806
12212,9594,4766,4828,2012,37807
12213,2719,1392,1327,2012,37809
12214,1862,887,975,2012,37810
12215,3409,1650,1759,2012,37811
12216,18581,9189,9392,2012,37813
12217,32674,15823,16851,2012,37814
12218,4942,2366,2576,2012,37818
12219,602,327,275,2012,37819
12220,7599,3662,3937,2012,37820
12221,22196,10540,11656,2012,37821
12222,8473,4223,4250,2012,37825
12223,4299,2224,2075,2012,37826
12224,1622,793,829,2012,37828
12225,1983,941,1042,2012,37829
12226,29698,14203,15495,2012,37830
12227,9518,4563,4955,2012,37840
12228,10006,4727,5279,2012,37841
12229,3676,1808,1868,2012,37843
12230,558,278,280,2012,37845
12231,6181,3223,2958,2012,37846
12232,2412,1111,1301,2012,37847
12233,245,129,116,2012,37848
12234,25989,12720,13269,2012,37849
12235,37,28,9,2012,37851
12236,2601,1367,1234,2012,37852
12237,3807,1768,2039,2012,37853
12238,12582,5936,6646,2012,37854
12239,21523,10623,10900,2012,37857
12240,4175,2012,2163,2012,37860
12241,8056,3899,4157,2012,37861
12242,21797,10896,10901,2012,37862
12243,6538,3325,3213,2012,37863
12244,20373,10289,10084,2012,37865
12245,1577,793,784,2012,37866
12246,5031,2470,2561,2012,37869
12247,4973,2553,2420,2012,37870
12248,8742,4163,4579,2012,37871
12249,1661,819,842,2012,37872
12250,4508,2457,2051,2012,37873
12251,13650,6635,7015,2012,37874
12252,29337,14235,15102,2012,37876
12253,8022,3790,4232,2012,37877
12254,587,258,329,2012,37878
12255,10654,4948,5706,2012,37879
12256,4053,2070,1983,2012,37880
12257,2316,1235,1081,2012,37881
12258,3043,1426,1617,2012,37882
12259,4819,2259,2560,2012,37885
12260,4558,2013,2545,2012,37886
12261,7517,4855,2662,2012,37887
12262,2657,1225,1432,2012,37888
12263,6825,3324,3501,2012,37890
12264,3051,1444,1607,2012,37891
12265,1987,1115,872,2012,37892
12266,1752,989,763,2012,37902
12267,15924,7400,8524,2012,37909
12268,19178,9537,9641,2012,37912
12269,20307,9652,10655,2012,37914
12270,5982,2738,3244,2012,37915
12271,12647,6985,5662,2012,37916
12272,24466,11542,12924,2012,37917
12273,43240,20925,22315,2012,37918
12274,28927,13316,15611,2012,37919
12275,37359,18170,19189,2012,37920
12276,27838,12989,14849,2012,37921
12277,33871,16340,17531,2012,37922
12278,27731,14774,12957,2012,37923
12279,10597,5429,5168,2012,37924
12280,25646,12318,13328,2012,37931
12281,14272,7124,7148,2012,37932
12282,24597,11516,13081,2012,37934
12283,18005,9017,8988,2012,37938
12284,4214,2037,2177,2012,38001
12285,37458,18151,19307,2012,38002
12286,10125,4772,5353,2012,38004
12287,5786,2904,2882,2012,38006
12288,94,43,51,2012,38007
12289,9121,4424,4697,2012,38008
12290,9239,4523,4716,2012,38011
12291,14308,6651,7657,2012,38012
12292,2963,1476,1487,2012,38015
12293,43137,19726,23411,2012,38016
12294,47262,22634,24628,2012,38017
12295,34728,16779,17949,2012,38018
12296,16078,7919,8159,2012,38019
12297,191,81,110,2012,38021
12298,6135,3031,3104,2012,38023
12299,27729,13229,14500,2012,38024
12300,6899,3297,3602,2012,38028
12301,0,0,0,2012,38029
12302,799,424,375,2012,38030
12303,3229,1597,1632,2012,38034
12304,502,189,313,2012,38036
12305,2101,991,1110,2012,38037
12306,1719,961,758,2012,38039
12307,5496,2660,2836,2012,38040
12308,4979,3755,1224,2012,38041
12309,762,357,405,2012,38042
12310,719,288,431,2012,38044
12311,47,24,23,2012,38046
12312,313,75,238,2012,38047
12313,4758,2642,2116,2012,38049
12314,512,259,253,2012,38050
12315,4366,2205,2161,2012,38052
12316,28871,14441,14430,2012,38053
12317,238,176,62,2012,38054
12318,3545,1732,1813,2012,38057
12319,8904,4354,4550,2012,38058
12320,7247,3779,3468,2012,38059
12321,9459,4823,4636,2012,38060
12322,687,326,361,2012,38061
12323,16683,7786,8897,2012,38063
12324,2532,1261,1271,2012,38066
12325,1499,663,836,2012,38067
12326,10951,5437,5514,2012,38068
12327,2393,1188,1205,2012,38069
12328,46,14,32,2012,38070
12329,7060,5062,1998,2012,38075
12330,1241,511,730,2012,38076
12331,16,16,0,2012,38077
12332,5473,3844,1629,2012,38079
12333,2558,1179,1379,2012,38080
12334,12168,7375,4793,2012,38103
12335,23031,11505,11526,2012,38104
12336,6445,3607,2838,2012,38105
12337,25065,11649,13416,2012,38106
12338,16739,8238,8501,2012,38107
12339,19630,9644,9986,2012,38108
12340,48322,22023,26299,2012,38109
12341,43199,20604,22595,2012,38111
12342,17531,8423,9108,2012,38112
12343,28363,13275,15088,2012,38114
12344,39084,17368,21716,2012,38115
12345,40468,17886,22582,2012,38116
12346,26622,12340,14282,2012,38117
12347,43021,20318,22703,2012,38118
12348,23361,11486,11875,2012,38119
12349,14003,6625,7378,2012,38120
12350,23838,12347,11491,2012,38122
12351,37414,17481,19933,2012,38125
12352,6881,2949,3932,2012,38126
12353,46994,21563,25431,2012,38127
12354,43348,20619,22729,2012,38128
12355,0,0,0,2012,38131
12356,0,0,0,2012,38132
12357,21646,10632,11014,2012,38133
12358,43406,21845,21561,2012,38134
12359,29058,13709,15349,2012,38135
12360,23329,11249,12080,2012,38138
12361,16752,8433,8319,2012,38139
12362,22750,10822,11928,2012,38141
12363,619,134,485,2012,38152
12364,10015,4820,5195,2012,38201
12365,1736,909,827,2012,38220
12366,3311,1487,1824,2012,38221
12367,2520,1252,1268,2012,38222
12368,953,523,430,2012,38224
12369,6248,3160,3088,2012,38225
12370,211,135,76,2012,38226
12371,2942,1436,1506,2012,38229
12372,3623,1642,1981,2012,38230
12373,2253,1036,1217,2012,38231
12374,2062,1050,1012,2012,38232
12375,2878,1418,1460,2012,38233
12376,195,94,101,2012,38235
12377,548,305,243,2012,38236
12378,16345,8008,8337,2012,38237
12379,2220,1175,1045,2012,38240
12380,963,543,420,2012,38241
12381,19952,9483,10469,2012,38242
12382,2941,1443,1498,2012,38251
12383,1442,750,692,2012,38253
12384,36,21,15,2012,38254
12385,2452,1273,1179,2012,38255
12386,2728,1413,1315,2012,38256
12387,4354,2021,2333,2012,38257
12388,1580,769,811,2012,38258
12389,945,448,497,2012,38259
12390,3824,1985,1839,2012,38260
12391,16661,7843,8818,2012,38261
12392,36045,16768,19277,2012,38301
12393,49537,23765,25772,2012,38305
12394,6477,3178,3299,2012,38310
12395,1048,597,451,2012,38311
12396,3082,1723,1359,2012,38313
12397,3688,1749,1939,2012,38315
12398,3152,1621,1531,2012,38316
12399,2635,1234,1401,2012,38317
12400,267,135,132,2012,38318
12401,10617,5387,5230,2012,38320
12402,2271,1114,1157,2012,38321
12403,2230,1046,1184,2012,38326
12404,451,219,232,2012,38327
12405,721,398,323,2012,38328
12406,3441,1660,1781,2012,38329
12407,4577,2167,2410,2012,38330
12408,1586,758,828,2012,38332
12409,402,200,202,2012,38333
12410,1734,796,938,2012,38334
12411,1327,692,635,2012,38337
12412,570,303,267,2012,38339
12413,13926,6637,7289,2012,38340
12414,2416,1246,1170,2012,38341
12415,1379,630,749,2012,38342
12416,15732,7047,8685,2012,38343
12417,8879,4128,4751,2012,38344
12418,1880,992,888,2012,38345
12419,146,87,59,2012,38347
12420,1081,526,555,2012,38348
12421,18569,8952,9617,2012,38351
12422,322,180,142,2012,38352
12423,5544,2691,2853,2012,38355
12424,2619,1328,1291,2012,38356
12425,2964,1644,1320,2012,38357
12426,11676,5401,6275,2012,38358
12427,355,172,183,2012,38359
12428,835,419,416,2012,38361
12429,1021,358,663,2012,38362
12430,5752,2673,3079,2012,38363
12431,0,0,0,2012,38365
12432,2367,1025,1342,2012,38366
12433,2857,1350,1507,2012,38367
12434,1414,607,807,2012,38368
12435,1885,942,943,2012,38369
12436,637,346,291,2012,38370
12437,1252,700,552,2012,38371
12438,17754,8322,9432,2012,38372
12439,1640,733,907,2012,38374
12440,9191,4540,4651,2012,38375
12441,161,82,79,2012,38376
12442,1039,537,502,2012,38379
12443,647,337,310,2012,38380
12444,1397,722,675,2012,38381
12445,9410,4654,4756,2012,38382
12446,523,267,256,2012,38387
12447,1941,908,1033,2012,38388
12448,905,452,453,2012,38390
12449,1300,656,644,2012,38391
12450,634,373,261,2012,38392
12451,54028,25954,28074,2012,38401
12452,3483,2820,663,2012,38425
12453,3159,1606,1553,2012,38449
12454,2828,1441,1387,2012,38450
12455,5148,2632,2516,2012,38451
12456,1320,638,682,2012,38452
12457,430,235,195,2012,38453
12458,1489,640,849,2012,38454
12459,124,72,52,2012,38455
12460,3905,1859,2046,2012,38456
12461,667,284,383,2012,38457
12462,720,340,380,2012,38459
12463,1478,787,691,2012,38460
12464,1543,832,711,2012,38461
12465,10435,5352,5083,2012,38462
12466,2520,1249,1271,2012,38463
12467,23046,10996,12050,2012,38464
12468,5068,2673,2395,2012,38468
12469,3887,1976,1911,2012,38469
12470,595,318,277,2012,38471
12471,2672,1173,1499,2012,38472
12472,950,438,512,2012,38473
12473,8047,3895,4152,2012,38474
12474,681,372,309,2012,38475
12475,1254,600,654,2012,38476
12476,2718,1415,1303,2012,38477
12477,17996,8797,9199,2012,38478
12478,960,458,502,2012,38481
12479,1355,702,653,2012,38482
12480,5344,2670,2674,2012,38483
12481,6576,3107,3469,2012,38485
12482,892,503,389,2012,38486
12483,521,259,262,2012,38487
12484,2317,1236,1081,2012,38488
12485,37080,17958,19122,2012,38501
12486,1194,635,559,2012,38504
12487,1648,927,721,2012,38505
12488,25920,13267,12653,2012,38506
12489,1715,898,817,2012,38541
12490,28,11,17,2012,38542
12491,544,274,270,2012,38543
12492,7306,3727,3579,2012,38544
12493,1334,663,671,2012,38545
12494,1619,735,884,2012,38547
12495,686,375,311,2012,38548
12496,3813,1830,1983,2012,38549
12497,3923,1932,1991,2012,38551
12498,599,357,242,2012,38552
12499,2507,1269,1238,2012,38553
12500,902,403,499,2012,38554
12501,19436,9212,10224,2012,38555
12502,12049,5837,6212,2012,38556
12503,7249,3369,3880,2012,38558
12504,1430,689,741,2012,38559
12505,1371,720,651,2012,38560
12506,6570,3194,3376,2012,38562
12507,2337,1086,1251,2012,38563
12508,334,188,146,2012,38564
12509,1052,505,547,2012,38565
12510,887,441,446,2012,38567
12511,2107,996,1111,2012,38568
12512,476,188,288,2012,38569
12513,10086,4880,5206,2012,38570
12514,13496,6724,6772,2012,38571
12515,10121,5039,5082,2012,38572
12516,2295,1174,1121,2012,38573
12517,8166,3877,4289,2012,38574
12518,1324,681,643,2012,38575
12519,905,463,442,2012,38577
12520,114,17,97,2012,38578
12521,1011,460,551,2012,38579
12522,1744,882,862,2012,38580
12523,4243,2048,2195,2012,38581
12524,1403,748,655,2012,38582
12525,24010,11678,12332,2012,38583
12526,4113,2074,2039,2012,38585
12527,1156,604,552,2012,38587
12528,700,364,336,2012,38588
12529,238,107,131,2012,38589
12530,2808,1460,1348,2012,38601
12531,2934,1385,1549,2012,38603
12532,15562,7225,8337,2012,38606
12533,3326,1609,1717,2012,38610
12534,16299,8350,7949,2012,38611
12535,19997,9069,10928,2012,38614
12536,892,438,454,2012,38617
12537,11309,5703,5606,2012,38618
12538,5223,2670,2553,2012,38619
12539,4012,1775,2237,2012,38620
12540,1847,806,1041,2012,38621
12541,527,249,278,2012,38622
12542,267,121,146,2012,38623
12543,1223,644,579,2012,38625
12544,1251,697,554,2012,38626
12545,1129,578,551,2012,38627
12546,2610,1169,1441,2012,38629
12547,229,170,59,2012,38630
12548,958,442,516,2012,38631
12549,24714,12115,12599,2012,38632
12550,2612,1328,1284,2012,38633
12551,17194,8289,8905,2012,38635
12552,26120,12388,13732,2012,38637
12553,1255,574,681,2012,38639
12554,2460,1172,1288,2012,38641
12555,1890,878,1012,2012,38642
12556,2565,1092,1473,2012,38643
12557,286,141,145,2012,38644
12558,1931,824,1107,2012,38645
12559,3180,1625,1555,2012,38646
12560,1355,686,669,2012,38647
12561,4375,2058,2317,2012,38650
12562,7081,3477,3604,2012,38651
12563,15407,7464,7943,2012,38652
12564,46582,22732,23850,2012,38654
12565,36109,17926,18183,2012,38655
12566,1581,872,709,2012,38658
12567,2751,1272,1479,2012,38659
12568,1556,790,766,2012,38661
12569,11438,5692,5746,2012,38663
12570,3583,1657,1926,2012,38664
12571,2515,927,1588,2012,38665
12572,7690,3829,3861,2012,38666
12573,15053,7378,7675,2012,38668
12574,1272,641,631,2012,38670
12575,36312,17505,18807,2012,38671
12576,10700,5067,5633,2012,38672
12577,678,318,360,2012,38673
12578,1087,519,568,2012,38674
12579,6022,2871,3151,2012,38676
12580,4680,2129,2551,2012,38677
12581,5580,2909,2671,2012,38680
12582,5344,2610,2734,2012,38683
12583,1316,506,810,2012,38685
12584,23728,11217,12511,2012,38701
12585,0,0,0,2012,38702
12586,14058,6166,7892,2012,38703
12587,25,11,14,2012,38704
12588,668,292,376,2012,38720
12589,1198,565,633,2012,38721
12590,551,262,289,2012,38722
12591,6,0,6,2012,38723
12592,820,379,441,2012,38725
12593,402,184,218,2012,38726
12594,1682,840,842,2012,38730
12595,230,75,155,2012,38731
12596,17896,8198,9698,2012,38732
12597,618,259,359,2012,38736
12598,4096,2631,1465,2012,38737
12599,2881,2793,88,2012,38738
12600,347,190,157,2012,38740
12601,837,438,399,2012,38744
12602,172,88,84,2012,38745
12603,742,375,367,2012,38746
12604,4231,2006,2225,2012,38748
12605,20,8,12,2012,38749
12606,11611,5247,6364,2012,38751
12607,1473,646,827,2012,38753
12608,1751,874,877,2012,38754
12609,6854,3350,3504,2012,38756
12610,1074,509,565,2012,38759
12611,872,340,532,2012,38760
12612,2674,1284,1390,2012,38761
12613,2561,1074,1487,2012,38762
12614,370,215,155,2012,38764
12615,89,30,59,2012,38765
12616,83,54,29,2012,38767
12617,171,86,85,2012,38768
12618,2439,1183,1256,2012,38769
12619,3042,1310,1732,2012,38771
12620,145,84,61,2012,38772
12621,3590,1750,1840,2012,38773
12622,2388,1142,1246,2012,38774
12623,1670,761,909,2012,38778
12624,163,68,95,2012,38781
12625,29129,12999,16130,2012,38801
12626,17595,8634,8961,2012,38804
12627,12418,5780,6638,2012,38821
12628,8821,4254,4567,2012,38824
12629,4745,2468,2277,2012,38826
12630,2762,1402,1360,2012,38827
12631,4718,2439,2279,2012,38828
12632,17890,8942,8948,2012,38829
12633,3165,1492,1673,2012,38833
12634,29772,14631,15141,2012,38834
12635,1363,671,692,2012,38838
12636,2000,985,1015,2012,38841
12637,11518,5796,5722,2012,38843
12638,173,83,90,2012,38844
12639,2363,1224,1139,2012,38846
12640,3382,1555,1827,2012,38847
12641,894,453,441,2012,38848
12642,5685,2891,2794,2012,38849
12643,3067,1551,1516,2012,38850
12644,8522,4052,4470,2012,38851
12645,8802,4188,4614,2012,38852
12646,5062,2329,2733,2012,38855
12647,1846,999,847,2012,38856
12648,3220,1665,1555,2012,38857
12649,6986,3448,3538,2012,38858
12650,618,296,322,2012,38859
12651,5647,2633,3014,2012,38860
12652,2871,1357,1514,2012,38862
12653,20871,10114,10757,2012,38863
12654,1559,845,714,2012,38864
12655,4223,1875,2348,2012,38865
12656,11878,5764,6114,2012,38866
12657,4937,2319,2618,2012,38868
12658,276,90,186,2012,38869
12659,2941,1565,1376,2012,38870
12660,2080,1079,1001,2012,38871
12661,2609,1264,1345,2012,38873
12662,1476,643,833,2012,38876
12663,3033,1555,1478,2012,38878
12664,671,324,347,2012,38879
12665,18627,8506,10121,2012,38901
12666,422,230,192,2012,38913
12667,505,314,191,2012,38914
12668,3876,1686,2190,2012,38915
12669,4787,2189,2598,2012,38916
12670,2851,1462,1389,2012,38917
12671,598,273,325,2012,38920
12672,4842,2062,2780,2012,38921
12673,3693,1955,1738,2012,38922
12674,1713,899,814,2012,38923
12675,784,299,485,2012,38924
12676,2412,1200,1212,2012,38925
12677,1091,546,545,2012,38927
12678,286,127,159,2012,38928
12679,1213,597,616,2012,38929
12680,26028,12462,13566,2012,38930
12681,1574,836,738,2012,38940
12682,4823,2269,2554,2012,38941
12683,365,208,157,2012,38943
12684,446,220,226,2012,38944
12685,17,0,17,2012,38945
12686,399,146,253,2012,38946
12687,570,171,399,2012,38947
12688,1883,779,1104,2012,38948
12689,140,59,81,2012,38949
12690,247,95,152,2012,38950
12691,1491,738,753,2012,38951
12692,767,377,390,2012,38952
12693,1237,827,410,2012,38953
12694,1171,587,584,2012,38954
12695,579,305,274,2012,38957
12696,30,18,12,2012,38958
12697,905,416,489,2012,38961
12698,77,21,56,2012,38962
12699,5063,3728,1335,2012,38963
12700,269,102,167,2012,38964
12701,8595,4182,4413,2012,38965
12702,996,371,625,2012,38966
12703,7519,3340,4179,2012,38967
12704,6702,3128,3574,2012,39038
12705,1993,1115,878,2012,39039
12706,3531,1855,1676,2012,39040
12707,3680,1671,2009,2012,39041
12708,34594,16331,18263,2012,39042
12709,3588,1730,1858,2012,39044
12710,1445,579,866,2012,39045
12711,26475,12592,13883,2012,39046
12712,37728,17904,19824,2012,39047
12713,16659,8085,8574,2012,39051
12714,519,263,256,2012,39054
12715,26061,12451,13610,2012,39056
12716,2034,1110,924,2012,39057
12717,11303,5636,5667,2012,39059
12718,206,25,181,2012,39061
12719,460,253,207,2012,39062
12720,3472,1682,1790,2012,39063
12721,4504,2208,2296,2012,39066
12722,1495,750,745,2012,39067
12723,6433,3393,3040,2012,39069
12724,5023,2440,2583,2012,39071
12725,19811,9932,9879,2012,39073
12726,15395,7460,7935,2012,39074
12727,810,325,485,2012,39078
12728,2112,1022,1090,2012,39079
12729,911,470,441,2012,39082
12730,11474,5390,6084,2012,39083
12731,2204,1039,1165,2012,39086
12732,195,151,44,2012,39088
12733,13631,6114,7517,2012,39090
12734,3147,1679,1468,2012,39092
12735,4419,2134,2285,2012,39094
12736,7071,3394,3677,2012,39095
12737,1401,676,725,2012,39096
12738,548,262,286,2012,39097
12739,1697,933,764,2012,39108
12740,36954,18194,18760,2012,39110
12741,9547,4613,4934,2012,39111
12742,691,471,220,2012,39113
12743,10307,5059,5248,2012,39114
12744,137,60,77,2012,39115
12745,2882,1510,1372,2012,39116
12746,9646,4594,5052,2012,39117
12747,5917,2695,3222,2012,39119
12748,32536,16187,16349,2012,39120
12749,2249,995,1254,2012,39140
12750,1152,539,613,2012,39144
12751,5052,2473,2579,2012,39145
12752,2708,1144,1564,2012,39146
12753,1882,964,918,2012,39149
12754,5623,2579,3044,2012,39150
12755,1216,640,576,2012,39152
12756,3619,1671,1948,2012,39153
12757,10365,5255,5110,2012,39154
12758,318,177,141,2012,39156
12759,24585,11560,13025,2012,39157
12760,3126,1427,1699,2012,39159
12761,3234,1770,1464,2012,39160
12762,103,32,71,2012,39162
12763,494,236,258,2012,39166
12764,0,0,0,2012,39167
12765,6809,3128,3681,2012,39168
12766,3175,1540,1635,2012,39169
12767,9205,4445,4760,2012,39170
12768,641,250,391,2012,39174
12769,4807,2613,2194,2012,39175
12770,2262,1120,1142,2012,39176
12771,60,30,30,2012,39177
12772,733,346,387,2012,39179
12773,33555,16165,17390,2012,39180
12774,14546,6744,7802,2012,39183
12775,4584,2606,1978,2012,39189
12776,6699,3200,3499,2012,39191
12777,1218,529,689,2012,39192
12778,989,786,203,2012,39193
12779,21538,11913,9625,2012,39194
12780,436,306,130,2012,39201
12781,8808,4297,4511,2012,39202
12782,7147,3233,3914,2012,39203
12783,18964,8927,10037,2012,39204
12784,24705,10920,13785,2012,39206
12785,28990,14272,14718,2012,39208
12786,30391,14045,16346,2012,39209
12787,24713,11276,13437,2012,39211
12788,33294,15395,17899,2012,39212
12789,22700,10733,11967,2012,39213
12790,3141,1603,1538,2012,39216
12791,661,229,432,2012,39217
12792,7398,3477,3921,2012,39218
12793,7099,3129,3970,2012,39232
12794,0,0,0,2012,39269
12795,13364,6370,6994,2012,39272
12796,27139,12491,14648,2012,39301
12797,20319,9504,10815,2012,39305
12798,18377,9469,8908,2012,39307
12799,651,517,134,2012,39309
12800,1952,871,1081,2012,39320
12801,1867,816,1051,2012,39322
12802,1071,579,492,2012,39323
12803,5978,3054,2924,2012,39325
12804,1151,554,597,2012,39326
12805,4332,2079,2253,2012,39327
12806,4977,2520,2457,2012,39328
12807,2495,1349,1146,2012,39330
12808,2046,1061,985,2012,39332
12809,3401,1634,1767,2012,39335
12810,1114,511,603,2012,39336
12811,1870,1001,869,2012,39337
12812,3089,1597,1492,2012,39338
12813,15654,7441,8213,2012,39339
12814,6586,3177,3409,2012,39341
12815,1284,555,729,2012,39342
12816,6190,2740,3450,2012,39345
12817,2752,1423,1329,2012,39346
12818,1655,611,1044,2012,39347
12819,287,90,197,2012,39348
12820,25375,11901,13474,2012,39350
12821,692,394,298,2012,39352
12822,1280,663,617,2012,39354
12823,6341,2787,3554,2012,39355
12824,648,426,222,2012,39356
12825,1756,837,919,2012,39358
12826,181,102,79,2012,39359
12827,4663,2509,2154,2012,39360
12828,1906,892,1014,2012,39361
12829,3127,1515,1612,2012,39362
12830,1742,762,980,2012,39363
12831,3473,1891,1582,2012,39364
12832,7359,3594,3765,2012,39365
12833,1317,501,816,2012,39366
12834,14372,7033,7339,2012,39367
12835,43639,20710,22929,2012,39401
12836,38401,17851,20550,2012,39402
12837,2124,1066,1058,2012,39406
12838,3413,1649,1764,2012,39421
12839,5307,2445,2862,2012,39422
12840,2652,1257,1395,2012,39423
12841,1681,842,839,2012,39425
12842,15403,7620,7783,2012,39426
12843,1178,518,660,2012,39427
12844,9659,4902,4757,2012,39428
12845,17718,8608,9110,2012,39429
12846,12657,6169,6488,2012,39437
12847,4447,2119,2328,2012,39439
12848,20520,9911,10609,2012,39440
12849,22842,11263,11579,2012,39443
12850,7118,4812,2306,2012,39451
12851,27041,13834,13207,2012,39452
12852,9231,4731,4500,2012,39455
12853,1325,714,611,2012,39456
12854,3751,1839,1912,2012,39459
12855,649,303,346,2012,39461
12856,1599,842,757,2012,39462
12857,2536,1353,1183,2012,39464
12858,21719,10670,11049,2012,39465
12859,28673,14034,14639,2012,39466
12860,13607,6793,6814,2012,39470
12861,6050,3082,2968,2012,39474
12862,12120,6133,5987,2012,39475
12863,6637,3279,3358,2012,39476
12864,627,275,352,2012,39477
12865,2036,993,1043,2012,39478
12866,5055,2385,2670,2012,39479
12867,2934,1501,1433,2012,39480
12868,2042,1039,1003,2012,39481
12869,9320,4549,4771,2012,39482
12870,6183,2903,3280,2012,39483
12871,21740,10863,10877,2012,39501
12872,46548,23622,22926,2012,39503
12873,15719,7628,8091,2012,39507
12874,14850,7120,7730,2012,39520
12875,8546,4279,4267,2012,39525
12876,8143,4039,4104,2012,39530
12877,17266,8386,8880,2012,39531
12878,34252,17072,17180,2012,39532
12879,2179,1659,520,2012,39534
12880,8749,4317,4432,2012,39540
12881,17543,8369,9174,2012,39553
12882,7337,3651,3686,2012,39556
12883,16553,7226,9327,2012,39560
12884,2155,1108,1047,2012,39561
12885,17486,8335,9151,2012,39562
12886,13842,7052,6790,2012,39563
12887,38000,18730,19270,2012,39564
12888,18689,9410,9279,2012,39565
12889,10529,5357,5172,2012,39567
12890,13069,6423,6646,2012,39571
12891,1032,474,558,2012,39572
12892,8325,4160,4165,2012,39573
12893,12840,6307,6533,2012,39574
12894,5781,2960,2821,2012,39576
12895,10600,5263,5337,2012,39577
12896,11956,5884,6072,2012,39581
12897,24780,11973,12807,2012,39601
12898,6054,2917,3137,2012,39629
12899,1260,545,715,2012,39630
12900,3766,1760,2006,2012,39631
12901,1441,701,740,2012,39633
12902,244,88,156,2012,39635
12903,3114,1478,1636,2012,39638
12904,4526,2186,2340,2012,39641
12905,829,423,406,2012,39643
12906,4753,2437,2316,2012,39645
12907,582,244,338,2012,39647
12908,22395,10761,11634,2012,39648
12909,8821,4034,4787,2012,39652
12910,3169,1636,1533,2012,39653
12911,5732,2580,3152,2012,39654
12912,1055,556,499,2012,39656
12913,1885,900,985,2012,39657
12914,2707,1270,1437,2012,39661
12915,1160,474,686,2012,39662
12916,2749,1522,1227,2012,39663
12917,2127,1055,1072,2012,39664
12918,1180,581,599,2012,39665
12919,9232,4285,4947,2012,39666
12920,12727,6206,6521,2012,39667
12921,422,206,216,2012,39668
12922,5715,3335,2380,2012,39669
12923,14097,5885,8212,2012,39701
12924,22418,10707,11711,2012,39702
12925,14023,7017,7006,2012,39705
12926,12223,5675,6548,2012,39730
12927,4180,2108,2072,2012,39735
12928,303,130,173,2012,39736
12929,585,330,255,2012,39737
12930,3094,1430,1664,2012,39739
12931,5490,2893,2597,2012,39740
12932,1438,724,714,2012,39741
12933,1492,684,808,2012,39743
12934,5628,2775,2853,2012,39744
12935,759,350,409,2012,39745
12936,3094,1394,1700,2012,39746
12937,1886,976,910,2012,39747
12938,2641,1178,1463,2012,39750
12939,1286,593,693,2012,39751
12940,2729,1366,1363,2012,39752
12941,889,404,485,2012,39755
12942,2331,966,1365,2012,39756
12943,41887,20992,20895,2012,39759
12944,0,0,0,2012,39760
12945,2238,1022,1216,2012,39762
12946,2526,1337,1189,2012,39766
12947,540,209,331,2012,39767
12948,2075,1111,964,2012,39769
12949,226,79,147,2012,39771
12950,1676,709,967,2012,39772
12951,16699,8001,8698,2012,39773
12952,1465,658,807,2012,39776
12953,2103,957,1146,2012,39813
12954,1666,744,922,2012,39815
12955,11597,5844,5753,2012,39817
12956,10654,5140,5514,2012,39819
12957,8687,4073,4614,2012,39823
12958,478,247,231,2012,39824
12959,1283,619,664,2012,39825
12960,702,376,326,2012,39826
12961,4157,2216,1941,2012,39827
12962,14993,7111,7882,2012,39828
12963,2218,1018,1200,2012,39834
12964,669,305,364,2012,39836
12965,6112,2997,3115,2012,39837
12966,5366,2655,2711,2012,39840
12967,676,301,375,2012,39841
12968,8110,3870,4240,2012,39842
12969,7653,3528,4125,2012,39845
12970,1617,672,945,2012,39846
12971,2419,1141,1278,2012,39851
12972,2591,1254,1337,2012,39854
12973,1469,656,813,2012,39859
12974,1065,487,578,2012,39861
12975,1133,533,600,2012,39862
12976,2961,2374,587,2012,39866
12977,204,102,102,2012,39867
12978,2469,1120,1349,2012,39870
12979,479,285,194,2012,39877
12980,155,98,57,2012,39885
12981,1717,881,836,2012,39886
12982,3632,1728,1904,2012,39897
12983,1962,1036,926,2012,40003
12984,27806,13667,14139,2012,40004
12985,5068,2595,2473,2012,40006
12986,178,87,91,2012,40007
12987,3930,1971,1959,2012,40008
12988,1408,660,748,2012,40009
12989,560,303,257,2012,40010
12990,2351,1196,1155,2012,40011
12991,457,172,285,2012,40012
12992,5825,2912,2913,2012,40013
12993,19998,9745,10253,2012,40014
12994,3384,1544,1840,2012,40019
12995,92,36,56,2012,40020
12996,836,375,461,2012,40022
12997,3732,1936,1796,2012,40023
12998,85,43,42,2012,40025
12999,5107,2529,2578,2012,40026
13000,22390,12952,9438,2012,40031
13001,12225,6060,6165,2012,40033
13002,304,152,152,2012,40036
13003,2886,1605,1281,2012,40037
13004,481,207,274,2012,40040
13005,381,92,289,2012,40041
13006,3380,1725,1655,2012,40045
13007,1924,1040,884,2012,40046
13008,19531,9577,9954,2012,40047
13009,89,0,89,2012,40048
13010,109,4,105,2012,40049
13011,1644,794,850,2012,40050
13012,4663,2368,2295,2012,40051
13013,706,421,285,2012,40052
13014,1585,856,729,2012,40055
13015,3680,1827,1853,2012,40056
13016,3947,2034,1913,2012,40057
13017,89,41,48,2012,40058
13018,17195,8627,8568,2012,40059
13019,1099,536,563,2012,40060
13020,482,219,263,2012,40062
13021,780,761,19,2012,40063
13022,27823,13314,14509,2012,40065
13023,5606,2427,3179,2012,40067
13024,2140,1055,1085,2012,40068
13025,8315,4133,4182,2012,40069
13026,578,343,235,2012,40070
13027,14635,7384,7251,2012,40071
13028,1229,667,562,2012,40075
13029,2505,1262,1243,2012,40076
13030,538,277,261,2012,40077
13031,2185,1203,982,2012,40078
13032,1108,581,527,2012,40104
13033,1965,1012,953,2012,40107
13034,11394,5609,5785,2012,40108
13035,2641,1306,1335,2012,40109
13036,13,0,13,2012,40110
13037,1712,855,857,2012,40111
13038,601,315,286,2012,40115
13039,2110,1074,1036,2012,40117
13040,9710,4676,5034,2012,40118
13041,1635,763,872,2012,40119
13042,10946,6484,4462,2012,40121
13043,658,355,303,2012,40140
13044,2405,1337,1068,2012,40142
13045,6466,3286,3180,2012,40143
13046,1382,692,690,2012,40144
13047,1194,616,578,2012,40145
13048,4399,2012,2387,2012,40146
13049,3603,1768,1835,2012,40150
13050,470,221,249,2012,40152
13051,1246,676,570,2012,40155
13052,888,420,468,2012,40157
13053,22999,10952,12047,2012,40160
13054,73,35,38,2012,40161
13055,5912,3026,2886,2012,40162
13056,32875,16478,16397,2012,40165
13057,273,163,110,2012,40170
13058,192,111,81,2012,40171
13059,13318,6530,6788,2012,40175
13060,1179,643,536,2012,40176
13061,1553,671,882,2012,40177
13062,464,233,231,2012,40178
13063,6429,4413,2016,2012,40202
13064,19270,9063,10207,2012,40203
13065,14480,7380,7100,2012,40204
13066,23483,10981,12502,2012,40205
13067,18474,8660,9814,2012,40206
13068,28989,13522,15467,2012,40207
13069,13727,6931,6796,2012,40208
13070,683,373,310,2012,40209
13071,16230,7618,8612,2012,40210
13072,22770,10116,12654,2012,40211
13073,18628,8627,10001,2012,40212
13074,16008,7880,8128,2012,40213
13075,44880,22074,22806,2012,40214
13076,23450,11601,11849,2012,40215
13077,40697,19497,21200,2012,40216
13078,12102,6196,5906,2012,40217
13079,29441,13898,15543,2012,40218
13080,38383,18160,20223,2012,40219
13081,32610,15420,17190,2012,40220
13082,21922,10347,11575,2012,40222
13083,21500,10256,11244,2012,40223
13084,15897,7381,8516,2012,40228
13085,36630,18111,18519,2012,40229
13086,0,0,0,2012,40231
13087,29260,14563,14697,2012,40241
13088,10761,4945,5816,2012,40242
13089,10004,4720,5284,2012,40243
13090,30352,14804,15548,2012,40245
13091,27304,13086,14218,2012,40258
13092,37826,18687,19139,2012,40272
13093,406,236,170,2012,40280
13094,33897,16204,17693,2012,40291
13095,38833,18975,19858,2012,40299
13096,681,316,365,2012,40310
13097,7406,3654,3752,2012,40311
13098,6801,3342,3459,2012,40312
13099,3867,1955,1912,2012,40313
13100,394,180,214,2012,40316
13101,3258,1549,1709,2012,40322
13102,41752,20272,21480,2012,40324
13103,951,455,496,2012,40328
13104,19135,9149,9986,2012,40330
13105,111,59,52,2012,40334
13106,13081,6472,6609,2012,40336
13107,5736,2884,2852,2012,40337
13108,0,0,0,2012,40339
13109,21222,10291,10931,2012,40342
13110,769,426,343,2012,40346
13111,2937,1399,1538,2012,40347
13112,680,307,373,2012,40348
13113,128,75,53,2012,40350
13114,19549,9491,10058,2012,40351
13115,20189,9534,10655,2012,40353
13116,40082,19746,20336,2012,40356
13117,1228,568,660,2012,40358
13118,7410,3636,3774,2012,40359
13119,6908,3440,3468,2012,40360
13120,18103,8880,9223,2012,40361
13121,0,0,0,2012,40363
13122,2900,1561,1339,2012,40370
13123,2378,1260,1118,2012,40371
13124,2143,973,1170,2012,40372
13125,1820,907,913,2012,40374
13126,35,11,24,2012,40376
13127,3092,1543,1549,2012,40379
13128,5802,2987,2815,2012,40380
13129,21906,10873,11033,2012,40383
13130,2906,1364,1542,2012,40385
13131,1933,962,971,2012,40387
13132,8001,3854,4147,2012,40390
13133,35204,17259,17945,2012,40391
13134,2102,986,1116,2012,40402
13135,24549,11826,12723,2012,40403
13136,690,296,394,2012,40404
13137,3475,1703,1772,2012,40409
13138,4109,2035,2074,2012,40419
13139,24410,12034,12376,2012,40422
13140,32,19,13,2012,40434
13141,5400,2515,2885,2012,40437
13142,2422,1125,1297,2012,40440
13143,993,428,565,2012,40442
13144,13803,6777,7026,2012,40444
13145,897,361,536,2012,40445
13146,8250,4295,3955,2012,40447
13147,0,0,0,2012,40448
13148,9804,5008,4796,2012,40456
13149,1166,517,649,2012,40460
13150,3454,1871,1583,2012,40461
13151,865,455,410,2012,40464
13152,1889,891,998,2012,40468
13153,1596,759,837,2012,40472
13154,55310,26831,28479,2012,40475
13155,281,146,135,2012,40481
13156,11434,5351,6083,2012,40484
13157,2901,1298,1603,2012,40486
13158,4299,2319,1980,2012,40489
13159,26508,12893,13615,2012,40502
13160,28245,13935,14310,2012,40503
13161,24988,12877,12111,2012,40504
13162,25849,12614,13235,2012,40505
13163,2195,886,1309,2012,40506
13164,1455,810,645,2012,40507
13165,24718,12285,12433,2012,40508
13166,33265,16187,17078,2012,40509
13167,2103,1533,570,2012,40510
13168,30374,15696,14678,2012,40511
13169,11333,5655,5678,2012,40513
13170,15088,7341,7747,2012,40514
13171,34420,16391,18029,2012,40515
13172,2504,1265,1239,2012,40516
13173,34659,15855,18804,2012,40517
13174,49948,24092,25856,2012,40601
13175,488,473,15,2012,40604
13176,28222,13379,14843,2012,40701
13177,6101,3095,3006,2012,40729
13178,3066,1535,1531,2012,40734
13179,1104,504,600,2012,40737
13180,3368,1768,1600,2012,40740
13181,22700,10765,11935,2012,40741
13182,341,202,139,2012,40743
13183,17338,8507,8831,2012,40744
13184,3258,1575,1683,2012,40759
13185,747,353,394,2012,40763
13186,17667,8670,8997,2012,40769
13187,1322,687,635,2012,40771
13188,363,208,155,2012,40801
13189,3253,1636,1617,2012,40806
13190,440,193,247,2012,40807
13191,180,71,109,2012,40808
13192,1373,650,723,2012,40810
13193,475,189,286,2012,40813
13194,1520,734,786,2012,40815
13195,36,0,36,2012,40816
13196,48,35,13,2012,40818
13197,969,447,522,2012,40819
13198,351,227,124,2012,40820
13199,4588,2257,2331,2012,40823
13200,697,370,327,2012,40824
13201,1054,489,565,2012,40826
13202,814,372,442,2012,40827
13203,3390,1831,1559,2012,40828
13204,232,128,104,2012,40829
13205,430,207,223,2012,40830
13206,5104,2143,2961,2012,40831
13207,129,60,69,2012,40840
13208,348,128,220,2012,40843
13209,46,37,9,2012,40844
13210,351,217,134,2012,40845
13211,160,91,69,2012,40847
13212,410,218,192,2012,40849
13213,1193,590,603,2012,40854
13214,975,454,521,2012,40855
13215,782,372,410,2012,40856
13216,509,261,248,2012,40858
13217,769,353,416,2012,40862
13218,484,265,219,2012,40863
13219,335,138,197,2012,40865
13220,1108,522,586,2012,40868
13221,394,202,192,2012,40870
13222,1885,934,951,2012,40873
13223,533,249,284,2012,40874
13224,1024,438,586,2012,40902
13225,791,415,376,2012,40903
13226,11636,5805,5831,2012,40906
13227,158,78,80,2012,40913
13228,565,272,293,2012,40914
13229,1441,740,701,2012,40915
13230,265,155,110,2012,40921
13231,966,434,532,2012,40923
13232,178,85,93,2012,40927
13233,2920,1427,1493,2012,40935
13234,256,155,101,2012,40939
13235,572,273,299,2012,40940
13236,113,48,65,2012,40941
13237,822,447,375,2012,40943
13238,92,25,67,2012,40946
13239,717,315,402,2012,40949
13240,944,469,475,2012,40953
13241,407,212,195,2012,40958
13242,18879,10296,8583,2012,40962
13243,349,174,175,2012,40964
13244,13790,6533,7257,2012,40965
13245,1110,515,595,2012,40972
13246,10901,5435,5466,2012,40977
13247,271,146,125,2012,40979
13248,362,208,154,2012,40982
13249,751,452,299,2012,40983
13250,469,207,262,2012,40988
13251,13,13,0,2012,40995
13252,417,181,236,2012,40997
13253,16380,8355,8025,2012,41001
13254,2604,1235,1369,2012,41002
13255,2177,1074,1103,2012,41003
13256,4448,2211,2237,2012,41004
13257,24599,11969,12630,2012,41005
13258,4859,2420,2439,2012,41006
13259,3623,1824,1799,2012,41007
13260,7602,3757,3845,2012,41008
13261,3464,1716,1748,2012,41010
13262,24974,13000,11974,2012,41011
13263,7916,3710,4206,2012,41014
13264,20928,10377,10551,2012,41015
13265,5778,3005,2773,2012,41016
13266,39399,18904,20495,2012,41017
13267,27168,13232,13936,2012,41018
13268,6013,2947,3066,2012,41030
13269,15896,7641,8255,2012,41031
13270,1577,806,771,2012,41033
13271,973,457,516,2012,41034
13272,10923,5555,5368,2012,41035
13273,2730,1204,1526,2012,41039
13274,7778,3781,3997,2012,41040
13275,7868,3880,3988,2012,41041
13276,49097,24396,24701,2012,41042
13277,1368,753,615,2012,41043
13278,1093,549,544,2012,41044
13279,1285,730,555,2012,41045
13280,1701,933,768,2012,41046
13281,14704,7335,7369,2012,41048
13282,1882,922,960,2012,41049
13283,27546,13445,14101,2012,41051
13284,28,10,18,2012,41052
13285,2015,952,1063,2012,41055
13286,14112,6960,7152,2012,41056
13287,3192,1603,1589,2012,41059
13288,22,9,13,2012,41062
13289,3036,1444,1592,2012,41063
13290,1811,939,872,2012,41064
13291,20951,10107,10844,2012,41071
13292,5838,2903,2935,2012,41073
13293,5485,2707,2778,2012,41074
13294,16439,8018,8421,2012,41075
13295,16352,7836,8516,2012,41076
13296,1479,755,724,2012,41080
13297,891,473,418,2012,41083
13298,665,319,346,2012,41085
13299,2881,1625,1256,2012,41086
13300,16355,8199,8156,2012,41091
13301,3950,1863,2087,2012,41092
13302,2701,1356,1345,2012,41093
13303,12784,6341,6443,2012,41094
13304,3026,1410,1616,2012,41095
13305,7333,3658,3675,2012,41097
13306,1834,980,854,2012,41098
13307,1025,479,546,2012,41099
13308,19334,9125,10209,2012,41101
13309,21106,10735,10371,2012,41102
13310,1672,969,703,2012,41121
13311,1326,614,712,2012,41124
13312,10216,5141,5075,2012,41129
13313,530,277,253,2012,41132
13314,260,87,173,2012,41135
13315,8211,3741,4470,2012,41139
13316,2117,1031,1086,2012,41141
13317,54,14,40,2012,41142
13318,14403,6896,7507,2012,41143
13319,10663,5335,5328,2012,41144
13320,308,139,169,2012,41146
13321,560,260,300,2012,41149
13322,437,241,196,2012,41159
13323,13268,6992,6276,2012,41164
13324,808,518,290,2012,41166
13325,3129,1464,1665,2012,41168
13326,5854,2917,2937,2012,41169
13327,4879,2844,2035,2012,41171
13328,1256,546,710,2012,41174
13329,5665,2671,2994,2012,41175
13330,7425,3656,3769,2012,41179
13331,1111,665,446,2012,41180
13332,1499,718,781,2012,41183
13333,2068,1125,943,2012,41189
13334,267,134,133,2012,41201
13335,616,288,328,2012,41203
13336,854,472,382,2012,41204
13337,599,258,341,2012,41214
13338,982,478,504,2012,41216
13339,1965,1096,869,2012,41219
13340,3217,1635,1582,2012,41222
13341,6712,3704,3008,2012,41224
13342,84,34,50,2012,41226
13343,11345,5515,5830,2012,41230
13344,863,450,413,2012,41231
13345,599,268,331,2012,41232
13346,463,213,250,2012,41234
13347,997,479,518,2012,41238
13348,7199,3339,3860,2012,41240
13349,1104,558,546,2012,41250
13350,601,349,252,2012,41254
13351,1163,588,575,2012,41255
13352,2035,936,1099,2012,41256
13353,255,159,96,2012,41257
13354,748,396,352,2012,41260
13355,1604,732,872,2012,41262
13356,328,164,164,2012,41263
13357,233,142,91,2012,41264
13358,2051,1043,1008,2012,41265
13359,1223,655,568,2012,41267
13360,303,156,147,2012,41268
13361,197,59,138,2012,41271
13362,448,215,233,2012,41274
13363,5855,2871,2984,2012,41301
13364,7786,4321,3465,2012,41311
13365,5311,2684,2627,2012,41314
13366,214,122,92,2012,41317
13367,1395,786,609,2012,41332
13368,10328,5072,5256,2012,41339
13369,1654,917,737,2012,41348
13370,635,424,211,2012,41352
13371,540,263,277,2012,41360
13372,397,201,196,2012,41365
13373,0,0,0,2012,41366
13374,257,152,105,2012,41367
13375,290,159,131,2012,41385
13376,56,22,34,2012,41390
13377,13,0,13,2012,41397
13378,489,141,348,2012,41408
13379,50,20,30,2012,41421
13380,1074,518,556,2012,41425
13381,671,291,380,2012,41464
13382,11998,6023,5975,2012,41465
13383,11480,6690,4790,2012,41472
13384,24575,12294,12281,2012,41501
13385,657,269,388,2012,41503
13386,1007,508,499,2012,41512
13387,467,231,236,2012,41513
13388,3268,1534,1734,2012,41514
13389,76,23,53,2012,41517
13390,1249,563,686,2012,41519
13391,4966,2327,2639,2012,41522
13392,373,210,163,2012,41524
13393,179,98,81,2012,41526
13394,839,455,384,2012,41527
13395,662,310,352,2012,41528
13396,847,429,418,2012,41531
13397,164,87,77,2012,41534
13398,322,178,144,2012,41535
13399,5653,2636,3017,2012,41537
13400,45,27,18,2012,41538
13401,1833,932,901,2012,41539
13402,358,161,197,2012,41540
13403,384,170,214,2012,41543
13404,957,415,542,2012,41544
13405,277,125,152,2012,41547
13406,590,315,275,2012,41548
13407,2835,1390,1445,2012,41553
13408,1294,623,671,2012,41554
13409,1025,504,521,2012,41555
13410,2040,958,1082,2012,41557
13411,854,445,409,2012,41558
13412,458,255,203,2012,41559
13413,226,127,99,2012,41560
13414,2760,1336,1424,2012,41562
13415,583,235,348,2012,41563
13416,1263,645,618,2012,41564
13417,461,250,211,2012,41566
13418,155,65,90,2012,41567
13419,832,413,419,2012,41568
13420,595,322,273,2012,41571
13421,3051,1496,1555,2012,41572
13422,619,309,310,2012,41601
13423,550,262,288,2012,41602
13424,1551,844,707,2012,41603
13425,460,250,210,2012,41604
13426,358,170,188,2012,41605
13427,515,175,340,2012,41606
13428,287,146,141,2012,41607
13429,32,13,19,2012,41612
13430,510,282,228,2012,41615
13431,811,467,344,2012,41616
13432,533,301,232,2012,41619
13433,443,217,226,2012,41621
13434,265,134,131,2012,41622
13435,1143,603,540,2012,41630
13436,1009,514,495,2012,41631
13437,560,281,279,2012,41632
13438,3010,1476,1534,2012,41635
13439,894,409,485,2012,41636
13440,966,432,534,2012,41640
13441,631,283,348,2012,41642
13442,180,76,104,2012,41643
13443,1109,549,560,2012,41645
13444,1781,864,917,2012,41647
13445,3429,1666,1763,2012,41649
13446,467,191,276,2012,41650
13447,12534,5924,6610,2012,41653
13448,623,325,298,2012,41655
13449,454,230,224,2012,41659
13450,828,445,383,2012,41660
13451,566,240,326,2012,41663
13452,977,446,531,2012,41666
13453,675,353,322,2012,41667
13454,1172,740,432,2012,41669
13455,17153,8461,8692,2012,41701
13456,333,172,161,2012,41712
13457,34,34,0,2012,41713
13458,231,137,94,2012,41714
13459,721,392,329,2012,41719
13460,676,341,335,2012,41721
13461,1426,788,638,2012,41722
13462,1792,818,974,2012,41723
13463,95,77,18,2012,41725
13464,733,215,518,2012,41727
13465,307,136,171,2012,41729
13466,1057,436,621,2012,41731
13467,177,90,87,2012,41735
13468,115,68,47,2012,41739
13469,787,374,413,2012,41740
13470,84,41,43,2012,41745
13471,850,505,345,2012,41746
13472,3189,1492,1697,2012,41749
13473,248,120,128,2012,41751
13474,569,268,301,2012,41754
13475,380,229,151,2012,41759
13476,24,9,15,2012,41760
13477,148,66,82,2012,41762
13478,533,292,241,2012,41763
13479,665,408,257,2012,41764
13480,262,145,117,2012,41766
13481,331,228,103,2012,41772
13482,1639,718,921,2012,41773
13483,2577,1408,1169,2012,41774
13484,80,51,29,2012,41775
13485,1699,833,866,2012,41776
13486,972,506,466,2012,41777
13487,1263,788,475,2012,41804
13488,537,356,181,2012,41810
13489,267,108,159,2012,41812
13490,300,145,155,2012,41815
13491,365,150,215,2012,41817
13492,298,145,153,2012,41819
13493,619,359,260,2012,41821
13494,2257,1033,1224,2012,41822
13495,1223,523,700,2012,41824
13496,604,314,290,2012,41825
13497,1053,492,561,2012,41826
13498,1179,621,558,2012,41828
13499,1118,543,575,2012,41831
13500,595,275,320,2012,41832
13501,202,129,73,2012,41833
13502,786,410,376,2012,41834
13503,869,436,433,2012,41835
13504,855,362,493,2012,41836
13505,548,317,231,2012,41837
13506,530,236,294,2012,41838
13507,974,467,507,2012,41839
13508,1359,762,597,2012,41840
13509,861,419,442,2012,41843
13510,1770,897,873,2012,41844
13511,130,46,84,2012,41845
13512,394,151,243,2012,41847
13513,29,29,0,2012,41848
13514,175,130,45,2012,41849
13515,683,337,346,2012,41855
13516,7627,3469,4158,2012,41858
13517,397,199,198,2012,41859
13518,285,136,149,2012,41861
13519,828,387,441,2012,41862
13520,28218,13200,15018,2012,42001
13521,29221,14121,15100,2012,42003
13522,2057,985,1072,2012,42020
13523,1334,594,740,2012,42021
13524,52,26,26,2012,42022
13525,2611,1284,1327,2012,42023
13526,1574,759,815,2012,42024
13527,19990,9745,10245,2012,42025
13528,2064,1076,988,2012,42027
13529,627,286,341,2012,42028
13530,6094,3095,2999,2012,42029
13531,3538,1660,1878,2012,42031
13532,275,157,118,2012,42032
13533,964,450,514,2012,42035
13534,1229,660,569,2012,42036
13535,0,0,0,2012,42037
13536,4899,2953,1946,2012,42038
13537,1690,845,845,2012,42039
13538,1124,523,601,2012,42040
13539,4757,2393,2364,2012,42041
13540,2922,1388,1534,2012,42044
13541,1975,915,1060,2012,42045
13542,104,48,56,2012,42047
13543,2465,1300,1165,2012,42048
13544,1845,789,1056,2012,42049
13545,2938,1501,1437,2012,42050
13546,2640,1260,1380,2012,42051
13547,4808,2448,2360,2012,42053
13548,1188,670,518,2012,42054
13549,2973,1404,1569,2012,42055
13550,2356,1173,1183,2012,42056
13551,2338,1143,1195,2012,42058
13552,214,110,104,2012,42060
13553,54,29,25,2012,42061
13554,8415,4162,4253,2012,42064
13555,23792,11586,12206,2012,42066
13556,1117,561,556,2012,42069
13557,29397,13761,15636,2012,42071
13558,899,471,428,2012,42076
13559,2036,1133,903,2012,42078
13560,1533,785,748,2012,42079
13561,2327,1177,1150,2012,42081
13562,1489,662,827,2012,42082
13563,360,165,195,2012,42083
13564,80,41,39,2012,42084
13565,835,426,409,2012,42085
13566,3950,1997,1953,2012,42086
13567,2455,1182,1273,2012,42087
13568,2636,1277,1359,2012,42088
13569,53975,26236,27739,2012,42101
13570,33,24,9,2012,42102
13571,20109,9735,10374,2012,42103
13572,30763,14932,15831,2012,42104
13573,2786,1329,1457,2012,42120
13574,4114,2231,1883,2012,42122
13575,1095,553,542,2012,42123
13576,109,70,39,2012,42124
13577,6019,2784,3235,2012,42127
13578,6655,3327,3328,2012,42129
13579,125,72,53,2012,42130
13580,1486,786,700,2012,42133
13581,16422,7960,8462,2012,42134
13582,1361,699,662,2012,42140
13583,30653,14800,15853,2012,42141
13584,197,130,67,2012,42151
13585,160,77,83,2012,42153
13586,814,398,416,2012,42154
13587,152,68,84,2012,42156
13588,332,113,219,2012,42157
13589,1354,758,596,2012,42159
13590,1804,946,858,2012,42160
13591,120,32,88,2012,42163
13592,16530,8065,8465,2012,42164
13593,2600,1376,1224,2012,42166
13594,8065,4001,4064,2012,42167
13595,1203,639,564,2012,42170
13596,6811,3469,3342,2012,42171
13597,2520,1215,1305,2012,42202
13598,635,315,320,2012,42204
13599,5665,2786,2879,2012,42206
13600,1399,760,639,2012,42207
13601,3946,1947,1999,2012,42210
13602,13314,6612,6702,2012,42211
13603,796,411,385,2012,42214
13604,1294,663,631,2012,42215
13605,4117,2150,1967,2012,42217
13606,7093,3471,3622,2012,42220
13607,19864,11447,8417,2012,42223
13608,618,287,331,2012,42232
13609,2835,1354,1481,2012,42234
13610,589,302,287,2012,42236
13611,42928,20970,21958,2012,42240
13612,252,130,122,2012,42254
13613,4681,2394,2287,2012,42256
13614,1098,615,483,2012,42259
13615,10717,5312,5405,2012,42261
13616,8243,4048,4195,2012,42262
13617,1431,808,623,2012,42265
13618,2425,1205,1220,2012,42266
13619,413,212,201,2012,42273
13620,2448,1225,1223,2012,42274
13621,826,458,368,2012,42275
13622,13581,6582,6999,2012,42276
13623,497,216,281,2012,42280
13624,533,165,368,2012,42285
13625,928,520,408,2012,42286
13626,42749,21099,21650,2012,42301
13627,38337,18031,20306,2012,42303
13628,8341,4252,4089,2012,42320
13629,218,100,118,2012,42321
13630,0,0,0,2012,42322
13631,904,439,465,2012,42323
13632,1316,676,640,2012,42324
13633,2599,1317,1282,2012,42325
13634,506,229,277,2012,42326
13635,4182,2064,2118,2012,42327
13636,1424,746,678,2012,42328
13637,9300,5084,4216,2012,42330
13638,194,94,100,2012,42332
13639,1077,581,496,2012,42333
13640,1840,790,1050,2012,42337
13641,87,41,46,2012,42338
13642,868,422,446,2012,42339
13643,1817,826,991,2012,42343
13644,1014,446,568,2012,42344
13645,11505,5627,5878,2012,42345
13646,5869,2783,3086,2012,42347
13647,5110,2641,2469,2012,42348
13648,1255,643,612,2012,42349
13649,1395,629,766,2012,42350
13650,3896,1900,1996,2012,42351
13651,1878,873,1005,2012,42352
13652,315,156,159,2012,42354
13653,1763,838,925,2012,42355
13654,121,0,121,2012,42356
13655,652,335,317,2012,42361
13656,5841,3046,2795,2012,42366
13657,619,330,289,2012,42367
13658,1513,793,720,2012,42368
13659,326,157,169,2012,42369
13660,33,8,25,2012,42370
13661,502,291,211,2012,42371
13662,1803,928,875,2012,42372
13663,158,51,107,2012,42374
13664,6049,2950,3099,2012,42376
13665,3216,1599,1617,2012,42378
13666,3102,1468,1634,2012,42404
13667,3747,1828,1919,2012,42406
13668,6294,3090,3204,2012,42408
13669,2534,1300,1234,2012,42409
13670,1610,782,828,2012,42410
13671,1706,894,812,2012,42411
13672,3324,1784,1540,2012,42413
13673,37632,18011,19621,2012,42420
13674,26647,12907,13740,2012,42431
13675,1117,587,530,2012,42436
13676,8394,4535,3859,2012,42437
13677,748,397,351,2012,42440
13678,1597,709,888,2012,42441
13679,3397,1581,1816,2012,42442
13680,11146,5370,5776,2012,42445
13681,3694,1878,1816,2012,42450
13682,1352,704,648,2012,42451
13683,2287,1049,1238,2012,42452
13684,632,273,359,2012,42453
13685,3291,1656,1635,2012,42455
13686,1755,863,892,2012,42456
13687,906,469,437,2012,42458
13688,4536,2079,2457,2012,42459
13689,1390,632,758,2012,42461
13690,1200,530,670,2012,42462
13691,129,65,64,2012,42463
13692,1934,995,939,2012,42464
13693,18408,8615,9793,2012,42501
13694,23524,11809,11715,2012,42503
13695,702,426,276,2012,42516
13696,2844,1298,1546,2012,42518
13697,2701,1533,1168,2012,42519
13698,1878,1007,871,2012,42528
13699,978,455,523,2012,42533
13700,9633,4721,4912,2012,42539
13701,726,354,372,2012,42541
13702,5826,2922,2904,2012,42544
13703,4474,2121,2353,2012,42553
13704,798,436,362,2012,42565
13705,444,194,250,2012,42566
13706,5876,2985,2891,2012,42567
13707,10354,5115,5239,2012,42602
13708,143,73,70,2012,42603
13709,5646,2659,2987,2012,42629
13710,0,0,0,2012,42631
13711,19822,9834,9988,2012,42633
13712,1599,867,732,2012,42634
13713,4777,3264,1513,2012,42635
13714,149,53,96,2012,42638
13715,11757,5900,5857,2012,42642
13716,4363,2150,2213,2012,42647
13717,2279,1233,1046,2012,42649
13718,4902,2279,2623,2012,42653
13719,47658,22956,24702,2012,42701
13720,1738,929,809,2012,42712
13721,1411,664,747,2012,42713
13722,268,144,124,2012,42715
13723,1792,916,876,2012,42716
13724,6726,3322,3404,2012,42717
13725,23805,11484,12321,2012,42718
13726,4187,1992,2195,2012,42721
13727,660,278,382,2012,42722
13728,4612,2329,2283,2012,42724
13729,4742,2440,2302,2012,42726
13730,15777,7921,7856,2012,42728
13731,1524,865,659,2012,42729
13732,172,110,62,2012,42731
13733,1817,892,925,2012,42732
13734,1674,930,744,2012,42733
13735,1975,985,990,2012,42740
13736,511,168,343,2012,42741
13737,8734,4272,4462,2012,42743
13738,2542,1309,1233,2012,42746
13739,8326,4278,4048,2012,42748
13740,4977,2312,2665,2012,42749
13741,750,289,461,2012,42753
13742,15390,7654,7736,2012,42754
13743,3168,1544,1624,2012,42757
13744,119,48,71,2012,42758
13745,415,245,170,2012,42762
13746,598,219,379,2012,42764
13747,5736,2842,2894,2012,42765
13748,2387,1166,1221,2012,42776
13749,974,462,512,2012,42782
13750,2654,1337,1317,2012,42784
13751,314,179,135,2012,42788
13752,2227,1247,980,2012,43001
13753,1904,782,1122,2012,43002
13754,2681,1304,1377,2012,43003
13755,24288,11550,12738,2012,43004
13756,141,57,84,2012,43005
13757,678,403,275,2012,43006
13758,2286,1118,1168,2012,43008
13759,2351,1279,1072,2012,43009
13760,343,158,185,2012,43010
13761,7008,3602,3406,2012,43011
13762,976,479,497,2012,43013
13763,3848,2004,1844,2012,43014
13764,48166,23453,24713,2012,43015
13765,33056,16277,16779,2012,43016
13766,38081,18809,19272,2012,43017
13767,8908,4257,4651,2012,43019
13768,10268,5114,5154,2012,43021
13769,4174,2063,2111,2012,43022
13770,12644,6066,6578,2012,43023
13771,5839,2768,3071,2012,43025
13772,56946,27182,29764,2012,43026
13773,7771,3824,3947,2012,43028
13774,605,337,268,2012,43029
13775,147,105,42,2012,43030
13776,12114,6012,6102,2012,43031
13777,137,88,49,2012,43032
13778,359,189,170,2012,43033
13779,24722,12718,12004,2012,43035
13780,311,171,140,2012,43036
13781,422,220,202,2012,43037
13782,31465,14217,17248,2012,43040
13783,5236,2801,2435,2012,43044
13784,1881,973,908,2012,43045
13785,3442,1698,1744,2012,43046
13786,28706,13744,14962,2012,43050
13787,20738,10329,10409,2012,43054
13788,59996,28699,31297,2012,43055
13789,16898,8267,8631,2012,43056
13790,2191,1097,1094,2012,43060
13791,3992,2183,1809,2012,43061
13792,26917,13802,13115,2012,43062
13793,13130,6251,6879,2012,43064
13794,39033,19263,19770,2012,43065
13795,1390,815,575,2012,43066
13796,1118,624,494,2012,43067
13797,52177,24692,27485,2012,43068
13798,58,30,28,2012,43070
13799,2316,1111,1205,2012,43071
13800,5895,3105,2790,2012,43072
13801,12336,6142,6194,2012,43074
13802,8945,4622,4323,2012,43076
13803,308,165,143,2012,43077
13804,20931,9975,10956,2012,43078
13805,6105,3021,3084,2012,43080
13806,56157,26358,29799,2012,43081
13807,29995,14364,15631,2012,43082
13808,838,390,448,2012,43084
13809,22822,10935,11887,2012,43085
13810,345,200,145,2012,43101
13811,4470,2310,2160,2012,43102
13812,11217,5503,5714,2012,43103
13813,8434,4301,4133,2012,43105
13814,1588,855,733,2012,43106
13815,3135,1415,1720,2012,43107
13816,152,37,115,2012,43109
13817,33742,16513,17229,2012,43110
13818,155,89,66,2012,43111
13819,4341,2249,2092,2012,43112
13820,23498,11159,12339,2012,43113
13821,1614,790,824,2012,43115
13822,1267,601,666,2012,43116
13823,0,0,0,2012,43117
13824,28055,13569,14486,2012,43119
13825,57901,28167,29734,2012,43123
13826,12192,5647,6545,2012,43125
13827,427,203,224,2012,43126
13828,69,33,36,2012,43127
13829,2347,1195,1152,2012,43128
13830,59904,30139,29765,2012,43130
13831,4900,2387,2513,2012,43135
13832,516,218,298,2012,43136
13833,1891,1014,877,2012,43137
13834,18741,8992,9749,2012,43138
13835,24185,14713,9472,2012,43140
13836,119,78,41,2012,43142
13837,5526,2670,2856,2012,43143
13838,419,206,213,2012,43144
13839,1634,843,791,2012,43145
13840,13079,8428,4651,2012,43146
13841,38861,19246,19615,2012,43147
13842,2247,1034,1213,2012,43148
13843,2720,1455,1265,2012,43149
13844,2555,1186,1369,2012,43150
13845,281,148,133,2012,43151
13846,927,424,503,2012,43152
13847,1043,553,490,2012,43153
13848,3407,1499,1908,2012,43154
13849,2219,1118,1101,2012,43155
13850,252,113,139,2012,43156
13851,618,282,336,2012,43157
13852,338,170,168,2012,43158
13853,22268,10899,11369,2012,43160
13854,6855,3268,3587,2012,43162
13855,2702,1515,1187,2012,43164
13856,30186,16633,13553,2012,43201
13857,19712,11308,8404,2012,43202
13858,8170,4063,4107,2012,43203
13859,41210,20539,20671,2012,43204
13860,11535,6323,5212,2012,43205
13861,22110,10791,11319,2012,43206
13862,45831,22274,23557,2012,43207
13863,27479,13301,14178,2012,43209
13864,10341,5458,4883,2012,43210
13865,21558,10167,11391,2012,43211
13866,18535,9168,9367,2012,43212
13867,30018,14504,15514,2012,43213
13868,25801,12695,13106,2012,43214
13869,12123,6559,5564,2012,43215
13870,2524,1219,1305,2012,43217
13871,27064,12653,14411,2012,43219
13872,24513,11926,12587,2012,43220
13873,32785,15530,17255,2012,43221
13874,4285,1990,2295,2012,43222
13875,26567,13022,13545,2012,43223
13876,36303,17418,18885,2012,43224
13877,21969,10373,11596,2012,43227
13878,52632,25564,27068,2012,43228
13879,46387,22498,23889,2012,43229
13880,52442,25255,27187,2012,43230
13881,18784,8593,10191,2012,43231
13882,42655,20558,22097,2012,43232
13883,39588,18997,20591,2012,43235
13884,3178,1264,1914,2012,43240
13885,54664,29122,25542,2012,43302
13886,3298,1641,1657,2012,43310
13887,19369,9318,10051,2012,43311
13888,3150,1627,1523,2012,43314
13889,7277,3576,3701,2012,43315
13890,5854,3004,2850,2012,43316
13891,183,92,91,2012,43317
13892,4317,2179,2138,2012,43318
13893,929,460,469,2012,43319
13894,1329,696,633,2012,43320
13895,265,118,147,2012,43321
13896,367,193,174,2012,43322
13897,686,321,365,2012,43323
13898,2482,1141,1341,2012,43324
13899,13701,6490,7211,2012,43326
13900,84,36,48,2012,43330
13901,4525,2231,2294,2012,43331
13902,2049,1033,1016,2012,43332
13903,929,499,430,2012,43333
13904,6771,3449,3322,2012,43334
13905,42,14,28,2012,43336
13906,1385,681,704,2012,43337
13907,10694,5258,5436,2012,43338
13908,1965,1051,914,2012,43340
13909,925,450,475,2012,43341
13910,2969,1466,1503,2012,43342
13911,1489,821,668,2012,43343
13912,5719,2917,2802,2012,43344
13913,880,413,467,2012,43345
13914,1446,702,744,2012,43347
13915,2082,1095,987,2012,43348
13916,10374,4891,5483,2012,43351
13917,1358,713,645,2012,43356
13918,4764,2241,2523,2012,43357
13919,2997,1547,1450,2012,43358
13920,797,398,399,2012,43359
13921,1159,575,584,2012,43360
13922,31372,15421,15951,2012,43402
13923,5916,2682,3234,2012,43403
13924,1868,932,936,2012,43406
13925,784,319,465,2012,43407
13926,302,141,161,2012,43408
13927,10179,4940,5239,2012,43410
13928,4302,2213,2089,2012,43412
13929,1334,702,632,2012,43413
13930,2819,1252,1567,2012,43416
13931,30927,15097,15830,2012,43420
13932,5054,2620,2434,2012,43430
13933,4928,2618,2310,2012,43431
13934,1043,477,566,2012,43432
13935,96,62,34,2012,43433
13936,218,82,136,2012,43434
13937,1378,742,636,2012,43435
13938,478,209,269,2012,43437
13939,203,110,93,2012,43438
13940,106,48,58,2012,43439
13941,4942,2462,2480,2012,43440
13942,863,453,410,2012,43442
13943,1679,896,783,2012,43443
13944,1127,577,550,2012,43445
13945,156,82,74,2012,43446
13946,3634,1567,2067,2012,43447
13947,8800,4561,4239,2012,43449
13948,3950,1994,1956,2012,43450
13949,1049,512,537,2012,43451
13950,13498,6449,7049,2012,43452
13951,511,270,241,2012,43456
13952,1242,640,602,2012,43457
13953,441,250,191,2012,43458
13954,6327,3188,3139,2012,43460
13955,969,532,437,2012,43462
13956,0,0,0,2012,43463
13957,1436,761,675,2012,43464
13958,5162,2671,2491,2012,43465
13959,2334,1257,1077,2012,43466
13960,64,18,46,2012,43467
13961,419,217,202,2012,43468
13962,2784,1366,1418,2012,43469
13963,659,352,307,2012,43501
13964,6834,3057,3777,2012,43502
13965,1251,694,557,2012,43504
13966,68,37,31,2012,43505
13967,14562,7162,7400,2012,43506
13968,774,391,383,2012,43511
13969,28837,14207,14630,2012,43512
13970,8280,4051,4229,2012,43515
13971,2870,1433,1437,2012,43516
13972,3594,1775,1819,2012,43517
13973,2836,1373,1463,2012,43518
13974,48,27,21,2012,43519
13975,2783,1425,1358,2012,43521
13976,3082,1536,1546,2012,43522
13977,0,0,0,2012,43523
13978,1260,583,677,2012,43524
13979,1145,524,621,2012,43525
13980,5736,2737,2999,2012,43526
13981,2343,1230,1113,2012,43527
13982,15418,7658,7760,2012,43528
13983,211,95,116,2012,43529
13984,136,82,54,2012,43531
13985,4124,2026,2098,2012,43532
13986,1299,654,645,2012,43533
13987,1718,849,869,2012,43534
13988,883,457,426,2012,43535
13989,370,194,176,2012,43536
13990,26599,13167,13432,2012,43537
13991,1603,738,865,2012,43540
13992,120,54,66,2012,43541
13993,4194,1938,2256,2012,43542
13994,8029,3985,4044,2012,43543
13995,14231,7033,7198,2012,43545
13996,416,208,208,2012,43547
13997,570,293,277,2012,43548
13998,1734,966,768,2012,43549
13999,36721,17422,19299,2012,43551
14000,210,90,120,2012,43553
14001,2599,1215,1384,2012,43554
14002,140,91,49,2012,43555
14003,1969,947,1022,2012,43556
14004,3295,1919,1376,2012,43557
14005,13374,6844,6530,2012,43558
14006,32589,15750,16839,2012,43560
14007,364,182,182,2012,43565
14008,7742,3814,3928,2012,43566
14009,13275,6584,6691,2012,43567
14010,2925,1508,1417,2012,43569
14011,3352,1606,1746,2012,43570
14012,6979,3210,3769,2012,43571
14013,8638,3985,4653,2012,43604
14014,28801,14221,14580,2012,43605
14015,24642,11594,13048,2012,43606
14016,24363,12011,12352,2012,43607
14017,16037,8014,8023,2012,43608
14018,23426,12171,11255,2012,43609
14019,4510,2157,2353,2012,43610
14020,19653,9787,9866,2012,43611
14021,31067,15214,15853,2012,43612
14022,32263,15486,16777,2012,43613
14023,30042,14059,15983,2012,43614
14024,39719,18127,21592,2012,43615
14025,20947,10025,10922,2012,43616
14026,7221,3561,3660,2012,43617
14027,7661,3732,3929,2012,43619
14028,6072,3023,3049,2012,43620
14029,20263,9605,10658,2012,43623
14030,55815,26785,29030,2012,43701
14031,0,0,0,2012,43711
14032,7560,3781,3779,2012,43713
14033,1662,826,836,2012,43716
14034,234,133,101,2012,43717
14035,3649,2083,1566,2012,43718
14036,2598,1279,1319,2012,43719
14037,895,498,397,2012,43720
14038,43,17,26,2012,43721
14039,376,171,205,2012,43722
14040,4787,2356,2431,2012,43723
14041,9418,5762,3656,2012,43724
14042,20362,9926,10436,2012,43725
14043,1596,751,845,2012,43727
14044,1008,493,515,2012,43728
14045,2413,1176,1237,2012,43730
14046,6031,3012,3019,2012,43731
14047,1997,990,1007,2012,43732
14048,307,264,43,2012,43733
14049,1180,513,667,2012,43734
14050,345,182,163,2012,43735
14051,72,26,46,2012,43736
14052,112,52,60,2012,43738
14053,2159,1013,1146,2012,43739
14054,388,210,178,2012,43740
14055,1561,716,845,2012,43746
14056,788,399,389,2012,43747
14057,2957,1562,1395,2012,43748
14058,2173,1048,1125,2012,43749
14059,172,77,95,2012,43750
14060,1556,811,745,2012,43754
14061,1490,764,726,2012,43755
14062,5223,2491,2732,2012,43756
14063,3538,1885,1653,2012,43758
14064,40,11,29,2012,43759
14065,1451,682,769,2012,43760
14066,100,51,49,2012,43761
14067,5904,2747,3157,2012,43762
14068,8309,3941,4368,2012,43764
14069,1592,737,855,2012,43766
14070,1470,720,750,2012,43767
14071,261,129,132,2012,43768
14072,1940,912,1028,2012,43771
14073,1754,891,863,2012,43772
14074,3161,1629,1532,2012,43773
14075,4371,2072,2299,2012,43777
14076,1668,825,843,2012,43778
14077,878,477,401,2012,43779
14078,1707,884,823,2012,43780
14079,639,317,322,2012,43782
14080,5198,2630,2568,2012,43783
14081,35,20,15,2012,43786
14082,2689,1260,1429,2012,43787
14083,970,485,485,2012,43788
14084,5055,2524,2531,2012,43793
14085,1041,532,509,2012,43802
14086,4050,2065,1985,2012,43804
14087,59,35,24,2012,43805
14088,799,433,366,2012,43811
14089,19380,9341,10039,2012,43812
14090,4438,2113,2325,2012,43821
14091,5214,2642,2572,2012,43822
14092,3365,1672,1693,2012,43824
14093,6191,3120,3071,2012,43830
14094,7756,3946,3810,2012,43832
14095,136,71,65,2012,43836
14096,1737,809,928,2012,43837
14097,1220,670,550,2012,43840
14098,161,69,92,2012,43842
14099,1043,463,580,2012,43843
14100,3827,1937,1890,2012,43844
14101,4642,2252,2390,2012,43845
14102,2484,1300,1184,2012,43901
14103,207,96,111,2012,43902
14104,2127,1088,1039,2012,43903
14105,170,94,76,2012,43905
14106,8553,4006,4547,2012,43906
14107,5936,2808,3128,2012,43907
14108,1707,843,864,2012,43908
14109,3641,1782,1859,2012,43910
14110,7074,3371,3703,2012,43912
14111,1608,706,902,2012,43913
14112,14,7,7,2012,43914
14113,1585,743,842,2012,43915
14114,3071,1544,1527,2012,43917
14115,23416,11164,12252,2012,43920
14116,12,12,0,2012,43925
14117,237,116,121,2012,43926
14118,46,21,25,2012,43927
14119,104,79,25,2012,43928
14120,779,415,364,2012,43930
14121,318,101,217,2012,43931
14122,926,521,405,2012,43932
14123,1943,996,947,2012,43933
14124,170,87,83,2012,43934
14125,8625,4015,4610,2012,43935
14126,5557,2732,2825,2012,43938
14127,512,245,267,2012,43939
14128,492,250,242,2012,43940
14129,2486,1287,1199,2012,43942
14130,3339,1639,1700,2012,43943
14131,2723,1420,1303,2012,43944
14132,3120,1618,1502,2012,43945
14133,2411,1234,1177,2012,43946
14134,5257,2341,2916,2012,43947
14135,517,252,265,2012,43948
14136,17015,9634,7381,2012,43950
14137,179,53,126,2012,43951
14138,18556,8596,9960,2012,43952
14139,11981,5545,6436,2012,43953
14140,294,109,185,2012,43961
14141,127,67,60,2012,43962
14142,1348,604,744,2012,43963
14143,9536,4653,4883,2012,43964
14144,0,0,0,2012,43967
14145,7326,3582,3744,2012,43968
14146,0,0,0,2012,43970
14147,1220,572,648,2012,43971
14148,92,51,41,2012,43972
14149,2263,1080,1183,2012,43973
14150,73,45,28,2012,43974
14151,1453,735,718,2012,43976
14152,2406,1185,1221,2012,43977
14153,275,142,133,2012,43983
14154,183,86,97,2012,43985
14155,2296,1109,1187,2012,43986
14156,2532,1261,1271,2012,43988
14157,20411,9932,10479,2012,44001
14158,4949,2381,2568,2012,44003
14159,33727,16007,17720,2012,44004
14160,1996,1002,994,2012,44010
14161,20925,10099,10826,2012,44011
14162,22515,11053,11462,2012,44012
14163,19292,9642,9650,2012,44017
14164,5959,2858,3101,2012,44021
14165,16663,8128,8535,2012,44022
14166,17298,8212,9086,2012,44023
14167,23503,11766,11737,2012,44024
14168,11055,5516,5539,2012,44026
14169,8126,4229,3897,2012,44028
14170,16785,9258,7527,2012,44030
14171,1872,893,979,2012,44032
14172,64105,30996,33109,2012,44035
14173,29676,14617,15059,2012,44039
14174,3013,1573,1440,2012,44040
14175,14814,7453,7361,2012,44041
14176,15790,10069,5721,2012,44044
14177,408,197,211,2012,44045
14178,2077,1008,1069,2012,44046
14179,9319,4498,4821,2012,44047
14180,2590,1100,1490,2012,44048
14181,310,169,141,2012,44049
14182,6205,3191,3014,2012,44050
14183,30891,14664,16227,2012,44052
14184,17788,8158,9630,2012,44053
14185,12656,6282,6374,2012,44054
14186,19498,9096,10402,2012,44055
14187,11196,5554,5642,2012,44056
14188,19902,9927,9975,2012,44057
14189,60850,29440,31410,2012,44060
14190,15353,7491,7862,2012,44062
14191,1863,966,897,2012,44064
14192,4487,2054,2433,2012,44065
14193,20346,9435,10911,2012,44067
14194,32830,16082,16748,2012,44070
14195,4346,2233,2113,2012,44072
14196,11882,5762,6120,2012,44074
14197,4714,2274,2440,2012,44076
14198,56017,27282,28735,2012,44077
14199,272,117,155,2012,44080
14200,6797,3379,3418,2012,44081
14201,1365,749,616,2012,44082
14202,3923,2090,1833,2012,44084
14203,2832,1578,1254,2012,44085
14204,2320,1169,1151,2012,44086
14205,19864,9675,10189,2012,44087
14206,15979,7879,8100,2012,44089
14207,11405,5375,6030,2012,44090
14208,16750,7934,8816,2012,44092
14209,984,488,496,2012,44093
14210,35309,17236,18073,2012,44094
14211,33691,16625,17066,2012,44095
14212,2004,1070,934,2012,44099
14213,732,121,611,2012,44101
14214,44496,21743,22753,2012,44102
14215,18745,8780,9965,2012,44103
14216,23181,10323,12858,2012,44104
14217,38515,17649,20866,2012,44105
14218,26768,12352,14416,2012,44106
14219,52101,25232,26869,2012,44107
14220,26387,12201,14186,2012,44108
14221,41882,20475,21407,2012,44109
14222,21012,9678,11334,2012,44110
14223,40881,19846,21035,2012,44111
14224,23193,10713,12480,2012,44112
14225,18650,10237,8413,2012,44113
14226,4378,2276,2102,2012,44114
14227,7510,3352,4158,2012,44115
14228,20206,9487,10719,2012,44116
14229,10001,4283,5718,2012,44117
14230,39548,18386,21162,2012,44118
14231,12077,5498,6579,2012,44119
14232,37763,17045,20718,2012,44120
14233,33556,15534,18022,2012,44121
14234,33662,15295,18367,2012,44122
14235,17281,8357,8924,2012,44123
14236,38113,17542,20571,2012,44124
14237,28740,13325,15415,2012,44125
14238,16694,7832,8862,2012,44126
14239,4544,2253,2291,2012,44127
14240,30139,13486,16653,2012,44128
14241,29323,14132,15191,2012,44129
14242,50585,24322,26263,2012,44130
14243,20338,9899,10439,2012,44131
14244,14798,6750,8048,2012,44132
14245,30229,14825,15404,2012,44133
14246,37983,18383,19600,2012,44134
14247,28024,13609,14415,2012,44135
14248,25689,12508,13181,2012,44136
14249,23255,10844,12411,2012,44137
14250,21909,10584,11325,2012,44138
14251,24036,11750,12286,2012,44139
14252,15589,7471,8118,2012,44140
14253,13843,7030,6813,2012,44141
14254,19199,8934,10265,2012,44142
14255,24284,11314,12970,2012,44143
14256,21906,10668,11238,2012,44144
14257,32519,15533,16986,2012,44145
14258,29734,13782,15952,2012,44146
14259,19196,9202,9994,2012,44147
14260,18879,9229,9650,2012,44149
14261,6390,3143,3247,2012,44201
14262,19506,9511,9995,2012,44202
14263,41125,19921,21204,2012,44203
14264,43699,21221,22478,2012,44212
14265,2019,932,1087,2012,44214
14266,2367,1228,1139,2012,44215
14267,9674,4974,4700,2012,44216
14268,4041,1884,2157,2012,44217
14269,29858,14455,15403,2012,44221
14270,18428,8747,9681,2012,44223
14271,38312,18493,19819,2012,44224
14272,8193,4144,4049,2012,44230
14273,8616,4413,4203,2012,44231
14274,7662,3847,3815,2012,44233
14275,3986,1956,2030,2012,44234
14276,2132,1035,1097,2012,44235
14277,25373,12426,12947,2012,44236
14278,39412,18909,20503,2012,44240
14279,16029,7833,8196,2012,44241
14280,4139,1413,2726,2012,44243
14281,1265,628,637,2012,44250
14282,894,441,453,2012,44251
14283,3215,1747,1468,2012,44253
14284,4782,2467,2315,2012,44254
14285,8373,4051,4322,2012,44255
14286,62319,30651,31668,2012,44256
14287,12955,6443,6512,2012,44260
14288,4990,2393,2597,2012,44262
14289,2522,1173,1349,2012,44264
14290,0,0,0,2012,44265
14291,33715,16959,16756,2012,44266
14292,9134,4386,4748,2012,44270
14293,5048,2443,2605,2012,44272
14294,6471,3265,3206,2012,44273
14295,109,67,42,2012,44274
14296,3109,1600,1509,2012,44275
14297,1735,919,816,2012,44276
14298,17795,8588,9207,2012,44278
14299,4453,2076,2377,2012,44280
14300,29997,14410,15587,2012,44281
14301,105,68,37,2012,44285
14302,5950,2915,3035,2012,44286
14303,7648,3843,3805,2012,44287
14304,4043,1922,2121,2012,44288
14305,15748,7516,8232,2012,44301
14306,6113,2884,3229,2012,44302
14307,7354,3780,3574,2012,44303
14308,5656,3211,2445,2012,44304
14309,21947,10911,11036,2012,44305
14310,22622,10436,12186,2012,44306
14311,6606,2879,3727,2012,44307
14312,684,405,279,2012,44308
14313,23289,11492,11797,2012,44310
14314,8985,4317,4668,2012,44311
14315,32364,16173,16191,2012,44312
14316,24454,11064,13390,2012,44313
14317,18805,8778,10027,2012,44314
14318,22564,11363,11201,2012,44319
14319,20675,9730,10945,2012,44320
14320,15077,7462,7615,2012,44321
14321,18825,9072,9753,2012,44333
14322,2939,1499,1440,2012,44401
14323,3166,1597,1569,2012,44402
14324,3938,1972,1966,2012,44403
14325,1448,816,632,2012,44404
14326,8218,3903,4315,2012,44405
14327,21769,10764,11005,2012,44406
14328,10261,4904,5357,2012,44408
14329,17585,8664,8921,2012,44410
14330,2221,1062,1159,2012,44411
14331,2733,1466,1267,2012,44412
14332,7401,3567,3834,2012,44413
14333,1546,713,833,2012,44417
14334,1517,748,769,2012,44418
14335,15423,7000,8423,2012,44420
14336,2837,1327,1510,2012,44423
14337,14680,7180,7500,2012,44425
14338,1572,765,807,2012,44427
14339,2838,1420,1418,2012,44428
14340,2519,1257,1262,2012,44429
14341,5734,3476,2258,2012,44430
14342,4695,2378,2317,2012,44431
14343,13169,7866,5303,2012,44432
14344,3835,1882,1953,2012,44436
14345,4330,2095,2235,2012,44437
14346,4792,2338,2454,2012,44438
14347,62,15,47,2012,44439
14348,4692,2509,2183,2012,44440
14349,1720,785,935,2012,44441
14350,3993,1910,2083,2012,44442
14351,2085,957,1128,2012,44443
14352,10673,5217,5456,2012,44444
14353,3360,1619,1741,2012,44445
14354,20692,10189,10503,2012,44446
14355,1302,668,634,2012,44449
14356,2631,1379,1252,2012,44450
14357,2925,1510,1415,2012,44451
14358,2813,1415,1398,2012,44452
14359,817,375,442,2012,44454
14360,1902,972,930,2012,44455
14361,26796,13217,13579,2012,44460
14362,3779,2016,1763,2012,44470
14363,11099,5561,5538,2012,44471
14364,3817,1845,1972,2012,44473
14365,10094,5324,4770,2012,44481
14366,26921,12661,14260,2012,44483
14367,22557,10396,12161,2012,44484
14368,15967,7021,8946,2012,44485
14369,858,453,405,2012,44490
14370,3203,1779,1424,2012,44491
14371,34,17,17,2012,44493
14372,10228,4874,5354,2012,44502
14373,929,657,272,2012,44503
14374,6018,3120,2898,2012,44504
14375,20130,10510,9620,2012,44505
14376,2266,1104,1162,2012,44506
14377,5360,2543,2817,2012,44507
14378,12079,5573,6506,2012,44509
14379,2447,1267,1180,2012,44510
14380,20282,9594,10688,2012,44511
14381,33741,15556,18185,2012,44512
14382,22484,10840,11644,2012,44514
14383,27712,13291,14421,2012,44515
14384,34622,16819,17803,2012,44601
14385,7423,3673,3750,2012,44606
14386,204,108,96,2012,44607
14387,2834,1384,1450,2012,44608
14388,4022,1922,2100,2012,44609
14389,486,325,161,2012,44610
14390,2177,1112,1065,2012,44611
14391,5295,2626,2669,2012,44612
14392,2186,950,1236,2012,44613
14393,12497,6011,6486,2012,44614
14394,11324,5529,5795,2012,44615
14395,6986,3447,3539,2012,44618
14396,1762,901,861,2012,44620
14397,4613,2302,2311,2012,44621
14398,18352,8740,9612,2012,44622
14399,5564,2745,2819,2012,44624
14400,1301,661,640,2012,44625
14401,3035,1580,1455,2012,44626
14402,7430,3776,3654,2012,44627
14403,931,498,433,2012,44628
14404,2755,1439,1316,2012,44629
14405,10166,4957,5209,2012,44632
14406,2690,1414,1276,2012,44633
14407,2192,1027,1165,2012,44634
14408,2400,1086,1314,2012,44637
14409,1489,656,833,2012,44638
14410,312,240,72,2012,44640
14411,20320,9793,10527,2012,44641
14412,2907,1518,1389,2012,44643
14413,4682,2324,2358,2012,44644
14414,2395,1194,1201,2012,44645
14415,46305,22988,23317,2012,44646
14416,18815,9504,9311,2012,44647
14417,830,473,357,2012,44651
14418,56,28,28,2012,44652
14419,635,333,302,2012,44653
14420,19339,9802,9537,2012,44654
14421,2958,1469,1489,2012,44656
14422,10762,5075,5687,2012,44657
14423,172,71,101,2012,44659
14424,261,149,112,2012,44661
14425,9311,4519,4792,2012,44662
14426,25241,12560,12681,2012,44663
14427,2901,1496,1405,2012,44666
14428,14082,7009,7073,2012,44667
14429,1315,692,623,2012,44669
14430,217,136,81,2012,44670
14431,276,116,160,2012,44671
14432,4776,2008,2768,2012,44672
14433,2180,1203,977,2012,44675
14434,4728,2291,2437,2012,44676
14435,2438,1185,1253,2012,44677
14436,63,33,30,2012,44678
14437,4285,2129,2156,2012,44680
14438,7830,3895,3935,2012,44681
14439,820,363,457,2012,44682
14440,8305,3925,4380,2012,44683
14441,28157,13899,14258,2012,44685
14442,161,87,74,2012,44687
14443,3206,1681,1525,2012,44688
14444,788,430,358,2012,44689
14445,166,57,109,2012,44690
14446,43057,21108,21949,2012,44691
14447,74,29,45,2012,44693
14448,1684,856,828,2012,44695
14449,177,93,84,2012,44697
14450,899,431,468,2012,44699
14451,1081,480,601,2012,44702
14452,8942,4537,4405,2012,44703
14453,4052,1963,2089,2012,44704
14454,18709,9048,9661,2012,44705
14455,18672,9149,9523,2012,44706
14456,8883,4037,4846,2012,44707
14457,25628,11678,13950,2012,44708
14458,18682,8494,10188,2012,44709
14459,9844,4486,5358,2012,44710
14460,9498,4638,4860,2012,44714
14461,11640,5511,6129,2012,44718
14462,39054,18864,20190,2012,44720
14463,13016,6275,6741,2012,44721
14464,6152,2998,3154,2012,44730
14465,941,474,467,2012,44802
14466,1086,554,532,2012,44804
14467,32530,15533,16997,2012,44805
14468,2455,1231,1224,2012,44807
14469,182,99,83,2012,44809
14470,13071,6382,6689,2012,44811
14471,7622,3778,3844,2012,44813
14472,2703,1288,1415,2012,44814
14473,591,281,310,2012,44815
14474,39,12,27,2012,44816
14475,1778,849,929,2012,44817
14476,2394,1277,1117,2012,44818
14477,18081,8877,9204,2012,44820
14478,3153,1639,1514,2012,44822
14479,3759,1913,1846,2012,44824
14480,23,9,14,2012,44825
14481,1819,861,958,2012,44826
14482,7279,3680,3599,2012,44827
14483,22,14,8,2012,44828
14484,18585,9170,9415,2012,44830
14485,16670,7848,8822,2012,44833
14486,2588,1308,1280,2012,44836
14487,4281,2177,2104,2012,44837
14488,197,89,108,2012,44838
14489,12789,6130,6659,2012,44839
14490,3481,1724,1757,2012,44840
14491,726,389,337,2012,44841
14492,5459,2771,2688,2012,44842
14493,2502,1339,1163,2012,44843
14494,629,352,277,2012,44844
14495,3166,1535,1631,2012,44846
14496,3769,1934,1835,2012,44847
14497,2462,1334,1128,2012,44849
14498,51,10,41,2012,44850
14499,5345,2617,2728,2012,44851
14500,1365,724,641,2012,44853
14501,1808,848,960,2012,44854
14502,1299,562,737,2012,44855
14503,73,48,25,2012,44856
14504,23583,11635,11948,2012,44857
14505,1266,628,638,2012,44859
14506,62,45,17,2012,44861
14507,3498,1816,1682,2012,44864
14508,3546,1852,1694,2012,44865
14509,2279,1158,1121,2012,44866
14510,2513,1389,1124,2012,44867
14511,41212,20188,21024,2012,44870
14512,413,190,223,2012,44874
14513,13911,7217,6694,2012,44875
14514,3075,1412,1663,2012,44878
14515,3097,1649,1448,2012,44880
14516,62,44,18,2012,44881
14517,2850,1414,1436,2012,44882
14518,29681,14480,15201,2012,44883
14519,1071,546,525,2012,44887
14520,7115,3450,3665,2012,44889
14521,11255,5418,5837,2012,44890
14522,2566,2553,13,2012,44901
14523,5550,2980,2570,2012,44902
14524,25156,12042,13114,2012,44903
14525,14437,6861,7576,2012,44904
14526,13899,8160,5739,2012,44905
14527,16962,7662,9300,2012,44906
14528,14626,6795,7831,2012,44907
14529,538,316,222,2012,45001
14530,13213,6563,6650,2012,45002
14531,682,360,322,2012,45003
14532,30092,14842,15250,2012,45005
14533,68127,33557,34570,2012,45011
14534,54097,26294,27803,2012,45013
14535,44152,21454,22698,2012,45014
14536,11316,5537,5779,2012,45015
14537,17662,8797,8865,2012,45030
14538,328,193,135,2012,45032
14539,341,167,174,2012,45033
14540,1204,701,503,2012,45034
14541,37983,20750,17233,2012,45036
14542,22500,11042,11458,2012,45039
14543,50859,24554,26305,2012,45040
14544,0,0,0,2012,45041
14545,26484,13056,13428,2012,45042
14546,52627,25925,26702,2012,45044
14547,8282,3891,4391,2012,45050
14548,165,9,156,2012,45051
14549,4671,2405,2266,2012,45052
14550,3229,1634,1595,2012,45053
14551,2377,1187,1190,2012,45054
14552,27484,13414,14070,2012,45056
14553,592,283,309,2012,45062
14554,2873,1471,1402,2012,45064
14555,5074,2464,2610,2012,45065
14556,24150,11884,12266,2012,45066
14557,13863,6675,7188,2012,45067
14558,10300,5431,4869,2012,45068
14559,49401,24195,25206,2012,45069
14560,204,109,95,2012,45070
14561,2556,1256,1300,2012,45101
14562,22520,11183,11337,2012,45102
14563,31766,15948,15818,2012,45103
14564,12496,6202,6294,2012,45106
14565,8858,4502,4356,2012,45107
14566,378,211,167,2012,45111
14567,63,34,29,2012,45112
14568,3295,1615,1680,2012,45113
14569,53,32,21,2012,45115
14570,3848,1911,1937,2012,45118
14571,3370,1594,1776,2012,45120
14572,9193,4386,4807,2012,45121
14573,11644,5861,5783,2012,45122
14574,8419,4068,4351,2012,45123
14575,3697,1832,1865,2012,45130
14576,261,135,126,2012,45131
14577,242,121,121,2012,45132
14578,22966,11109,11857,2012,45133
14579,5136,2682,2454,2012,45135
14580,52009,25787,26222,2012,45140
14581,4573,2360,2213,2012,45142
14582,4423,2031,2392,2012,45144
14583,0,0,0,2012,45145
14584,1732,885,847,2012,45146
14585,237,90,147,2012,45147
14586,1553,808,745,2012,45148
14587,31916,15493,16423,2012,45150
14588,11474,5625,5849,2012,45152
14589,1822,902,920,2012,45153
14590,9408,4620,4788,2012,45154
14591,337,171,166,2012,45155
14592,108,61,47,2012,45156
14593,9758,4795,4963,2012,45157
14594,391,196,195,2012,45158
14595,3531,1738,1793,2012,45159
14596,742,278,464,2012,45160
14597,2344,1160,1184,2012,45162
14598,324,164,160,2012,45164
14599,222,79,143,2012,45166
14600,3453,1707,1746,2012,45167
14601,1634,816,818,2012,45168
14602,4652,2274,2378,2012,45169
14603,6415,3254,3161,2012,45171
14604,120,59,61,2012,45172
14605,2294,1195,1099,2012,45174
14606,8757,4628,4129,2012,45176
14607,22190,10621,11569,2012,45177
14608,12044,6709,5335,2012,45202
14609,2156,1116,1040,2012,45203
14610,6989,3702,3287,2012,45204
14611,20954,9785,11169,2012,45205
14612,10157,4763,5394,2012,45206
14613,8139,3834,4305,2012,45207
14614,18480,8339,10141,2012,45208
14615,9810,4722,5088,2012,45209
14616,36096,17771,18325,2012,45211
14617,22072,10663,11409,2012,45212
14618,12147,5763,6384,2012,45213
14619,8482,3727,4755,2012,45214
14620,30014,14347,15667,2012,45215
14621,9216,4018,5198,2012,45216
14622,7286,3290,3996,2012,45217
14623,3814,1771,2043,2012,45218
14624,16648,8988,7660,2012,45219
14625,14268,6859,7409,2012,45220
14626,12096,5895,6201,2012,45223
14627,20129,9323,10806,2012,45224
14628,8964,4044,4920,2012,45225
14629,5472,2808,2664,2012,45226
14630,18714,8480,10234,2012,45227
14631,12698,5829,6869,2012,45229
14632,27810,13473,14337,2012,45230
14633,40393,18979,21414,2012,45231
14634,6672,2668,4004,2012,45232
14635,15809,7801,8008,2012,45233
14636,24159,11360,12799,2012,45236
14637,19762,9187,10575,2012,45237
14638,45802,21605,24197,2012,45238
14639,28727,13436,15291,2012,45239
14640,27450,12990,14460,2012,45240
14641,23359,11958,11401,2012,45241
14642,21945,10761,11184,2012,45242
14643,14353,7220,7133,2012,45243
14644,28580,13724,14856,2012,45244
14645,18601,9298,9303,2012,45245
14646,15067,7276,7791,2012,45246
14647,21605,10614,10991,2012,45247
14648,25954,12442,13512,2012,45248
14649,13195,6527,6668,2012,45249
14650,21485,10250,11235,2012,45251
14651,4905,2399,2506,2012,45252
14652,21761,10162,11599,2012,45255
14653,110,48,62,2012,45301
14654,4188,2017,2171,2012,45302
14655,1937,960,977,2012,45303
14656,7591,3754,3837,2012,45304
14657,11089,5261,5828,2012,45305
14658,2389,1185,1204,2012,45306
14659,282,117,165,2012,45307
14660,4550,2297,2253,2012,45308
14661,12302,6149,6153,2012,45309
14662,213,115,98,2012,45310
14663,6737,3371,3366,2012,45311
14664,1364,694,670,2012,45312
14665,5977,2917,3060,2012,45314
14666,3969,1998,1971,2012,45315
14667,199,99,100,2012,45316
14668,1140,617,523,2012,45317
14669,5208,2617,2591,2012,45318
14670,326,158,168,2012,45319
14671,15272,7408,7864,2012,45320
14672,946,455,491,2012,45321
14673,21830,10467,11363,2012,45322
14674,5195,2433,2762,2012,45323
14675,40063,19455,20608,2012,45324
14676,2308,1145,1163,2012,45325
14677,1103,520,583,2012,45326
14678,9143,4364,4779,2012,45327
14679,660,331,329,2012,45328
14680,746,368,378,2012,45330
14681,22703,10949,11754,2012,45331
14682,656,307,349,2012,45332
14683,1176,628,548,2012,45333
14684,2197,1023,1174,2012,45334
14685,6921,3226,3695,2012,45335
14686,175,101,74,2012,45336
14687,1494,713,781,2012,45337
14688,5201,2590,2611,2012,45338
14689,1291,693,598,2012,45339
14690,800,437,363,2012,45340
14691,3501,1867,1634,2012,45341
14692,36328,17115,19213,2012,45342
14693,17123,8758,8365,2012,45344
14694,6412,3085,3327,2012,45345
14695,2114,1050,1064,2012,45346
14696,4523,2309,2214,2012,45347
14697,763,411,352,2012,45348
14698,482,223,259,2012,45349
14699,114,62,52,2012,45350
14700,220,116,104,2012,45351
14701,168,89,79,2012,45352
14702,130,81,49,2012,45353
14703,542,256,286,2012,45354
14704,25486,12283,13203,2012,45356
14705,407,170,237,2012,45358
14706,1947,953,994,2012,45359
14707,473,271,202,2012,45360
14708,301,141,160,2012,45361
14709,1145,562,583,2012,45362
14710,1665,821,844,2012,45363
14711,30761,15312,15449,2012,45365
14712,4620,2202,2418,2012,45368
14713,3677,1877,1800,2012,45369
14714,2252,1181,1071,2012,45370
14715,18848,9153,9695,2012,45371
14716,438,214,224,2012,45372
14717,34910,17405,17505,2012,45373
14718,14896,7339,7557,2012,45377
14719,376,206,170,2012,45378
14720,5570,2691,2879,2012,45380
14721,5520,2729,2791,2012,45381
14722,1429,696,733,2012,45382
14723,7182,3638,3544,2012,45383
14724,1340,488,852,2012,45384
14725,38332,18485,19847,2012,45385
14726,5311,2606,2705,2012,45387
14727,917,518,399,2012,45388
14728,431,206,225,2012,45389
14729,3406,1641,1765,2012,45390
14730,10535,5532,5003,2012,45402
14731,14789,7208,7581,2012,45403
14732,10918,5569,5349,2012,45404
14733,18659,9165,9494,2012,45405
14734,20717,9874,10843,2012,45406
14735,17048,8564,8484,2012,45409
14736,15209,7615,7594,2012,45410
14737,20780,9847,10933,2012,45414
14738,12359,5861,6498,2012,45415
14739,6545,2828,3717,2012,45416
14740,30871,13509,17362,2012,45417
14741,1465,695,770,2012,45418
14742,15083,7595,7488,2012,45419
14743,26376,13071,13305,2012,45420
14744,50226,24282,25944,2012,45424
14745,14459,6558,7901,2012,45426
14746,342,312,30,2012,45428
14747,25122,11929,13193,2012,45429
14748,7735,3709,4026,2012,45430
14749,26828,13317,13511,2012,45431
14750,14759,7552,7207,2012,45432
14751,2372,1272,1100,2012,45433
14752,11728,6010,5718,2012,45434
14753,9648,4546,5102,2012,45439
14754,20752,9973,10779,2012,45440
14755,18816,8650,10166,2012,45449
14756,29801,14196,15605,2012,45458
14757,27472,13124,14348,2012,45459
14758,15961,8015,7946,2012,45502
14759,33728,15962,17766,2012,45503
14760,18478,8936,9542,2012,45504
14761,19338,9065,10273,2012,45505
14762,13883,6417,7466,2012,45506
14763,57082,30541,26541,2012,45601
14764,5345,2803,2542,2012,45612
14765,3849,2008,1841,2012,45613
14766,4568,2140,2428,2012,45614
14767,1399,705,694,2012,45616
14768,119,41,78,2012,45617
14769,20,11,9,2012,45618
14770,7743,3750,3993,2012,45619
14771,809,360,449,2012,45620
14772,339,138,201,2012,45621
14773,274,152,122,2012,45622
14774,2946,1643,1303,2012,45623
14775,26,12,14,2012,45624
14776,4587,2329,2258,2012,45628
14777,3818,1952,1866,2012,45629
14778,254,110,144,2012,45630
14779,15815,7678,8137,2012,45631
14780,2271,1047,1224,2012,45634
14781,186,38,148,2012,45636
14782,21782,10264,11518,2012,45638
14783,16959,8647,8312,2012,45640
14784,0,0,0,2012,45642
14785,4263,2067,2196,2012,45644
14786,2957,1506,1451,2012,45645
14787,339,162,177,2012,45646
14788,3183,1669,1514,2012,45647
14789,12817,6989,5828,2012,45648
14790,294,112,182,2012,45650
14791,5671,2970,2701,2012,45651
14792,3528,1853,1675,2012,45652
14793,4174,1940,2234,2012,45653
14794,826,414,412,2012,45654
14795,6085,2914,3171,2012,45656
14796,3172,1782,1390,2012,45657
14797,2164,1078,1086,2012,45658
14798,2981,1594,1387,2012,45659
14799,8312,4030,4282,2012,45660
14800,6813,3585,3228,2012,45661
14801,29861,14218,15643,2012,45662
14802,6709,3180,3529,2012,45663
14803,10899,5307,5592,2012,45669
14804,659,270,389,2012,45671
14805,1619,683,936,2012,45672
14806,256,153,103,2012,45673
14807,676,284,392,2012,45674
14808,1421,822,599,2012,45678
14809,2955,1499,1456,2012,45679
14810,12685,5985,6700,2012,45680
14811,1937,949,988,2012,45681
14812,2517,1182,1335,2012,45682
14813,1951,972,979,2012,45684
14814,1370,658,712,2012,45685
14815,3516,1806,1710,2012,45686
14816,476,274,202,2012,45688
14817,14499,7178,7321,2012,45690
14818,8319,3742,4577,2012,45692
14819,8538,4326,4212,2012,45693
14820,12164,5954,6210,2012,45694
14821,731,392,339,2012,45695
14822,1306,613,693,2012,45696
14823,5461,2653,2808,2012,45697
14824,416,179,237,2012,45698
14825,33528,17301,16227,2012,45701
14826,5618,2565,3053,2012,45710
14827,1124,551,573,2012,45711
14828,9750,4622,5128,2012,45714
14829,2811,1409,1402,2012,45715
14830,436,188,248,2012,45716
14831,1108,470,638,2012,45719
14832,10,10,0,2012,45721
14833,4002,1909,2093,2012,45723
14834,1941,993,948,2012,45724
14835,423,165,258,2012,45727
14836,1475,660,815,2012,45729
14837,4487,2135,2352,2012,45732
14838,571,322,249,2012,45734
14839,1799,888,911,2012,45735
14840,557,261,296,2012,45740
14841,863,413,450,2012,45741
14842,3143,1595,1548,2012,45742
14843,1504,753,751,2012,45743
14844,2596,1177,1419,2012,45744
14845,1568,828,740,2012,45745
14846,350,199,151,2012,45746
14847,27662,13246,14416,2012,45750
14848,3874,1848,2026,2012,45760
14849,2027,965,1062,2012,45761
14850,8938,4852,4086,2012,45764
14851,1508,845,663,2012,45766
14852,2311,1161,1150,2012,45767
14853,1788,921,867,2012,45768
14854,6582,3335,3247,2012,45769
14855,484,274,210,2012,45770
14856,3381,1658,1723,2012,45771
14857,2036,1086,950,2012,45772
14858,168,94,74,2012,45773
14859,1353,698,655,2012,45775
14860,630,291,339,2012,45776
14861,592,321,271,2012,45778
14862,736,374,362,2012,45779
14863,3444,1574,1870,2012,45780
14864,398,185,213,2012,45782
14865,3234,1629,1605,2012,45784
14866,3151,1665,1486,2012,45786
14867,54,23,31,2012,45787
14868,1317,657,660,2012,45788
14869,173,103,70,2012,45789
14870,24924,13337,11587,2012,45801
14871,15846,7516,8330,2012,45804
14872,22931,11444,11487,2012,45805
14873,10993,5327,5666,2012,45806
14874,11571,5726,5845,2012,45807
14875,349,167,182,2012,45808
14876,123,56,67,2012,45809
14877,8388,4354,4034,2012,45810
14878,1716,893,823,2012,45812
14879,3583,1683,1900,2012,45813
14880,2656,1343,1313,2012,45814
14881,343,186,157,2012,45816
14882,6501,3036,3465,2012,45817
14883,242,122,120,2012,45819
14884,417,170,247,2012,45820
14885,1371,654,717,2012,45821
14886,19392,9381,10011,2012,45822
14887,309,152,157,2012,45826
14888,2252,1214,1038,2012,45827
14889,6201,3268,2933,2012,45828
14890,6694,3443,3251,2012,45830
14891,3235,1626,1609,2012,45831
14892,3172,1618,1554,2012,45832
14893,10477,5061,5416,2012,45833
14894,286,137,149,2012,45835
14895,1513,762,751,2012,45836
14896,35,13,22,2012,45838
14897,54696,26172,28524,2012,45840
14898,730,398,332,2012,45841
14899,3890,1904,1986,2012,45843
14900,3287,1674,1613,2012,45844
14901,3042,1448,1594,2012,45845
14902,4295,2235,2060,2012,45846
14903,1150,524,626,2012,45849
14904,3767,1936,1831,2012,45850
14905,684,292,392,2012,45851
14906,1033,476,557,2012,45853
14907,477,261,216,2012,45854
14908,216,108,108,2012,45855
14909,5070,2585,2485,2012,45856
14910,3239,1510,1729,2012,45858
14911,463,215,248,2012,45859
14912,2197,1046,1151,2012,45860
14913,169,74,95,2012,45861
14914,1426,750,676,2012,45862
14915,1226,565,661,2012,45863
14916,146,70,76,2012,45864
14917,4800,2386,2414,2012,45865
14918,234,113,121,2012,45866
14919,1131,531,600,2012,45867
14920,533,302,231,2012,45868
14921,4526,2250,2276,2012,45869
14922,194,104,90,2012,45870
14923,1799,941,858,2012,45871
14924,4269,2197,2072,2012,45872
14925,2200,1148,1052,2012,45873
14926,1732,833,899,2012,45874
14927,11254,5399,5855,2012,45875
14928,703,328,375,2012,45876
14929,2316,1136,1180,2012,45877
14930,6258,3134,3124,2012,45879
14931,2516,1283,1233,2012,45880
14932,1902,955,947,2012,45881
14933,2997,1408,1589,2012,45882
14934,3821,2097,1724,2012,45883
14935,132,60,72,2012,45884
14936,12773,6552,6221,2012,45885
14937,732,352,380,2012,45886
14938,4643,2532,2111,2012,45887
14939,213,130,83,2012,45888
14940,1524,767,757,2012,45889
14941,787,386,401,2012,45890
14942,15432,7474,7958,2012,45891
14943,783,396,387,2012,45894
14944,18253,9078,9175,2012,45895
14945,2093,1009,1084,2012,45896
14946,199,118,81,2012,45897
14947,1150,636,514,2012,45898
14948,288,142,146,2012,45899
14949,10690,5266,5424,2012,46001
14950,16817,8156,8661,2012,46011
14951,19865,9693,10172,2012,46012
14952,18663,8782,9881,2012,46013
14953,18282,8457,9825,2012,46016
14954,5592,2867,2725,2012,46017
14955,3270,1706,1564,2012,46030
14956,2445,1184,1261,2012,46031
14957,42542,20849,21693,2012,46032
14958,35326,16851,18475,2012,46033
14959,7012,3379,3633,2012,46034
14960,1080,524,556,2012,46035
14961,11805,6139,5666,2012,46036
14962,34602,16617,17985,2012,46037
14963,38838,18786,20052,2012,46038
14964,960,523,437,2012,46039
14965,11112,5434,5678,2012,46040
14966,23728,11619,12109,2012,46041
14967,2675,1318,1357,2012,46044
14968,374,190,184,2012,46045
14969,89,69,20,2012,46047
14970,2099,974,1125,2012,46048
14971,924,473,451,2012,46049
14972,1978,976,1002,2012,46050
14973,3023,1449,1574,2012,46051
14974,22067,10823,11244,2012,46052
14975,9130,4495,4635,2012,46055
14976,2489,1305,1184,2012,46056
14977,989,552,437,2012,46057
14978,2099,982,1117,2012,46058
14979,34390,17220,17170,2012,46060
14980,30358,14792,15566,2012,46062
14981,443,207,236,2012,46063
14982,15992,9151,6841,2012,46064
14983,3506,1768,1738,2012,46065
14984,2383,1102,1281,2012,46068
14985,6599,3222,3377,2012,46069
14986,2136,1042,1094,2012,46070
14987,3795,2029,1766,2012,46071
14988,9590,4666,4924,2012,46072
14989,26896,13352,13544,2012,46074
14990,2982,1437,1545,2012,46075
14991,1686,900,786,2012,46076
14992,24300,11925,12375,2012,46077
14993,226,116,110,2012,46103
14994,791,444,347,2012,46104
14995,2154,1105,1049,2012,46105
14996,5173,2550,2623,2012,46106
14997,12801,6015,6786,2012,46107
14998,564,213,351,2012,46110
14999,402,178,224,2012,46111
15000,33705,16191,17514,2012,46112
15001,15037,7247,7790,2012,46113
15002,2077,1006,1071,2012,46115
15003,397,211,186,2012,46117
15004,5297,2662,2635,2012,46118
15005,6182,2970,3212,2012,46120
15006,5270,2559,2711,2012,46121
15007,14363,7017,7346,2012,46122
15008,31365,15722,15643,2012,46123
15009,7893,3991,3902,2012,46124
15010,19,19,0,2012,46125
15011,4610,2157,2453,2012,46126
15012,311,160,151,2012,46127
15013,1776,923,853,2012,46128
15014,2830,1428,1402,2012,46130
15015,30925,14854,16071,2012,46131
15016,1010,484,526,2012,46133
15017,20390,11455,8935,2012,46135
15018,38876,19377,19499,2012,46140
15019,28980,14238,14742,2012,46142
15020,50241,25076,25165,2012,46143
15021,108,49,59,2012,46144
15022,109,79,30,2012,46146
15023,3280,1618,1662,2012,46147
15024,5625,2752,2873,2012,46148
15025,2148,1067,1081,2012,46149
15026,661,358,303,2012,46150
15027,30317,14811,15506,2012,46151
15028,149,85,64,2012,46155
15029,1566,725,841,2012,46156
15030,3927,1998,1929,2012,46157
15031,22231,11038,11193,2012,46158
15032,6846,3435,3411,2012,46160
15033,2309,1179,1130,2012,46161
15034,279,146,133,2012,46162
15035,12028,6080,5948,2012,46163
15036,4091,2034,2057,2012,46164
15037,1606,812,794,2012,46165
15038,2316,1178,1138,2012,46166
15039,6455,3133,3322,2012,46167
15040,30729,15946,14783,2012,46168
15041,1570,773,797,2012,46171
15042,2540,1225,1315,2012,46172
15043,11349,5633,5716,2012,46173
15044,671,351,320,2012,46175
15045,27834,13551,14283,2012,46176
15046,1306,662,644,2012,46180
15047,4359,2219,2140,2012,46181
15048,1754,979,775,2012,46182
15049,247,148,99,2012,46183
15050,12532,5862,6670,2012,46184
15051,1802,945,857,2012,46186
15052,30487,15140,15347,2012,46201
15053,16021,8569,7452,2012,46202
15054,38313,18652,19661,2012,46203
15055,5903,3844,2059,2012,46204
15056,26351,12694,13657,2012,46205
15057,23312,10548,12764,2012,46208
15058,23747,11199,12548,2012,46214
15059,1496,614,882,2012,46216
15060,29558,14434,15124,2012,46217
15061,30516,14208,16308,2012,46218
15062,33646,16232,17414,2012,46219
15063,33833,16299,17534,2012,46220
15064,27054,13366,13688,2012,46221
15065,33061,16213,16848,2012,46222
15066,35177,17739,17438,2012,46224
15067,6524,3390,3134,2012,46225
15068,45998,22435,23563,2012,46226
15069,56449,26905,29544,2012,46227
15070,14876,7328,7548,2012,46228
15071,27913,12840,15073,2012,46229
15072,11440,5677,5763,2012,46231
15073,25002,11947,13055,2012,46234
15074,29507,14079,15428,2012,46235
15075,26751,13447,13304,2012,46236
15076,39803,19243,20560,2012,46237
15077,24348,11792,12556,2012,46239
15078,18817,8952,9865,2012,46240
15079,30918,15509,15409,2012,46241
15080,18545,9288,9257,2012,46250
15081,36530,16613,19917,2012,46254
15082,23541,11538,12003,2012,46256
15083,11777,5491,6286,2012,46259
15084,32779,14775,18004,2012,46260
15085,26411,11951,14460,2012,46268
15086,7968,3804,4164,2012,46278
15087,6595,3417,3178,2012,46280
15088,297,134,163,2012,46290
15089,571,290,281,2012,46301
15090,13631,6686,6945,2012,46303
15091,24618,12374,12244,2012,46304
15092,59749,29711,30038,2012,46307
15093,13085,6699,6386,2012,46310
15094,21373,10585,10788,2012,46311
15095,29789,13799,15990,2012,46312
15096,18086,9196,8890,2012,46319
15097,15215,7288,7927,2012,46320
15098,23460,11361,12099,2012,46321
15099,23646,11102,12544,2012,46322
15100,22618,11397,11221,2012,46323
15101,22944,10934,12010,2012,46324
15102,12272,6194,6078,2012,46327
15103,1083,610,473,2012,46340
15104,10610,5291,5319,2012,46341
15105,31077,15616,15461,2012,46342
15106,293,121,172,2012,46345
15107,1539,722,817,2012,46346
15108,4844,2505,2339,2012,46347
15109,1014,488,526,2012,46348
15110,3302,1808,1494,2012,46349
15111,43249,21776,21473,2012,46350
15112,17541,8549,8992,2012,46356
15113,44106,21982,22124,2012,46360
15114,1151,586,565,2012,46365
15115,5573,2845,2728,2012,46366
15116,38310,18586,19724,2012,46368
15117,3559,1760,1799,2012,46371
15118,13694,7037,6657,2012,46373
15119,959,428,531,2012,46374
15120,23752,11561,12191,2012,46375
15121,398,195,203,2012,46376
15122,350,157,193,2012,46377
15123,291,81,210,2012,46379
15124,420,158,262,2012,46381
15125,2212,1178,1034,2012,46382
15126,39202,19399,19803,2012,46383
15127,38335,18432,19903,2012,46385
15128,2541,1227,1314,2012,46390
15129,10153,6960,3193,2012,46391
15130,7856,4118,3738,2012,46392
15131,337,196,141,2012,46393
15132,12606,5896,6710,2012,46394
15133,6692,3050,3642,2012,46402
15134,12938,5604,7334,2012,46403
15135,16888,7583,9305,2012,46404
15136,11854,5881,5973,2012,46405
15137,9876,4761,5115,2012,46406
15138,13076,5684,7392,2012,46407
15139,16577,7967,8610,2012,46408
15140,9799,4559,5240,2012,46409
15141,38990,18662,20328,2012,46410
15142,3858,1790,2068,2012,46501
15143,454,175,279,2012,46502
15144,3490,1632,1858,2012,46504
15145,10223,5047,5176,2012,46506
15146,8963,4468,4495,2012,46507
15147,202,88,114,2012,46508
15148,3178,1677,1501,2012,46510
15149,4589,2234,2355,2012,46511
15150,39298,19023,20275,2012,46514
15151,34309,16623,17686,2012,46516
15152,22970,11356,11614,2012,46517
15153,2581,1308,1273,2012,46524
15154,32644,15972,16672,2012,46526
15155,24966,12546,12420,2012,46528
15156,29892,14498,15394,2012,46530
15157,1498,771,727,2012,46531
15158,2031,1006,1025,2012,46532
15159,11393,5544,5849,2012,46534
15160,3369,1855,1514,2012,46536
15161,396,147,249,2012,46537
15162,3841,1882,1959,2012,46538
15163,1897,919,978,2012,46539
15164,11501,5842,5659,2012,46540
15165,4041,2016,2025,2012,46542
15166,4022,2198,1824,2012,46543
15167,30761,14543,16218,2012,46544
15168,25090,11346,13744,2012,46545
15169,12568,6572,5996,2012,46550
15170,6891,3455,3436,2012,46552
15171,3567,1817,1750,2012,46553
15172,4698,2449,2249,2012,46554
15173,2829,1477,1352,2012,46555
15174,7207,3677,3530,2012,46556
15175,13801,6710,7091,2012,46561
15176,4848,2364,2484,2012,46562
15177,23347,11848,11499,2012,46563
15178,7802,4050,3752,2012,46565
15179,9335,4685,4650,2012,46567
15180,1330,645,685,2012,46570
15181,6458,3226,3232,2012,46571
15182,3518,1679,1839,2012,46573
15183,7551,3869,3682,2012,46574
15184,21210,10627,10583,2012,46580
15185,12116,6006,6110,2012,46582
15186,4862,2233,2629,2012,46590
15187,66,14,52,2012,46595
15188,6094,3306,2788,2012,46601
15189,11193,5458,5735,2012,46613
15190,30730,15123,15607,2012,46614
15191,15167,7023,8144,2012,46615
15192,5593,2639,2954,2012,46616
15193,10190,4740,5450,2012,46617
15194,21229,10414,10815,2012,46619
15195,26702,13270,13432,2012,46628
15196,5641,2707,2934,2012,46635
15197,14532,6959,7573,2012,46637
15198,7724,4011,3713,2012,46701
15199,2241,1209,1032,2012,46702
15200,17894,8782,9112,2012,46703
15201,179,108,71,2012,46704
15202,1876,1027,849,2012,46705
15203,18998,9247,9751,2012,46706
15204,4564,2233,2331,2012,46710
15205,7686,3684,4002,2012,46711
15206,14478,7229,7249,2012,46714
15207,5028,2525,2503,2012,46721
15208,7259,3660,3599,2012,46723
15209,22979,11456,11523,2012,46725
15210,1350,692,658,2012,46730
15211,566,277,289,2012,46731
15212,2922,1468,1454,2012,46732
15213,18896,9396,9500,2012,46733
15214,7112,3569,3543,2012,46737
15215,7913,3837,4076,2012,46738
15216,4113,2048,2065,2012,46740
15217,4748,2485,2263,2012,46741
15218,3539,1974,1565,2012,46742
15219,1824,892,932,2012,46743
15220,1940,951,989,2012,46745
15221,3985,2029,1956,2012,46746
15222,2503,1303,1200,2012,46747
15223,5374,2868,2506,2012,46748
15224,27475,13185,14290,2012,46750
15225,15203,7339,7864,2012,46755
15226,612,297,315,2012,46759
15227,1564,938,626,2012,46760
15228,11503,5614,5889,2012,46761
15229,1712,965,747,2012,46763
15230,1495,730,765,2012,46764
15231,5602,2889,2713,2012,46765
15232,832,410,422,2012,46766
15233,8436,4394,4042,2012,46767
15234,2809,1421,1388,2012,46770
15235,43,28,15,2012,46771
15236,3426,1690,1736,2012,46772
15237,3886,1979,1907,2012,46773
15238,16244,7825,8419,2012,46774
15239,1492,776,716,2012,46776
15240,6274,3026,3248,2012,46777
15241,2142,1121,1021,2012,46779
15242,915,411,504,2012,46781
15243,5888,3047,2841,2012,46783
15244,2072,973,1099,2012,46784
15245,1926,1064,862,2012,46785
15246,238,102,136,2012,46786
15247,4000,1914,2086,2012,46787
15248,2628,1338,1290,2012,46788
15249,761,382,379,2012,46791
15250,3451,1720,1731,2012,46792
15251,4495,2222,2273,2012,46793
15252,2121,1013,1108,2012,46794
15253,5699,3013,2686,2012,46795
15254,3961,1997,1964,2012,46797
15255,2156,1186,970,2012,46798
15256,162,71,91,2012,46799
15257,10976,6075,4901,2012,46802
15258,8932,4303,4629,2012,46803
15259,26719,12610,14109,2012,46804
15260,21462,10061,11401,2012,46805
15261,23990,11211,12779,2012,46806
15262,15632,7472,8160,2012,46807
15263,19495,9453,10042,2012,46808
15264,8230,3956,4274,2012,46809
15265,12883,6327,6556,2012,46814
15266,26936,12891,14045,2012,46815
15267,19003,9110,9893,2012,46816
15268,18998,9776,9222,2012,46818
15269,8865,4374,4491,2012,46819
15270,28901,14126,14775,2012,46825
15271,32278,15738,16540,2012,46835
15272,21406,10352,11054,2012,46845
15273,38946,19442,19504,2012,46901
15274,35497,16567,18930,2012,46902
15275,3463,1778,1685,2012,46910
15276,1580,755,825,2012,46911
15277,1210,703,507,2012,46913
15278,1945,1032,913,2012,46914
15279,800,386,414,2012,46915
15280,1900,880,1020,2012,46917
15281,2660,1296,1364,2012,46919
15282,1144,621,523,2012,46920
15283,0,0,0,2012,46922
15284,7773,3742,4031,2012,46923
15285,1725,886,839,2012,46926
15286,4793,2484,2309,2012,46928
15287,3385,1662,1723,2012,46929
15288,153,78,75,2012,46930
15289,101,54,47,2012,46931
15290,3921,1809,2112,2012,46932
15291,6623,3324,3299,2012,46933
15292,6046,3058,2988,2012,46936
15293,3167,1579,1588,2012,46938
15294,2139,1174,965,2012,46939
15295,2711,1323,1388,2012,46940
15296,931,450,481,2012,46941
15297,216,88,128,2012,46943
15298,14,6,8,2012,46946
15299,28817,14545,14272,2012,46947
15300,590,273,317,2012,46950
15301,1662,920,742,2012,46951
15302,19790,9157,10633,2012,46952
15303,24444,11630,12814,2012,46953
15304,580,268,312,2012,46957
15305,454,331,123,2012,46958
15306,523,260,263,2012,46959
15307,1057,560,497,2012,46960
15308,74,36,38,2012,46961
15309,10041,4826,5215,2012,46962
15310,111,51,60,2012,46967
15311,108,48,60,2012,46968
15312,24112,12859,11253,2012,46970
15313,1822,923,899,2012,46974
15314,14685,7191,7494,2012,46975
15315,2039,989,1050,2012,46978
15316,5298,2552,2746,2012,46979
15317,2692,1361,1331,2012,46982
15318,163,81,82,2012,46984
15319,1083,526,557,2012,46985
15320,2083,982,1101,2012,46986
15321,476,247,229,2012,46987
15322,1083,513,570,2012,46988
15323,5196,2543,2653,2012,46989
15324,1051,586,465,2012,46990
15325,1842,951,891,2012,46991
15326,16787,8223,8564,2012,46992
15327,2480,1217,1263,2012,46994
15328,7253,3717,3536,2012,46996
15329,74,15,59,2012,46998
15330,9802,4744,5058,2012,47001
15331,914,455,459,2012,47003
15332,11902,5774,6128,2012,47006
15333,213,129,84,2012,47010
15334,868,478,390,2012,47011
15335,10393,5006,5387,2012,47012
15336,1100,592,508,2012,47016
15337,493,314,179,2012,47017
15338,4306,2125,2181,2012,47018
15339,1782,953,829,2012,47020
15340,3293,1690,1603,2012,47022
15341,1881,930,951,2012,47023
15342,3313,1779,1534,2012,47024
15343,23153,11663,11490,2012,47025
15344,1453,795,658,2012,47030
15345,5245,2573,2672,2012,47031
15346,3108,1515,1593,2012,47032
15347,161,85,76,2012,47034
15348,410,226,184,2012,47035
15349,956,478,478,2012,47036
15350,4632,2268,2364,2012,47037
15351,1396,631,765,2012,47038
15352,5675,2901,2774,2012,47040
15353,6386,3097,3289,2012,47041
15354,4040,1890,2150,2012,47042
15355,5145,2496,2649,2012,47043
15356,6200,3032,3168,2012,47060
15357,7676,3762,3914,2012,47102
15358,0,0,0,2012,47104
15359,4387,2150,2237,2012,47106
15360,2427,1286,1141,2012,47108
15361,254,64,190,2012,47110
15362,14654,6781,7873,2012,47111
15363,16519,8363,8156,2012,47112
15364,326,179,147,2012,47114
15365,2684,1330,1354,2012,47115
15366,971,526,445,2012,47116
15367,4397,2167,2230,2012,47117
15368,3402,1621,1781,2012,47118
15369,11060,5295,5765,2012,47119
15370,929,485,444,2012,47120
15371,10205,5324,4881,2012,47122
15372,153,78,75,2012,47123
15373,4748,2313,2435,2012,47124
15374,1665,794,871,2012,47125
15375,3969,2091,1878,2012,47126
15376,20007,9672,10335,2012,47129
15377,44354,21739,22615,2012,47130
15378,1220,478,742,2012,47135
15379,4070,1940,2130,2012,47136
15380,1493,731,762,2012,47137
15381,4489,2362,2127,2012,47138
15382,2485,1208,1277,2012,47140
15383,1969,1000,969,2012,47141
15384,984,533,451,2012,47142
15385,3082,1629,1453,2012,47143
15386,1939,1053,886,2012,47145
15387,906,504,402,2012,47147
15388,47415,22628,24787,2012,47150
15389,177,85,92,2012,47160
15390,4014,2089,1925,2012,47161
15391,836,332,504,2012,47162
15392,1375,779,596,2012,47163
15393,3361,1743,1618,2012,47164
15394,6686,3259,3427,2012,47165
15395,1459,710,749,2012,47166
15396,14724,7346,7378,2012,47167
15397,14521,7319,7202,2012,47170
15398,15761,7845,7916,2012,47172
15399,982,564,418,2012,47175
15400,1411,687,724,2012,47177
15401,41832,20915,20917,2012,47201
15402,26216,12724,13492,2012,47203
15403,5106,2491,2615,2012,47220
15404,1619,810,809,2012,47223
15405,645,409,236,2012,47224
15406,304,140,164,2012,47226
15407,1492,760,732,2012,47227
15408,3191,1530,1661,2012,47229
15409,1744,1022,722,2012,47230
15410,987,499,488,2012,47231
15411,3660,1960,1700,2012,47232
15412,1539,773,766,2012,47234
15413,2243,1061,1182,2012,47235
15414,21155,10515,10640,2012,47240
15415,6064,2971,3093,2012,47243
15416,889,412,477,2012,47244
15417,4372,2106,2266,2012,47246
15418,106,47,59,2012,47247
15419,21801,10281,11520,2012,47250
15420,1990,965,1025,2012,47260
15421,217,117,100,2012,47263
15422,1918,956,962,2012,47264
15423,20518,10265,10253,2012,47265
15424,659,318,341,2012,47270
15425,2027,966,1061,2012,47272
15426,1734,975,759,2012,47273
15427,28475,14283,14192,2012,47274
15428,525,210,315,2012,47280
15429,1518,737,781,2012,47281
15430,187,75,112,2012,47282
15431,2826,1337,1489,2012,47283
15432,27938,13376,14562,2012,47302
15433,25466,12614,12852,2012,47303
15434,30369,14359,16010,2012,47304
15435,4570,2475,2095,2012,47305
15436,5508,2042,3466,2012,47306
15437,4240,2140,2100,2012,47320
15438,175,85,90,2012,47324
15439,685,345,340,2012,47325
15440,2002,1025,977,2012,47326
15441,4812,2321,2491,2012,47327
15442,5494,2746,2748,2012,47330
15443,23165,11339,11826,2012,47331
15444,3246,1519,1727,2012,47334
15445,693,349,344,2012,47335
15446,3854,1775,2079,2012,47336
15447,159,65,94,2012,47337
15448,2631,1342,1289,2012,47338
15449,850,513,337,2012,47339
15450,3131,1656,1475,2012,47340
15451,2207,1157,1050,2012,47341
15452,3062,1607,1455,2012,47342
15453,242,140,102,2012,47344
15454,1655,821,834,2012,47345
15455,3755,1873,1882,2012,47346
15456,10022,4814,5208,2012,47348
15457,614,315,299,2012,47351
15458,686,346,340,2012,47352
15459,5934,2920,3014,2012,47353
15460,1095,541,554,2012,47354
15461,2970,1488,1482,2012,47355
15462,5852,2932,2920,2012,47356
15463,1374,695,679,2012,47357
15464,1198,645,553,2012,47358
15465,2873,1539,1334,2012,47359
15466,1805,938,867,2012,47360
15467,138,61,77,2012,47361
15468,29687,15458,14229,2012,47362
15469,123,52,71,2012,47367
15470,2351,1045,1306,2012,47368
15471,1483,679,804,2012,47369
15472,12495,6335,6160,2012,47371
15473,2088,987,1101,2012,47373
15474,46669,21974,24695,2012,47374
15475,1939,983,956,2012,47380
15476,213,105,108,2012,47381
15477,154,77,77,2012,47382
15478,2852,1288,1564,2012,47383
15479,1780,981,799,2012,47384
15480,1989,1050,939,2012,47385
15481,1307,724,583,2012,47386
15482,758,356,402,2012,47387
15483,279,137,142,2012,47388
15484,5280,2575,2705,2012,47390
15485,1634,938,696,2012,47393
15486,8337,3894,4443,2012,47394
15487,6751,3301,3450,2012,47396
15488,41444,21088,20356,2012,47401
15489,30104,14339,15765,2012,47403
15490,20730,10311,10419,2012,47404
15491,5100,2592,2508,2012,47405
15492,4422,1965,2457,2012,47406
15493,25147,12822,12325,2012,47408
15494,49,19,30,2012,47420
15495,28064,13885,14179,2012,47421
15496,8833,4385,4448,2012,47424
15497,1306,678,628,2012,47427
15498,7999,3904,4095,2012,47429
15499,1370,710,660,2012,47431
15500,4441,2097,2344,2012,47432
15501,4115,2152,1963,2012,47433
15502,103,46,57,2012,47434
15503,1627,817,810,2012,47436
15504,0,0,0,2012,47437
15505,4511,2362,2149,2012,47438
15506,9340,4538,4802,2012,47441
15507,1010,463,547,2012,47443
15508,10142,4942,5200,2012,47446
15509,7249,3600,3649,2012,47448
15510,587,283,304,2012,47449
15511,1324,656,668,2012,47451
15512,5169,2511,2658,2012,47452
15513,546,219,327,2012,47453
15514,7765,4048,3717,2012,47454
15515,48,10,38,2012,47455
15516,1122,557,565,2012,47456
15517,29,22,7,2012,47457
15518,0,0,0,2012,47458
15519,4042,2066,1976,2012,47459
15520,11489,5691,5798,2012,47460
15521,4956,2422,2534,2012,47462
15522,119,57,62,2012,47464
15523,684,395,289,2012,47465
15524,36,18,18,2012,47467
15525,1245,610,635,2012,47468
15526,1798,878,920,2012,47469
15527,1809,961,848,2012,47470
15528,2756,1492,1264,2012,47471
15529,17689,8665,9024,2012,47501
15530,3914,2034,1880,2012,47512
15531,1886,976,910,2012,47513
15532,1673,1510,163,2012,47514
15533,962,564,398,2012,47515
15534,1373,617,756,2012,47516
15535,448,212,236,2012,47519
15536,2972,1401,1571,2012,47520
15537,649,367,282,2012,47521
15538,262,148,114,2012,47522
15539,3488,1696,1792,2012,47523
15540,600,362,238,2012,47524
15541,188,100,88,2012,47525
15542,1615,811,804,2012,47527
15543,692,328,364,2012,47528
15544,874,448,426,2012,47529
15545,745,433,312,2012,47531
15546,5046,2289,2757,2012,47532
15547,339,137,202,2012,47535
15548,23,12,11,2012,47536
15549,792,406,386,2012,47537
15550,1085,490,595,2012,47541
15551,9779,4891,4888,2012,47542
15552,21167,10764,10403,2012,47546
15553,772,412,360,2012,47550
15554,839,447,392,2012,47551
15555,104,44,60,2012,47552
15556,8560,4320,4240,2012,47553
15557,1345,698,647,2012,47557
15558,4977,2508,2469,2012,47558
15559,1594,874,720,2012,47561
15560,4259,2094,2165,2012,47562
15561,1702,799,903,2012,47564
15562,5588,2772,2816,2012,47567
15563,673,378,295,2012,47568
15564,120,77,43,2012,47574
15565,995,473,522,2012,47575
15566,359,224,135,2012,47576
15567,992,505,487,2012,47577
15568,659,276,383,2012,47578
15569,2896,1508,1388,2012,47579
15570,567,287,280,2012,47580
15571,3812,1928,1884,2012,47581
15572,135,61,74,2012,47584
15573,536,277,259,2012,47585
15574,11363,5539,5824,2012,47586
15575,601,244,357,2012,47588
15576,703,380,323,2012,47590
15577,27040,13576,13464,2012,47591
15578,140,63,77,2012,47596
15579,932,448,484,2012,47597
15580,3596,1801,1795,2012,47598
15581,13941,7067,6874,2012,47601
15582,5298,2884,2414,2012,47610
15583,1191,536,655,2012,47611
15584,1101,622,479,2012,47612
15585,2647,1338,1309,2012,47613
15586,1553,727,826,2012,47615
15587,409,171,238,2012,47616
15588,1449,695,754,2012,47619
15589,13216,6643,6573,2012,47620
15590,34483,16680,17803,2012,47630
15591,1931,902,1029,2012,47631
15592,2592,1254,1338,2012,47633
15593,2298,1139,1159,2012,47634
15594,5898,3067,2831,2012,47635
15595,1415,705,710,2012,47637
15596,3117,1455,1662,2012,47638
15597,4424,2224,2200,2012,47639
15598,1019,600,419,2012,47640
15599,4696,2451,2245,2012,47648
15600,1498,749,749,2012,47649
15601,120,55,65,2012,47654
15602,4895,2371,2524,2012,47660
15603,3643,1763,1880,2012,47665
15604,1491,748,743,2012,47666
15605,12162,6117,6045,2012,47670
15606,151,64,87,2012,47683
15607,465,327,138,2012,47708
15608,19288,9370,9918,2012,47710
15609,30806,15472,15334,2012,47711
15610,26603,12285,14318,2012,47712
15611,10367,5018,5349,2012,47713
15612,34114,16131,17983,2012,47714
15613,27313,12485,14828,2012,47715
15614,18111,9381,8730,2012,47720
15615,15805,7867,7938,2012,47725
15616,33880,18242,15638,2012,47802
15617,21258,10644,10614,2012,47803
15618,11312,4997,6315,2012,47804
15619,12891,6509,6382,2012,47805
15620,13189,7006,6183,2012,47807
15621,2761,1188,1573,2012,47809
15622,881,512,369,2012,47832
15623,1466,691,775,2012,47833
15624,19771,9988,9783,2012,47834
15625,0,0,0,2012,47836
15626,1139,565,574,2012,47837
15627,4134,3017,1117,2012,47838
15628,1706,842,864,2012,47840
15629,1905,874,1031,2012,47841
15630,9927,4817,5110,2012,47842
15631,558,278,280,2012,47846
15632,875,484,391,2012,47847
15633,1744,914,830,2012,47848
15634,296,161,135,2012,47849
15635,2201,1087,1114,2012,47850
15636,100,45,55,2012,47853
15637,1153,638,515,2012,47854
15638,547,300,247,2012,47855
15639,583,283,300,2012,47857
15640,1094,569,525,2012,47858
15641,1600,773,827,2012,47859
15642,291,164,127,2012,47860
15643,387,198,189,2012,47861
15644,1448,711,737,2012,47862
15645,276,49,227,2012,47863
15646,42,5,37,2012,47865
15647,250,52,198,2012,47866
15648,3042,1579,1463,2012,47868
15649,112,39,73,2012,47869
15650,216,111,105,2012,47871
15651,8220,3463,4757,2012,47872
15652,3236,1548,1688,2012,47874
15653,426,13,413,2012,47876
15654,3386,1679,1707,2012,47879
15655,11,11,0,2012,47880
15656,482,247,235,2012,47881
15657,8474,4224,4250,2012,47882
15658,178,82,96,2012,47884
15659,9068,4579,4489,2012,47885
15660,3489,1941,1548,2012,47901
15661,15033,7721,7312,2012,47904
15662,40191,19509,20682,2012,47905
15663,67388,36219,31169,2012,47906
15664,0,0,0,2012,47907
15665,39902,19054,20848,2012,47909
15666,77,46,31,2012,47916
15667,509,249,260,2012,47917
15668,6027,3169,2858,2012,47918
15669,2276,1196,1080,2012,47920
15670,1148,530,618,2012,47921
15671,1676,773,903,2012,47922
15672,3518,1753,1765,2012,47923
15673,205,110,95,2012,47924
15674,395,178,217,2012,47925
15675,1031,503,528,2012,47926
15676,1960,952,1008,2012,47928
15677,694,331,363,2012,47929
15678,1069,528,541,2012,47930
15679,5436,2712,2724,2012,47932
15680,28036,14116,13920,2012,47933
15681,1226,599,627,2012,47940
15682,1002,517,485,2012,47941
15683,681,365,316,2012,47942
15684,1007,532,475,2012,47943
15685,3431,1765,1666,2012,47944
15686,1915,1033,882,2012,47946
15687,1511,789,722,2012,47948
15688,1660,720,940,2012,47949
15689,1027,570,457,2012,47950
15690,2130,1049,1081,2012,47951
15691,2722,1402,1320,2012,47952
15692,2485,1258,1227,2012,47954
15693,1220,527,693,2012,47955
15694,2310,1003,1307,2012,47957
15695,198,107,91,2012,47958
15696,2718,1452,1266,2012,47959
15697,14945,7225,7720,2012,47960
15698,2005,970,1035,2012,47963
15699,165,86,79,2012,47964
15700,771,345,426,2012,47965
15701,475,257,218,2012,47966
15702,976,536,440,2012,47967
15703,652,355,297,2012,47968
15704,144,80,64,2012,47969
15705,2078,930,1148,2012,47970
15706,1957,941,1016,2012,47971
15707,1253,615,638,2012,47974
15708,491,229,262,2012,47975
15709,2312,1180,1132,2012,47977
15710,11491,5475,6016,2012,47978
15711,1251,672,579,2012,47980
15712,1060,612,448,2012,47981
15713,110,52,58,2012,47982
15714,343,185,158,2012,47983
15715,3802,1827,1975,2012,47987
15716,1363,784,579,2012,47989
15717,1439,648,791,2012,47990
15718,1134,590,544,2012,47991
15719,1217,635,582,2012,47992
15720,4297,2139,2158,2012,47993
15721,304,146,158,2012,47994
15722,1469,715,754,2012,47995
15723,106,48,58,2012,47997
15724,12075,5900,6175,2012,48001
15725,3286,1632,1654,2012,48002
15726,5951,2919,3032,2012,48003
15727,5390,2616,2774,2012,48005
15728,4049,2147,1902,2012,48006
15729,20153,9569,10584,2012,48009
15730,4410,2217,2193,2012,48014
15731,8289,3635,4654,2012,48015
15732,11885,5932,5953,2012,48017
15733,32454,15521,16933,2012,48021
15734,2647,1302,1345,2012,48022
15735,5250,2512,2738,2012,48023
15736,14610,6744,7866,2012,48025
15737,14563,6676,7887,2012,48026
15738,3243,1588,1655,2012,48027
15739,1158,567,591,2012,48028
15740,16579,7946,8633,2012,48030
15741,2237,1110,1127,2012,48032
15742,16258,6958,9300,2012,48033
15743,13296,5774,7522,2012,48034
15744,34667,16444,18223,2012,48035
15745,21240,10113,11127,2012,48036
15746,41391,18981,22410,2012,48038
15747,7817,3918,3899,2012,48039
15748,9933,4906,5027,2012,48040
15749,4392,2222,2170,2012,48041
15750,26680,13461,13219,2012,48042
15751,16345,8474,7871,2012,48043
15752,52258,25608,26650,2012,48044
15753,24680,12228,12452,2012,48045
15754,39232,19037,20195,2012,48047
15755,8225,4430,3795,2012,48048
15756,5563,2855,2708,2012,48049
15757,1430,758,672,2012,48050
15758,16634,8780,7854,2012,48051
15759,7321,3533,3788,2012,48054
15760,15098,7425,7673,2012,48059
15761,40784,20165,20619,2012,48060
15762,9409,4637,4772,2012,48062
15763,4090,1872,2218,2012,48063
15764,4151,2253,1898,2012,48064
15765,10593,5275,5318,2012,48065
15766,47542,23308,24234,2012,48066
15767,24457,12094,12363,2012,48067
15768,2541,1310,1231,2012,48069
15769,6236,2969,3267,2012,48070
15770,29854,14975,14879,2012,48071
15771,15034,7506,7528,2012,48072
15772,33321,15996,17325,2012,48073
15773,9313,4515,4798,2012,48074
15774,21684,9747,11937,2012,48075
15775,25141,11423,13718,2012,48076
15776,12307,6203,6104,2012,48079
15777,23019,10577,12442,2012,48080
15778,20700,9742,10958,2012,48081
15779,16225,7915,8310,2012,48082
15780,23265,11350,11915,2012,48083
15781,14440,6995,7445,2012,48084
15782,24362,11923,12439,2012,48085
15783,22953,11121,11832,2012,48088
15784,30197,14853,15344,2012,48089
15785,31229,15053,16176,2012,48091
15786,26508,13026,13482,2012,48092
15787,23663,10774,12889,2012,48093
15788,17730,8677,9053,2012,48094
15789,4906,2387,2519,2012,48095
15790,3810,2061,1749,2012,48096
15791,5249,2586,2663,2012,48097
15792,19240,9949,9291,2012,48098
15793,28072,13224,14848,2012,48101
15794,54256,26113,28143,2012,48103
15795,39094,19478,19616,2012,48104
15796,33127,16720,16407,2012,48105
15797,26549,13290,13259,2012,48108
15798,7585,3812,3773,2012,48109
15799,42366,20890,21476,2012,48111
15800,20406,10353,10053,2012,48114
15801,25969,12815,13154,2012,48116
15802,10328,5059,5269,2012,48117
15803,12494,6152,6342,2012,48118
15804,7388,3906,3482,2012,48120
15805,10676,4735,5941,2012,48122
15806,32356,15892,16464,2012,48124
15807,20569,10125,10444,2012,48125
15808,47394,23505,23889,2012,48126
15809,36885,17697,19188,2012,48127
15810,10371,4903,5468,2012,48128
15811,14580,7006,7574,2012,48130
15812,6501,3254,3247,2012,48131
15813,5516,2914,2602,2012,48133
15814,20718,10380,10338,2012,48134
15815,27639,13796,13843,2012,48135
15816,4688,2454,2234,2012,48137
15817,10354,5107,5247,2012,48138
15818,248,71,177,2012,48139
15819,3088,1580,1508,2012,48140
15820,25455,11625,13830,2012,48141
15821,0,0,0,2012,48143
15822,10301,5157,5144,2012,48144
15823,3561,1718,1843,2012,48145
15824,37836,18130,19706,2012,48146
15825,27241,13216,14025,2012,48150
15826,31060,15327,15733,2012,48152
15827,38331,19314,19017,2012,48154
15828,1454,719,735,2012,48157
15829,7486,3688,3798,2012,48158
15830,2304,1272,1032,2012,48159
15831,13842,7155,6687,2012,48160
15832,27035,13242,13793,2012,48161
15833,28861,14076,14785,2012,48162
15834,9755,5042,4713,2012,48164
15835,5888,2701,3187,2012,48165
15836,11473,5599,5874,2012,48166
15837,22089,10468,11621,2012,48167
15838,22004,10622,11382,2012,48168
15839,20698,10537,10161,2012,48169
15840,39459,19484,19975,2012,48170
15841,12515,6559,5956,2012,48173
15842,31558,15260,16298,2012,48174
15843,20443,10161,10282,2012,48176
15844,302,163,139,2012,48177
15845,29729,14201,15528,2012,48178
15846,3215,1635,1580,2012,48179
15847,62916,30037,32879,2012,48180
15848,21579,10595,10984,2012,48182
15849,42225,20522,21703,2012,48183
15850,17585,8469,9116,2012,48184
15851,47519,22098,25421,2012,48185
15852,36251,17703,18548,2012,48186
15853,47914,23562,24352,2012,48187
15854,41190,21062,20128,2012,48188
15855,13414,6692,6722,2012,48189
15856,56,28,28,2012,48190
15857,3781,1873,1908,2012,48191
15858,25839,12523,13316,2012,48192
15859,15520,6954,8566,2012,48193
15860,29879,14142,15737,2012,48195
15861,61339,30294,31045,2012,48197
15862,37995,17759,20236,2012,48198
15863,11033,5672,5361,2012,48201
15864,16265,8348,7917,2012,48202
15865,28577,13445,15132,2012,48203
15866,28011,12486,15525,2012,48204
15867,41947,18844,23103,2012,48205
15868,22436,10522,11914,2012,48206
15869,20085,8792,11293,2012,48207
15870,10084,5033,5051,2012,48208
15871,34583,17971,16612,2012,48209
15872,31141,15104,16037,2012,48210
15873,6318,3387,2931,2012,48211
15874,39592,20837,18755,2012,48212
15875,28729,12697,16032,2012,48213
15876,22673,10769,11904,2012,48214
15877,14568,7287,7281,2012,48215
15878,5117,2422,2695,2012,48216
15879,8159,3863,4296,2012,48217
15880,7951,3675,4276,2012,48218
15881,48391,22027,26364,2012,48219
15882,22761,11426,11335,2012,48220
15883,40152,18228,21924,2012,48221
15884,24185,11159,13026,2012,48223
15885,45296,21029,24267,2012,48224
15886,14532,6621,7911,2012,48225
15887,5232,3087,2145,2012,48226
15888,47007,22298,24709,2012,48227
15889,53145,24805,28340,2012,48228
15890,9707,4881,4826,2012,48229
15891,16920,7861,9059,2012,48230
15892,0,0,0,2012,48233
15893,36211,17102,19109,2012,48234
15894,46133,21187,24946,2012,48235
15895,30528,14537,15991,2012,48236
15896,29523,13519,16004,2012,48237
15897,33116,15771,17345,2012,48238
15898,35738,17236,18502,2012,48239
15899,17649,8817,8832,2012,48240
15900,0,0,0,2012,48242
15901,0,0,0,2012,48243
15902,13839,6759,7080,2012,48301
15903,15240,7133,8107,2012,48302
15904,16652,8023,8629,2012,48304
15905,27433,13127,14306,2012,48306
15906,40691,19659,21032,2012,48307
15907,28838,13735,15103,2012,48309
15908,42868,21567,21301,2012,48310
15909,32955,15717,17238,2012,48312
15910,33599,16479,17120,2012,48313
15911,20465,9911,10554,2012,48314
15912,26766,12827,13939,2012,48315
15913,25543,12829,12714,2012,48316
15914,26275,13369,12906,2012,48317
15915,4390,2222,2168,2012,48320
15916,31532,14739,16793,2012,48322
15917,17373,8644,8729,2012,48323
15918,17393,8825,8568,2012,48324
15919,20988,10189,10799,2012,48326
15920,22026,11101,10925,2012,48327
15921,25142,12267,12875,2012,48328
15922,24489,11959,12530,2012,48329
15923,21913,10759,11154,2012,48331
15924,16966,7588,9378,2012,48334
15925,23001,10934,12067,2012,48335
15926,26516,13267,13249,2012,48336
15927,25089,12132,12957,2012,48340
15928,16937,8576,8361,2012,48341
15929,18541,8850,9691,2012,48342
15930,22823,11038,11785,2012,48346
15931,23376,11491,11885,2012,48348
15932,6989,3475,3514,2012,48350
15933,6345,3378,2967,2012,48353
15934,8366,4106,4260,2012,48356
15935,8488,4460,4028,2012,48357
15936,7784,3804,3980,2012,48359
15937,11847,5888,5959,2012,48360
15938,15431,8007,7424,2012,48362
15939,4776,2433,2343,2012,48363
15940,4584,2373,2211,2012,48367
15941,1788,996,792,2012,48370
15942,22187,10885,11302,2012,48371
15943,14229,7089,7140,2012,48374
15944,21461,10530,10931,2012,48375
15945,15165,7328,7837,2012,48377
15946,7244,3624,3620,2012,48380
15947,12677,6021,6656,2012,48381
15948,21532,10796,10736,2012,48382
15949,12534,6304,6230,2012,48383
15950,17579,8847,8732,2012,48386
15951,23002,10972,12030,2012,48390
15952,16512,8197,8315,2012,48393
15953,0,0,0,2012,48397
15954,1710,862,848,2012,48401
15955,81,41,40,2012,48411
15956,5662,2902,2760,2012,48412
15957,7478,3671,3807,2012,48413
15958,2986,1533,1453,2012,48414
15959,9707,4507,5200,2012,48415
15960,4976,2482,2494,2012,48416
15961,2830,1424,1406,2012,48417
15962,4573,2303,2270,2012,48418
15963,2716,1311,1405,2012,48419
15964,21868,10794,11074,2012,48420
15965,6800,3278,3522,2012,48421
15966,6147,3029,3118,2012,48422
15967,32457,15235,17222,2012,48423
15968,1079,534,545,2012,48426
15969,3001,1481,1520,2012,48427
15970,5044,2641,2403,2012,48428
15971,8403,4069,4334,2012,48429
15972,36668,18142,18526,2012,48430
15973,646,316,330,2012,48432
15974,26551,12341,14210,2012,48433
15975,68,31,37,2012,48434
15976,1934,967,967,2012,48435
15977,3707,1787,1920,2012,48436
15978,392,211,181,2012,48437
15979,6975,3533,3442,2012,48438
15980,48992,23881,25111,2012,48439
15981,395,125,270,2012,48440
15982,3930,2017,1913,2012,48441
15983,21404,10692,10712,2012,48442
15984,9276,4427,4849,2012,48444
15985,1380,687,693,2012,48445
15986,30874,15694,15180,2012,48446
15987,2922,1398,1524,2012,48449
15988,4719,2358,2361,2012,48450
15989,14672,7339,7333,2012,48451
15990,5107,2462,2645,2012,48453
15991,1424,742,682,2012,48454
15992,8021,4107,3914,2012,48455
15993,935,491,444,2012,48456
15994,8519,4413,4106,2012,48457
15995,21737,10564,11173,2012,48458
15996,2302,1228,1074,2012,48460
15997,8917,4727,4190,2012,48461
15998,13702,6944,6758,2012,48462
15999,4216,2047,2169,2012,48463
16000,2003,1003,1000,2012,48464
16001,589,303,286,2012,48465
16002,1615,848,767,2012,48466
16003,2286,1184,1102,2012,48467
16004,1371,679,692,2012,48468
16005,1166,569,597,2012,48469
16006,797,384,413,2012,48470
16007,5765,2757,3008,2012,48471
16008,1903,967,936,2012,48472
16009,21778,10499,11279,2012,48473
16010,2629,1318,1311,2012,48475
16011,668,317,351,2012,48476
16012,1091,792,299,2012,48502
16013,25180,12098,13082,2012,48503
16014,30329,14592,15737,2012,48504
16015,25258,11622,13636,2012,48505
16016,30181,14945,15236,2012,48506
16017,30974,14238,16736,2012,48507
16018,9973,5045,4928,2012,48509
16019,7758,3642,4116,2012,48519
16020,9487,4870,4617,2012,48529
16021,20014,9257,10757,2012,48532
16022,0,0,0,2012,48551
16023,0,0,0,2012,48553
16024,0,0,0,2012,48554
16025,38877,18133,20744,2012,48601
16026,29656,14296,15360,2012,48602
16027,26802,12514,14288,2012,48603
16028,13083,6339,6744,2012,48604
16029,1628,791,837,2012,48607
16030,12157,5843,6314,2012,48609
16031,3298,1577,1721,2012,48610
16032,7085,3497,3588,2012,48611
16033,9248,4638,4610,2012,48612
16034,1121,607,514,2012,48613
16035,1387,648,739,2012,48614
16036,3168,1558,1610,2012,48615
16037,7575,3810,3765,2012,48616
16038,8803,4121,4682,2012,48617
16039,5624,2819,2805,2012,48618
16040,420,224,196,2012,48619
16041,1167,538,629,2012,48621
16042,6254,3247,3007,2012,48622
16043,13663,7464,6199,2012,48623
16044,16052,8136,7916,2012,48624
16045,13642,6832,6810,2012,48625
16046,6113,3083,3030,2012,48626
16047,111,68,43,2012,48627
16048,1993,948,1045,2012,48628
16049,7691,3909,3782,2012,48629
16050,144,61,83,2012,48630
16051,4526,2283,2243,2012,48631
16052,4902,2465,2437,2012,48632
16053,236,87,149,2012,48633
16054,4607,2126,2481,2012,48634
16055,1676,846,830,2012,48635
16056,831,420,411,2012,48636
16057,3181,1608,1573,2012,48637
16058,12980,6192,6788,2012,48638
16059,32229,15913,16316,2012,48640
16060,32792,15782,17010,2012,48642
16061,4602,2337,2265,2012,48647
16062,1569,744,825,2012,48649
16063,6894,3494,3400,2012,48650
16064,4787,2238,2549,2012,48651
16065,1517,739,778,2012,48652
16066,10293,5103,5190,2012,48653
16067,2393,1204,1189,2012,48654
16068,6304,3251,3053,2012,48655
16069,4144,2090,2054,2012,48656
16070,7918,3954,3964,2012,48657
16071,5578,3031,2547,2012,48658
16072,2686,1350,1336,2012,48659
16073,10210,5056,5154,2012,48661
16074,1489,732,757,2012,48662
16075,0,0,0,2012,48667
16076,1306,638,668,2012,48701
16077,3058,1471,1587,2012,48703
16078,435,224,211,2012,48705
16079,40144,19377,20767,2012,48706
16080,27493,13476,14017,2012,48708
16081,0,0,0,2012,48710
16082,1055,574,481,2012,48720
16083,366,191,175,2012,48721
16084,3234,1570,1664,2012,48722
16085,12156,6097,6059,2012,48723
16086,266,155,111,2012,48724
16087,2575,1263,1312,2012,48725
16088,6417,3198,3219,2012,48726
16089,1304,725,579,2012,48727
16090,315,163,152,2012,48728
16091,1540,809,731,2012,48729
16092,4504,2088,2416,2012,48730
16093,1799,893,906,2012,48731
16094,11581,5779,5802,2012,48732
16095,1889,928,961,2012,48733
16096,7729,3635,4094,2012,48734
16097,960,486,474,2012,48735
16098,1287,649,638,2012,48737
16099,1267,649,618,2012,48738
16100,4302,2248,2054,2012,48739
16101,2528,1258,1270,2012,48740
16102,2165,1102,1063,2012,48741
16103,1620,787,833,2012,48742
16104,3,3,0,2012,48743
16105,4786,2337,2449,2012,48744
16106,1419,702,717,2012,48745
16107,8751,4374,4377,2012,48746
16108,1454,754,700,2012,48747
16109,1836,923,913,2012,48748
16110,1090,554,536,2012,48749
16111,8731,4604,4127,2012,48750
16112,928,439,489,2012,48754
16113,3124,1495,1629,2012,48755
16114,4606,2262,2344,2012,48756
16115,3946,1974,1972,2012,48757
16116,3277,1622,1655,2012,48759
16117,1274,686,588,2012,48760
16118,1008,492,516,2012,48761
16119,1133,577,556,2012,48762
16120,5355,2550,2805,2012,48763
16121,722,382,340,2012,48765
16122,1326,728,598,2012,48766
16123,2210,1118,1092,2012,48767
16124,9794,5069,4725,2012,48768
16125,1972,970,1002,2012,48770
16126,13114,6280,6834,2012,48801
16127,1698,849,849,2012,48806
16128,800,393,407,2012,48807
16129,5769,2952,2817,2012,48808
16130,11041,5519,5522,2012,48809
16131,5602,3699,1903,2012,48811
16132,21121,10331,10790,2012,48813
16133,2438,1265,1173,2012,48815
16134,31,19,12,2012,48816
16135,6597,3147,3450,2012,48817
16136,2220,1162,1058,2012,48818
16137,2763,1452,1311,2012,48819
16138,17227,8571,8656,2012,48820
16139,5862,3041,2821,2012,48821
16140,2666,1340,1326,2012,48822
16141,48961,24512,24449,2012,48823
16142,14344,7079,7265,2012,48825
16143,16063,7916,8147,2012,48827
16144,3309,1639,1670,2012,48829
16145,3473,1796,1677,2012,48831
16146,1234,602,632,2012,48832
16147,2207,1112,1095,2012,48834
16148,2691,1385,1306,2012,48835
16149,13600,6811,6789,2012,48836
16150,18511,8589,9922,2012,48837
16151,17774,8910,8864,2012,48838
16152,12952,6022,6930,2012,48840
16153,936,504,432,2012,48841
16154,20297,9510,10787,2012,48842
16155,43422,21241,22181,2012,48843
16156,940,517,423,2012,48845
16157,20611,12074,8537,2012,48846
16158,5886,2897,2989,2012,48847
16159,7306,3553,3753,2012,48848
16160,5727,3037,2690,2012,48849
16161,4460,2330,2130,2012,48850
16162,2621,1546,1075,2012,48851
16163,75,41,34,2012,48852
16164,594,287,307,2012,48853
16165,18277,9221,9056,2012,48854
16166,14251,7179,7072,2012,48855
16167,938,474,464,2012,48856
16168,2489,1191,1298,2012,48857
16169,49470,23848,25622,2012,48858
16170,1238,593,645,2012,48860
16171,1652,783,869,2012,48861
16172,19547,9214,10333,2012,48864
16173,1693,911,782,2012,48865
16174,5076,2427,2649,2012,48866
16175,27928,13752,14176,2012,48867
16176,190,114,76,2012,48870
16177,2001,1023,978,2012,48871
16178,7534,3791,3743,2012,48872
16179,1443,674,769,2012,48873
16180,268,133,135,2012,48874
16181,10458,5082,5376,2012,48875
16182,3966,1967,1999,2012,48876
16183,2521,1334,1187,2012,48877
16184,1645,788,857,2012,48878
16185,18143,8855,9288,2012,48879
16186,10531,6724,3807,2012,48880
16187,5151,2465,2686,2012,48881
16188,7303,3527,3776,2012,48883
16189,4429,2257,2172,2012,48884
16190,1051,554,497,2012,48885
16191,2128,1143,985,2012,48886
16192,6316,3165,3151,2012,48888
16193,1444,701,743,2012,48889
16194,1933,950,983,2012,48890
16195,2987,1457,1530,2012,48891
16196,4597,2576,2021,2012,48892
16197,5412,2702,2710,2012,48893
16198,2083,1017,1066,2012,48894
16199,11490,5379,6111,2012,48895
16200,179,83,96,2012,48896
16201,1652,851,801,2012,48897
16202,25729,12518,13211,2012,48906
16203,35035,16827,18208,2012,48910
16204,40732,19391,21341,2012,48911
16205,17665,8246,9419,2012,48912
16206,8759,4241,4518,2012,48915
16207,32142,15350,16792,2012,48917
16208,0,0,0,2012,48921
16209,2506,1442,1064,2012,48933
16210,22219,11020,11199,2012,49001
16211,19581,9920,9661,2012,49002
16212,15613,7464,8149,2012,49004
16213,26733,13405,13328,2012,49006
16214,9509,4730,4779,2012,49007
16215,17500,8067,9433,2012,49008
16216,42595,20904,21691,2012,49009
16217,17558,8708,8850,2012,49010
16218,2187,1038,1149,2012,49011
16219,3346,1774,1572,2012,49012
16220,4785,2439,2346,2012,49013
16221,22088,10937,11151,2012,49014
16222,26684,12592,14092,2012,49015
16223,20243,9975,10268,2012,49017
16224,6053,3067,2986,2012,49021
16225,31782,14758,17024,2012,49022
16226,28190,13405,14785,2012,49024
16227,2289,1121,1168,2012,49026
16228,106,49,57,2012,49027
16229,6164,3173,2991,2012,49028
16230,1628,734,894,2012,49029
16231,2367,1205,1162,2012,49030
16232,7507,3830,3677,2012,49031
16233,3753,1805,1948,2012,49032
16234,2127,1054,1073,2012,49033
16235,2129,1044,1085,2012,49034
16236,24311,12980,11331,2012,49036
16237,22581,11150,11431,2012,49037
16238,9005,4420,4585,2012,49038
16239,3285,1645,1640,2012,49040
16240,4614,2269,2345,2012,49042
16241,2719,1334,1385,2012,49043
16242,6087,3010,3077,2012,49045
16243,7352,3711,3641,2012,49046
16244,14851,7302,7549,2012,49047
16245,25399,12305,13094,2012,49048
16246,1697,917,780,2012,49050
16247,2704,1352,1352,2012,49051
16248,1160,574,586,2012,49052
16249,6648,3346,3302,2012,49053
16250,6368,3228,3140,2012,49055
16251,4481,2330,2151,2012,49056
16252,6930,3491,3439,2012,49057
16253,19009,9241,9768,2012,49058
16254,1978,966,1012,2012,49060
16255,1355,690,665,2012,49061
16256,3676,1749,1927,2012,49064
16257,6745,3453,3292,2012,49065
16258,564,277,287,2012,49066
16259,4682,2267,2415,2012,49067
16260,14424,7090,7334,2012,49068
16261,2500,1316,1184,2012,49070
16262,9239,4394,4845,2012,49071
16263,3020,1550,1470,2012,49072
16264,4734,2448,2286,2012,49073
16265,238,41,197,2012,49074
16266,53,23,30,2012,49075
16267,4342,2377,1965,2012,49076
16268,8942,4362,4580,2012,49078
16269,12890,6367,6523,2012,49079
16270,15373,7773,7600,2012,49080
16271,6788,3358,3430,2012,49082
16272,7186,3231,3955,2012,49083
16273,28,22,6,2012,49084
16274,23870,11785,12085,2012,49085
16275,6418,3221,3197,2012,49087
16276,3503,1792,1711,2012,49088
16277,1761,920,841,2012,49089
16278,14195,6632,7563,2012,49090
16279,19887,9805,10082,2012,49091
16280,2142,1051,1091,2012,49092
16281,18395,8881,9514,2012,49093
16282,4093,1943,2150,2012,49094
16283,2061,1091,970,2012,49095
16284,3329,1666,1663,2012,49096
16285,9967,5213,4754,2012,49097
16286,6289,3198,3091,2012,49098
16287,5784,3086,2698,2012,49099
16288,3111,1521,1590,2012,49101
16289,1457,731,726,2012,49102
16290,11273,5556,5717,2012,49103
16291,593,276,317,2012,49104
16292,4854,2274,2580,2012,49106
16293,10467,5063,5404,2012,49107
16294,3614,1861,1753,2012,49111
16295,10272,5128,5144,2012,49112
16296,1786,916,870,2012,49113
16297,170,47,123,2012,49115
16298,347,170,177,2012,49116
16299,3703,1826,1877,2012,49117
16300,107,60,47,2012,49119
16301,37262,17929,19333,2012,49120
16302,1848,962,886,2012,49125
16303,1435,700,735,2012,49126
16304,10389,5357,5032,2012,49127
16305,4111,2042,2069,2012,49128
16306,347,173,174,2012,49129
16307,2182,1138,1044,2012,49130
16308,45146,25455,19691,2012,49201
16309,21235,9967,11268,2012,49202
16310,38037,18359,19678,2012,49203
16311,2508,1231,1277,2012,49220
16312,42267,21543,20724,2012,49221
16313,14683,7180,7503,2012,49224
16314,1173,631,542,2012,49227
16315,5718,2813,2905,2012,49228
16316,2946,1477,1469,2012,49229
16317,9787,4823,4964,2012,49230
16318,3059,1466,1593,2012,49232
16319,2721,1509,1212,2012,49233
16320,2766,1375,1391,2012,49234
16321,2070,1040,1030,2012,49235
16322,4653,2457,2196,2012,49236
16323,3007,1616,1391,2012,49237
16324,1736,856,880,2012,49238
16325,9058,4517,4541,2012,49240
16326,2306,1061,1245,2012,49241
16327,15100,7287,7813,2012,49242
16328,4798,2431,2367,2012,49245
16329,3398,1809,1589,2012,49246
16330,5503,2627,2876,2012,49247
16331,813,397,416,2012,49248
16332,3429,1623,1806,2012,49249
16333,5817,2884,2933,2012,49250
16334,6575,3541,3034,2012,49251
16335,2442,1225,1217,2012,49252
16336,3061,1586,1475,2012,49253
16337,3790,2040,1750,2012,49254
16338,1955,1031,924,2012,49255
16339,3852,1941,1911,2012,49256
16340,2147,1180,967,2012,49259
16341,274,139,135,2012,49261
16342,1317,683,634,2012,49262
16343,0,0,0,2012,49263
16344,1983,934,1049,2012,49264
16345,5153,2691,2462,2012,49265
16346,2845,1530,1315,2012,49266
16347,4226,2013,2213,2012,49267
16348,1010,486,524,2012,49268
16349,5863,2990,2873,2012,49269
16350,5872,3009,2863,2012,49270
16351,2321,1127,1194,2012,49271
16352,2114,996,1118,2012,49272
16353,3776,1935,1841,2012,49274
16354,1162,576,586,2012,49276
16355,3473,1719,1754,2012,49277
16356,668,349,319,2012,49279
16357,331,197,134,2012,49282
16358,4298,1836,2462,2012,49283
16359,3278,1815,1463,2012,49284
16360,5781,2816,2965,2012,49285
16361,14559,7018,7541,2012,49286
16362,2045,1073,972,2012,49287
16363,1772,892,880,2012,49288
16364,164,94,70,2012,49289
16365,18990,9513,9477,2012,49301
16366,7830,4006,3824,2012,49302
16367,1055,537,518,2012,49303
16368,4169,2157,2012,2012,49304
16369,2198,1125,1073,2012,49305
16370,10015,4899,5116,2012,49306
16371,20565,10413,10152,2012,49307
16372,1635,846,789,2012,49309
16373,2803,1374,1429,2012,49310
16374,202,98,104,2012,49312
16375,19552,9461,10091,2012,49315
16376,20081,9664,10417,2012,49316
16377,1523,799,724,2012,49318
16378,15674,8088,7586,2012,49319
16379,75,26,49,2012,49320
16380,15792,7436,8356,2012,49321
16381,1306,632,674,2012,49322
16382,9457,4810,4647,2012,49323
16383,1683,849,834,2012,49325
16384,3928,2029,1899,2012,49326
16385,8661,4384,4277,2012,49327
16386,4264,2171,2093,2012,49328
16387,8624,4318,4306,2012,49329
16388,5356,2835,2521,2012,49330
16389,16666,8155,8511,2012,49331
16390,2945,1433,1512,2012,49332
16391,11126,5351,5775,2012,49333
16392,466,243,223,2012,49335
16393,4666,2307,2359,2012,49336
16394,11665,5968,5697,2012,49337
16395,1681,943,738,2012,49338
16396,2513,1200,1313,2012,49339
16397,3000,1556,1444,2012,49340
16398,33697,16606,17091,2012,49341
16399,1654,778,876,2012,49342
16400,5277,2484,2793,2012,49343
16401,3567,1874,1693,2012,49344
16402,13800,6624,7176,2012,49345
16403,5369,2663,2706,2012,49346
16404,1186,652,534,2012,49347
16405,12169,6202,5967,2012,49348
16406,8399,4296,4103,2012,49349
16407,19437,9007,10430,2012,49401
16408,1379,717,662,2012,49402
16409,2289,1172,1117,2012,49403
16410,8724,4459,4265,2012,49404
16411,1570,839,731,2012,49405
16412,810,410,400,2012,49406
16413,8848,4438,4410,2012,49408
16414,2080,1012,1068,2012,49410
16415,1576,834,742,2012,49411
16416,11228,5430,5798,2012,49412
16417,6530,3422,3108,2012,49415
16418,29669,14415,15254,2012,49417
16419,27476,13624,13852,2012,49418
16420,8001,4114,3887,2012,49419
16421,7450,3745,3705,2012,49420
16422,5857,3055,2802,2012,49421
16423,45359,21442,23917,2012,49423
16424,44193,21930,22263,2012,49424
16425,3519,1737,1782,2012,49425
16426,33896,16905,16991,2012,49426
16427,26127,12581,13546,2012,49428
16428,16810,8107,8703,2012,49431
16429,0,0,0,2012,49434
16430,3135,1603,1532,2012,49435
16431,1406,785,621,2012,49436
16432,6938,3237,3701,2012,49437
16433,1149,520,629,2012,49440
16434,36654,17433,19221,2012,49441
16435,42775,22205,20570,2012,49442
16436,26882,13073,13809,2012,49444
16437,20539,10160,10379,2012,49445
16438,2461,1205,1256,2012,49446
16439,3256,1615,1641,2012,49448
16440,2371,1120,1251,2012,49449
16441,2938,1543,1395,2012,49450
16442,6260,3207,3053,2012,49451
16443,1668,886,782,2012,49452
16444,2409,1143,1266,2012,49453
16445,4727,2391,2336,2012,49454
16446,4781,2357,2424,2012,49455
16447,18972,8726,10246,2012,49456
16448,10847,5403,5444,2012,49457
16449,39,17,22,2012,49458
16450,1250,624,626,2012,49459
16451,8738,4720,4018,2012,49460
16452,8825,4340,4485,2012,49461
16453,27226,13490,13736,2012,49464
16454,34625,17827,16798,2012,49503
16455,39832,19776,20056,2012,49504
16456,31093,14828,16265,2012,49505
16457,33171,16172,16999,2012,49506
16458,37871,18269,19602,2012,49507
16459,40101,19001,21100,2012,49508
16460,26074,13308,12766,2012,49509
16461,15377,7573,7804,2012,49512
16462,27888,13457,14431,2012,49519
16463,27113,12989,14124,2012,49525
16464,21777,10576,11201,2012,49534
16465,8781,4424,4357,2012,49544
16466,31145,15021,16124,2012,49546
16467,30155,15161,14994,2012,49548
16468,21502,10530,10972,2012,49601
16469,210,98,112,2012,49611
16470,1222,634,588,2012,49612
16471,590,277,313,2012,49613
16472,2987,1528,1459,2012,49614
16473,4235,2058,2177,2012,49615
16474,1928,995,933,2012,49616
16475,3376,1726,1650,2012,49617
16476,719,413,306,2012,49618
16477,895,474,421,2012,49619
16478,2460,1231,1229,2012,49620
16479,2983,1515,1468,2012,49621
16480,2612,1349,1263,2012,49622
16481,1224,653,571,2012,49623
16482,1306,691,615,2012,49625
16483,496,227,269,2012,49626
16484,113,55,58,2012,49627
16485,301,157,144,2012,49628
16486,2344,1072,1272,2012,49629
16487,1302,638,664,2012,49630
16488,5801,2964,2837,2012,49631
16489,1111,544,567,2012,49632
16490,3439,1802,1637,2012,49633
16491,160,85,75,2012,49634
16492,3692,1788,1904,2012,49635
16493,457,237,220,2012,49636
16494,3618,1878,1740,2012,49637
16495,758,389,369,2012,49638
16496,2847,1352,1495,2012,49639
16497,1567,742,825,2012,49640
16498,855,376,479,2012,49642
16499,5978,3024,2954,2012,49643
16500,1716,847,869,2012,49644
16501,1616,845,771,2012,49645
16502,8274,4152,4122,2012,49646
16503,2064,974,1090,2012,49648
16504,7854,4560,3294,2012,49649
16505,3252,1654,1598,2012,49650
16506,7528,3730,3798,2012,49651
16507,1956,941,1015,2012,49653
16508,642,363,279,2012,49654
16509,3118,1554,1564,2012,49655
16510,1376,736,640,2012,49656
16511,3776,1943,1833,2012,49657
16512,6756,3504,3252,2012,49659
16513,13872,7387,6485,2012,49660
16514,6204,3167,3037,2012,49663
16515,2234,1132,1102,2012,49664
16516,4294,2176,2118,2012,49665
16517,62,33,29,2012,49666
16518,637,366,271,2012,49667
16519,3335,1815,1520,2012,49668
16520,1911,957,954,2012,49670
16521,158,65,93,2012,49674
16522,1176,528,648,2012,49675
16523,3372,1791,1581,2012,49676
16524,7408,3647,3761,2012,49677
16525,1426,718,708,2012,49679
16526,1997,941,1056,2012,49680
16527,4275,2048,2227,2012,49682
16528,2109,1031,1078,2012,49683
16529,37672,17948,19724,2012,49684
16530,32553,15646,16907,2012,49686
16531,2486,1314,1172,2012,49688
16532,1594,809,785,2012,49689
16533,6125,3128,2997,2012,49690
16534,1034,489,545,2012,49701
16535,1019,529,490,2012,49705
16536,4677,2288,2389,2012,49706
16537,22478,10995,11483,2012,49707
16538,3727,1943,1784,2012,49709
16539,348,200,148,2012,49710
16540,8076,3941,4135,2012,49712
16541,2042,984,1058,2012,49713
16542,2969,1486,1483,2012,49715
16543,866,456,410,2012,49716
16544,58,24,34,2012,49717
16545,752,398,354,2012,49718
16546,1337,728,609,2012,49719
16547,9319,4542,4777,2012,49720
16548,14386,7053,7333,2012,49721
16549,202,89,113,2012,49722
16550,1245,657,588,2012,49724
16551,680,351,329,2012,49725
16552,1015,532,483,2012,49726
16553,7168,3596,3572,2012,49727
16554,356,184,172,2012,49728
16555,1590,775,815,2012,49729
16556,2113,1129,984,2012,49730
16557,1901,986,915,2012,49733
16558,19640,9632,10008,2012,49735
16559,501,238,263,2012,49736
16560,9962,5116,4846,2012,49738
16561,6805,3359,3446,2012,49740
16562,786,383,403,2012,49743
16563,822,427,395,2012,49744
16564,1264,653,611,2012,49745
16565,3700,1912,1788,2012,49746
16566,1784,860,924,2012,49747
16567,138,69,69,2012,49748
16568,4166,2107,2059,2012,49749
16569,1747,856,891,2012,49751
16570,891,613,278,2012,49752
16571,2339,1166,1173,2012,49753
16572,1989,1018,971,2012,49755
16573,3792,1833,1959,2012,49756
16574,396,123,273,2012,49757
16575,1612,857,755,2012,49759
16576,600,275,325,2012,49760
16577,585,289,296,2012,49762
16578,156,106,50,2012,49764
16579,3998,1942,2056,2012,49765
16580,2455,1228,1227,2012,49766
16581,471,254,217,2012,49768
16582,1617,797,820,2012,49769
16583,17011,8346,8665,2012,49770
16584,1895,1034,861,2012,49774
16585,74,40,34,2012,49775
16586,1868,927,941,2012,49776
16587,1610,847,763,2012,49777
16588,4753,2338,2415,2012,49779
16589,1836,894,942,2012,49780
16590,4383,2199,2184,2012,49781
16591,543,264,279,2012,49782
16592,19991,10184,9807,2012,49783
16593,6567,5004,1563,2012,49788
16594,264,127,137,2012,49791
16595,433,235,198,2012,49793
16596,2137,1042,1095,2012,49795
16597,238,99,139,2012,49796
16598,2458,1288,1170,2012,49799
16599,11266,5747,5519,2012,49801
16600,6462,2952,3510,2012,49802
16601,295,160,135,2012,49805
16602,547,257,290,2012,49806
16603,3343,1715,1628,2012,49807
16604,228,124,104,2012,49808
16605,847,424,423,2012,49812
16606,1473,782,691,2012,49814
16607,628,342,286,2012,49815
16608,914,455,459,2012,49816
16609,538,272,266,2012,49817
16610,959,490,469,2012,49818
16611,61,34,27,2012,49819
16612,236,141,95,2012,49820
16613,1348,714,634,2012,49821
16614,224,106,118,2012,49822
16615,334,184,150,2012,49825
16616,135,77,58,2012,49826
16617,924,470,454,2012,49827
16618,17371,8385,8986,2012,49829
16619,784,411,373,2012,49831
16620,288,153,135,2012,49833
16621,253,136,117,2012,49834
16622,798,389,409,2012,49835
16623,1032,550,482,2012,49836
16624,9658,4762,4896,2012,49837
16625,525,275,250,2012,49838
16626,387,182,205,2012,49839
16627,806,424,382,2012,49840
16628,7181,3816,3365,2012,49841
16629,824,375,449,2012,49847
16630,132,65,67,2012,49848
16631,12536,5910,6626,2012,49849
16632,100,43,57,2012,49852
16633,1520,788,732,2012,49853
16634,6438,3120,3318,2012,49854
16635,33563,17208,16355,2012,49855
16636,12004,6054,5950,2012,49858
16637,522,243,279,2012,49861
16638,4792,2560,2232,2012,49862
16639,98,57,41,2012,49863
16640,65,45,20,2012,49864
16641,7952,3907,4045,2012,49866
16642,5129,3056,2073,2012,49868
16643,3402,1639,1763,2012,49870
16644,761,418,343,2012,49871
16645,237,107,130,2012,49872
16646,166,79,87,2012,49873
16647,1162,569,593,2012,49874
16648,1227,577,650,2012,49876
16649,33,19,14,2012,49877
16650,3581,1920,1661,2012,49878
16651,896,410,486,2012,49879
16652,1144,600,544,2012,49880
16653,348,187,161,2012,49881
16654,89,47,42,2012,49883
16655,812,535,277,2012,49884
16656,1649,896,753,2012,49885
16657,447,236,211,2012,49886
16658,2730,1345,1385,2012,49887
16659,613,310,303,2012,49891
16660,1899,993,906,2012,49892
16661,1988,1050,938,2012,49893
16662,669,317,352,2012,49894
16663,744,545,199,2012,49895
16664,1592,763,829,2012,49896
16665,272,121,151,2012,49901
16666,101,41,60,2012,49902
16667,162,71,91,2012,49903
16668,1876,1005,871,2012,49905
16669,3542,2426,1116,2012,49908
16670,378,180,198,2012,49910
16671,2944,1428,1516,2012,49911
16672,948,518,430,2012,49912
16673,7434,3808,3626,2012,49913
16674,579,283,296,2012,49915
16675,2775,1470,1305,2012,49916
16676,236,112,124,2012,49917
16677,132,61,71,2012,49918
16678,249,120,129,2012,49919
16679,4222,2122,2100,2012,49920
16680,261,133,128,2012,49921
16681,813,414,399,2012,49922
16682,503,270,233,2012,49925
16683,352,159,193,2012,49927
16684,239,142,97,2012,49929
16685,7036,3670,3366,2012,49930
16686,9824,6090,3734,2012,49931
16687,1077,433,644,2012,49934
16688,6402,3198,3204,2012,49935
16689,7870,3901,3969,2012,49938
16690,124,41,83,2012,49942
16691,2454,1208,1246,2012,49945
16692,3965,1870,2095,2012,49946
16693,1843,1501,342,2012,49947
16694,573,321,252,2012,49948
16695,1304,713,591,2012,49950
16696,144,103,41,2012,49952
16697,2964,1510,1454,2012,49953
16698,431,251,180,2012,49955
16699,1206,594,612,2012,49958
16700,414,220,194,2012,49959
16701,123,58,65,2012,49960
16702,89,41,48,2012,49961
16703,159,87,72,2012,49962
16704,861,494,367,2012,49963
16705,433,223,210,2012,49965
16706,513,262,251,2012,49967
16707,2153,1077,1076,2012,49968
16708,1211,581,630,2012,49969
16709,237,115,122,2012,49970
16710,402,204,198,2012,49971
16711,866,458,408,2012,50001
16712,1479,767,712,2012,50002
16713,6506,3124,3382,2012,50003
16714,849,541,308,2012,50005
16715,1655,819,836,2012,50006
16716,710,360,350,2012,50007
16717,867,419,448,2012,50008
16718,16367,8039,8328,2012,50009
16719,29522,14887,14635,2012,50010
16720,1952,1011,941,2012,50011
16721,3611,2304,1307,2012,50012
16722,27746,14814,12932,2012,50014
16723,1627,735,892,2012,50020
16724,21132,10617,10515,2012,50021
16725,8273,4042,4231,2012,50022
16726,28105,14259,13846,2012,50023
16727,3325,1608,1717,2012,50025
16728,594,351,243,2012,50026
16729,359,181,178,2012,50027
16730,1756,850,906,2012,50028
16731,713,371,342,2012,50029
16732,414,240,174,2012,50032
16733,29,23,6,2012,50033
16734,367,187,180,2012,50034
16735,5545,2864,2681,2012,50035
16736,16258,7896,8362,2012,50036
16737,192,96,96,2012,50038
16738,454,239,215,2012,50039
16739,67,29,38,2012,50041
16740,319,157,162,2012,50042
16741,1092,568,524,2012,50044
16742,1445,696,749,2012,50046
16743,5480,2717,2763,2012,50047
16744,862,433,429,2012,50048
16745,6481,3158,3323,2012,50049
16746,589,287,302,2012,50050
16747,312,146,166,2012,50051
16748,245,112,133,2012,50052
16749,3646,1766,1880,2012,50054
16750,857,452,405,2012,50055
16751,1367,753,614,2012,50056
16752,228,113,115,2012,50057
16753,1997,1017,980,2012,50058
16754,2473,1133,1340,2012,50060
16755,1788,838,950,2012,50061
16756,672,318,354,2012,50062
16757,2870,1472,1398,2012,50063
16758,101,51,50,2012,50064
16759,581,298,283,2012,50065
16760,258,132,126,2012,50066
16761,422,221,201,2012,50067
16762,470,241,229,2012,50068
16763,1263,665,598,2012,50069
16764,1424,692,732,2012,50070
16765,924,487,437,2012,50071
16766,2878,1496,1382,2012,50072
16767,955,521,434,2012,50073
16768,304,146,158,2012,50074
16769,934,428,506,2012,50075
16770,1430,670,760,2012,50076
16771,128,63,65,2012,50078
16772,59,38,21,2012,50101
16773,52,32,20,2012,50102
16774,471,238,233,2012,50103
16775,138,76,62,2012,50104
16776,1276,709,567,2012,50105
16777,879,387,492,2012,50106
16778,1116,574,542,2012,50107
16779,551,248,303,2012,50108
16780,2685,1376,1309,2012,50109
16781,9649,4640,5009,2012,50111
16782,11701,5466,6235,2012,50112
16783,2864,1370,1494,2012,50115
16784,180,88,92,2012,50116
16785,216,98,118,2012,50117
16786,903,442,461,2012,50118
16787,498,260,238,2012,50119
16788,296,175,121,2012,50120
16789,1510,762,748,2012,50122
16790,775,390,385,2012,50123
16791,3728,1778,1950,2012,50124
16792,19536,9229,10307,2012,50125
16793,6822,3434,3388,2012,50126
16794,0,0,0,2012,50127
16795,368,173,195,2012,50128
16796,5230,2520,2710,2012,50129
16797,1514,728,786,2012,50130
16798,17364,8201,9163,2012,50131
16799,313,180,133,2012,50132
16800,522,307,215,2012,50133
16801,573,288,285,2012,50134
16802,1659,891,768,2012,50135
16803,401,191,210,2012,50136
16804,11700,5832,5868,2012,50138
16805,1391,739,652,2012,50139
16806,3074,1512,1562,2012,50140
16807,541,277,264,2012,50141
16808,934,459,475,2012,50142
16809,633,341,292,2012,50143
16810,2696,1382,1314,2012,50144
16811,380,209,171,2012,50146
16812,365,173,192,2012,50147
16813,368,188,180,2012,50148
16814,878,385,493,2012,50149
16815,1164,569,595,2012,50150
16816,660,335,325,2012,50151
16817,903,490,413,2012,50153
16818,571,327,244,2012,50154
16819,254,125,129,2012,50155
16820,4213,2033,2180,2012,50156
16821,620,332,288,2012,50157
16822,31524,15703,15821,2012,50158
16823,493,224,269,2012,50160
16824,2013,1000,1013,2012,50161
16825,1210,633,577,2012,50162
16826,955,406,549,2012,50163
16827,578,262,316,2012,50164
16828,75,30,45,2012,50165
16829,1650,803,847,2012,50166
16830,549,283,266,2012,50167
16831,792,430,362,2012,50168
16832,3651,1572,2079,2012,50169
16833,2790,1529,1261,2012,50170
16834,2951,1535,1416,2012,50171
16835,783,407,376,2012,50173
16836,1345,681,664,2012,50174
16837,8021,4080,3941,2012,50201
16838,423,230,193,2012,50206
16839,2473,1250,1223,2012,50207
16840,20550,10593,9957,2012,50208
16841,1647,867,780,2012,50210
16842,11385,5572,5813,2012,50211
16843,3448,1765,1683,2012,50212
16844,6877,3456,3421,2012,50213
16845,656,312,344,2012,50214
16846,2707,1258,1449,2012,50216
16847,722,350,372,2012,50217
16848,84,35,49,2012,50218
16849,14335,7089,7246,2012,50219
16850,8985,4632,4353,2012,50220
16851,628,353,275,2012,50222
16852,498,252,246,2012,50223
16853,2864,1391,1473,2012,50225
16854,5018,2489,2529,2012,50226
16855,21,16,5,2012,50227
16856,1916,883,1033,2012,50228
16857,783,382,401,2012,50229
16858,1125,619,506,2012,50230
16859,144,72,72,2012,50231
16860,449,232,217,2012,50232
16861,1214,612,602,2012,50233
16862,525,233,292,2012,50234
16863,500,260,240,2012,50235
16864,1635,820,815,2012,50236
16865,2827,1451,1376,2012,50237
16866,1086,565,521,2012,50238
16867,199,101,98,2012,50239
16868,2673,1460,1213,2012,50240
16869,413,213,200,2012,50242
16870,225,109,116,2012,50243
16871,1991,1039,952,2012,50244
16872,706,340,366,2012,50246
16873,2250,1129,1121,2012,50247
16874,4555,2088,2467,2012,50248
16875,1230,635,595,2012,50249
16876,2510,1364,1146,2012,50250
16877,1211,659,552,2012,50251
16878,129,66,63,2012,50252
16879,339,186,153,2012,50254
16880,52,21,31,2012,50255
16881,630,322,308,2012,50256
16882,822,427,395,2012,50257
16883,1035,455,580,2012,50258
16884,2565,1253,1312,2012,50261
16885,410,192,218,2012,50262
16886,16195,7877,8318,2012,50263
16887,383,188,195,2012,50264
16888,31733,16138,15595,2012,50265
16889,23905,11869,12036,2012,50266
16890,1060,502,558,2012,50268
16891,861,406,455,2012,50271
16892,133,88,45,2012,50272
16893,8284,3938,4346,2012,50273
16894,376,223,153,2012,50274
16895,633,359,274,2012,50275
16896,2608,1421,1187,2012,50276
16897,333,131,202,2012,50277
16898,928,457,471,2012,50278
16899,5315,3072,2243,2012,50309
16900,30029,14519,15510,2012,50310
16901,15013,7491,7522,2012,50311
16902,15373,7144,8229,2012,50312
16903,17542,8722,8820,2012,50313
16904,12006,5914,6092,2012,50314
16905,35930,17465,18465,2012,50315
16906,16976,8123,8853,2012,50316
16907,35686,18046,17640,2012,50317
16908,0,0,0,2012,50319
16909,20259,9307,10952,2012,50320
16910,8156,3913,4243,2012,50321
16911,31085,14557,16528,2012,50322
16912,10331,4918,5413,2012,50323
16913,4857,2381,2476,2012,50324
16914,15658,7612,8046,2012,50325
16915,10268,5059,5209,2012,50327
16916,29617,14187,15430,2012,50401
16917,297,146,151,2012,50420
16918,2729,1353,1376,2012,50421
16919,3072,1493,1579,2012,50423
16920,1483,782,701,2012,50424
16921,54,35,19,2012,50426
16922,9283,4479,4804,2012,50428
16923,463,247,216,2012,50430
16924,414,217,197,2012,50431
16925,209,92,117,2012,50432
16926,242,115,127,2012,50433
16927,413,209,204,2012,50434
16928,517,266,251,2012,50435
16929,5733,2758,2975,2012,50436
16930,3918,2028,1890,2012,50438
16931,468,254,214,2012,50439
16932,407,220,187,2012,50440
16933,5834,2811,3023,2012,50441
16934,408,226,182,2012,50444
16935,604,316,288,2012,50446
16936,1270,578,692,2012,50447
16937,611,317,294,2012,50448
16938,808,412,396,2012,50449
16939,2524,1226,1298,2012,50450
16940,471,212,259,2012,50451
16941,950,548,402,2012,50452
16942,754,373,381,2012,50453
16943,163,72,91,2012,50454
16944,413,228,185,2012,50455
16945,1749,848,901,2012,50456
16946,473,222,251,2012,50457
16947,2039,1001,1038,2012,50458
16948,2947,1438,1509,2012,50459
16949,169,80,89,2012,50460
16950,5642,2711,2931,2012,50461
16951,776,402,374,2012,50464
16952,250,147,103,2012,50465
16953,1985,994,991,2012,50466
16954,67,34,33,2012,50467
16955,1663,882,781,2012,50468
16956,1482,766,716,2012,50469
16957,262,138,124,2012,50470
16958,735,351,384,2012,50471
16959,2568,1330,1238,2012,50472
16960,228,140,88,2012,50473
16961,1686,865,821,2012,50475
16962,748,320,428,2012,50476
16963,393,224,169,2012,50477
16964,1017,502,515,2012,50478
16965,656,346,310,2012,50479
16966,777,373,404,2012,50480
16967,895,426,469,2012,50482
16968,833,452,381,2012,50483
16969,389,197,192,2012,50484
16970,28659,14458,14201,2012,50501
16971,1035,547,488,2012,50510
16972,7006,3373,3633,2012,50511
16973,1541,747,794,2012,50514
16974,222,126,96,2012,50515
16975,616,319,297,2012,50516
16976,1200,564,636,2012,50517
16977,443,241,202,2012,50518
16978,592,300,292,2012,50519
16979,137,82,55,2012,50520
16980,41,23,18,2012,50521
16981,753,337,416,2012,50522
16982,793,454,339,2012,50523
16983,462,234,228,2012,50524
16984,3590,1701,1889,2012,50525
16985,221,100,121,2012,50527
16986,508,316,192,2012,50528
16987,779,379,400,2012,50529
16988,1315,672,643,2012,50530
16989,291,114,177,2012,50531
16990,930,450,480,2012,50532
16991,3998,2035,1963,2012,50533
16992,813,411,402,2012,50535
16993,4619,2251,2368,2012,50536
16994,441,210,231,2012,50538
16995,609,314,295,2012,50539
16996,955,438,517,2012,50540
16997,885,413,472,2012,50541
16998,1027,522,505,2012,50542
16999,1650,888,762,2012,50543
17000,624,355,269,2012,50544
17001,247,135,112,2012,50545
17002,367,216,151,2012,50546
17003,5935,2840,3095,2012,50548
17004,97,50,47,2012,50551
17005,1620,850,770,2012,50554
17006,271,152,119,2012,50556
17007,843,458,385,2012,50557
17008,730,372,358,2012,50558
17009,318,172,146,2012,50559
17010,576,288,288,2012,50560
17011,513,246,267,2012,50561
17012,560,298,262,2012,50562
17013,2578,1265,1313,2012,50563
17014,603,279,324,2012,50565
17015,275,132,143,2012,50566
17016,196,118,78,2012,50567
17017,1434,692,742,2012,50568
17018,812,410,402,2012,50569
17019,202,89,113,2012,50570
17020,321,169,152,2012,50571
17021,77,37,40,2012,50573
17022,2188,1101,1087,2012,50574
17023,1050,492,558,2012,50575
17024,439,262,177,2012,50576
17025,342,183,159,2012,50577
17026,685,346,339,2012,50578
17027,2939,1638,1301,2012,50579
17028,991,491,500,2012,50581
17029,160,101,59,2012,50582
17030,2647,1349,1298,2012,50583
17031,891,447,444,2012,50585
17032,283,101,182,2012,50586
17033,12824,6561,6263,2012,50588
17034,918,431,487,2012,50590
17035,283,128,155,2012,50591
17036,46,22,24,2012,50593
17037,256,135,121,2012,50594
17038,9115,4522,4593,2012,50595
17039,1147,614,533,2012,50597
17040,1056,554,502,2012,50598
17041,510,195,315,2012,50599
17042,2413,1117,1296,2012,50601
17043,1627,815,812,2012,50602
17044,707,393,314,2012,50603
17045,1604,766,838,2012,50604
17046,144,67,77,2012,50605
17047,1005,497,508,2012,50606
17048,692,392,300,2012,50607
17049,456,231,225,2012,50609
17050,377,218,159,2012,50611
17051,345,165,180,2012,50612
17052,42067,20144,21923,2012,50613
17053,10562,5022,5540,2012,50616
17054,2460,1215,1245,2012,50619
17055,52,25,27,2012,50620
17056,1651,851,800,2012,50621
17057,3108,1550,1558,2012,50622
17058,1817,885,932,2012,50624
17059,1232,645,587,2012,50625
17060,1716,881,835,2012,50626
17061,3530,1820,1710,2012,50627
17062,1538,810,728,2012,50628
17063,2523,1267,1256,2012,50629
17064,1733,885,848,2012,50630
17065,1164,591,573,2012,50632
17066,402,216,186,2012,50633
17067,803,419,384,2012,50634
17068,1818,940,878,2012,50635
17069,1924,950,974,2012,50636
17070,3179,1451,1728,2012,50638
17071,1758,902,856,2012,50641
17072,753,407,346,2012,50642
17073,2706,1416,1290,2012,50643
17074,8190,3950,4240,2012,50644
17075,942,475,467,2012,50645
17076,1919,1060,859,2012,50647
17077,4554,2226,2328,2012,50648
17078,648,319,329,2012,50650
17079,3927,2013,1914,2012,50651
17080,101,39,62,2012,50652
17081,677,383,294,2012,50653
17082,399,174,225,2012,50654
17083,708,372,336,2012,50655
17084,2620,1264,1356,2012,50658
17085,5808,2941,2867,2012,50659
17086,1394,673,721,2012,50660
17087,7218,3526,3692,2012,50662
17088,15,5,10,2012,50664
17089,2690,1252,1438,2012,50665
17090,976,503,473,2012,50666
17091,818,442,376,2012,50667
17092,1353,710,643,2012,50668
17093,2365,1177,1188,2012,50669
17094,1963,961,1002,2012,50670
17095,401,199,202,2012,50671
17096,651,355,296,2012,50672
17097,215,110,105,2012,50673
17098,3494,1750,1744,2012,50674
17099,2728,1403,1325,2012,50675
17100,2241,1167,1074,2012,50676
17101,11897,5587,6310,2012,50677
17102,1158,590,568,2012,50680
17103,490,228,262,2012,50681
17104,1693,931,762,2012,50682
17105,29410,14574,14836,2012,50701
17106,19724,9670,10054,2012,50702
17107,20153,9282,10871,2012,50703
17108,8570,4142,4428,2012,50707
17109,9514,4611,4903,2012,50801
17110,1852,876,976,2012,50830
17111,2376,1158,1218,2012,50833
17112,122,65,57,2012,50835
17113,375,180,195,2012,50836
17114,276,155,121,2012,50837
17115,24,11,13,2012,50839
17116,553,258,295,2012,50840
17117,2854,1367,1487,2012,50841
17118,69,37,32,2012,50842
17119,587,305,282,2012,50843
17120,936,501,435,2012,50845
17121,1143,583,560,2012,50846
17122,68,29,39,2012,50847
17123,305,147,158,2012,50848
17124,2678,1262,1416,2012,50849
17125,1898,915,983,2012,50851
17126,728,362,366,2012,50853
17127,2075,943,1132,2012,50854
17128,202,107,95,2012,50857
17129,685,353,332,2012,50858
17130,645,339,306,2012,50859
17131,652,335,317,2012,50860
17132,293,150,143,2012,50861
17133,155,82,73,2012,50862
17134,276,133,143,2012,50863
17135,2102,988,1114,2012,50864
17136,2467,1200,1267,2012,51001
17137,2579,1292,1287,2012,51002
17138,1585,774,811,2012,51003
17139,1360,680,680,2012,51004
17140,1593,777,816,2012,51005
17141,1192,571,621,2012,51006
17142,699,357,342,2012,51007
17143,94,49,45,2012,51008
17144,309,124,185,2012,51009
17145,313,171,142,2012,51010
17146,44,16,28,2012,51011
17147,6387,3150,3237,2012,51012
17148,517,230,287,2012,51014
17149,1445,721,724,2012,51016
17150,317,173,144,2012,51018
17151,819,408,411,2012,51019
17152,761,370,391,2012,51020
17153,892,503,389,2012,51022
17154,3167,1568,1599,2012,51023
17155,1955,960,995,2012,51024
17156,1867,1019,848,2012,51025
17157,730,374,356,2012,51026
17158,1342,693,649,2012,51027
17159,2116,1077,1039,2012,51028
17160,331,201,130,2012,51029
17161,1758,864,894,2012,51030
17162,12070,5880,6190,2012,51031
17163,509,295,214,2012,51033
17164,1756,880,876,2012,51034
17165,1717,903,814,2012,51035
17166,628,266,362,2012,51036
17167,323,171,152,2012,51037
17168,1658,837,821,2012,51038
17169,2528,1282,1246,2012,51039
17170,3998,1958,2040,2012,51040
17171,7369,3561,3808,2012,51041
17172,210,117,93,2012,51044
17173,1737,887,850,2012,51046
17174,802,452,350,2012,51047
17175,647,309,338,2012,51048
17176,500,255,245,2012,51049
17177,2765,1423,1342,2012,51050
17178,119,72,47,2012,51051
17179,790,390,400,2012,51052
17180,1296,617,679,2012,51053
17181,4881,2212,2669,2012,51054
17182,1172,543,629,2012,51055
17183,473,247,226,2012,51056
17184,1077,515,562,2012,51058
17185,552,246,306,2012,51060
17186,473,218,255,2012,51061
17187,536,266,270,2012,51062
17188,1100,510,590,2012,51063
17189,767,461,306,2012,51101
17190,17831,9099,8732,2012,51103
17191,21878,10567,11311,2012,51104
17192,9509,4470,5039,2012,51105
17193,26107,12865,13242,2012,51106
17194,6401,3166,3235,2012,51108
17195,3066,1473,1593,2012,51109
17196,228,141,87,2012,51111
17197,6069,3311,2758,2012,51201
17198,588,264,324,2012,51230
17199,256,137,119,2012,51231
17200,993,509,484,2012,51232
17201,1142,572,570,2012,51234
17202,1007,554,453,2012,51235
17203,1598,756,842,2012,51237
17204,1284,681,603,2012,51238
17205,3081,1571,1510,2012,51239
17206,1672,841,831,2012,51240
17207,1727,909,818,2012,51241
17208,230,102,128,2012,51242
17209,748,385,363,2012,51243
17210,60,29,31,2012,51244
17211,1492,693,799,2012,51245
17212,3918,1940,1978,2012,51246
17213,4721,2283,2438,2012,51247
17214,1495,723,772,2012,51248
17215,3440,1661,1779,2012,51249
17216,8425,4338,4087,2012,51250
17217,12867,6148,6719,2012,51301
17218,1007,504,503,2012,51331
17219,477,228,249,2012,51333
17220,7513,3910,3603,2012,51334
17221,895,453,442,2012,51338
17222,74,54,20,2012,51341
17223,1232,624,608,2012,51342
17224,189,93,96,2012,51343
17225,417,224,193,2012,51345
17226,2248,1018,1230,2012,51346
17227,1515,708,807,2012,51347
17228,486,233,253,2012,51350
17229,4392,2131,2261,2012,51351
17230,1122,559,563,2012,51354
17231,693,333,360,2012,51355
17232,795,396,399,2012,51357
17233,1354,648,706,2012,51358
17234,8581,4326,4255,2012,51360
17235,162,93,69,2012,51363
17236,577,325,252,2012,51364
17237,419,145,274,2012,51365
17238,398,180,218,2012,51366
17239,12166,5812,6354,2012,51401
17240,742,385,357,2012,51430
17241,366,169,197,2012,51431
17242,563,293,270,2012,51433
17243,957,472,485,2012,51436
17244,1087,528,559,2012,51439
17245,361,180,181,2012,51440
17246,381,177,204,2012,51441
17247,9614,4930,4684,2012,51442
17248,1813,871,942,2012,51443
17249,166,65,101,2012,51444
17250,2830,1367,1463,2012,51445
17251,505,248,257,2012,51446
17252,175,103,72,2012,51447
17253,662,348,314,2012,51448
17254,1926,884,1042,2012,51449
17255,1767,844,923,2012,51450
17256,101,50,51,2012,51451
17257,696,380,316,2012,51453
17258,1534,695,839,2012,51454
17259,2364,1184,1180,2012,51455
17260,1623,785,838,2012,51458
17261,130,56,74,2012,51459
17262,1144,557,587,2012,51461
17263,1003,501,502,2012,51462
17264,639,321,318,2012,51463
17265,789,356,433,2012,51465
17266,923,414,509,2012,51466
17267,668,355,313,2012,51467
17268,35173,17303,17870,2012,51501
17269,36673,17971,18702,2012,51503
17270,3743,1664,2079,2012,51510
17271,230,146,84,2012,51520
17272,1831,941,890,2012,51521
17273,302,135,167,2012,51523
17274,1042,522,520,2012,51525
17275,1861,964,897,2012,51526
17276,498,276,222,2012,51527
17277,788,379,409,2012,51528
17278,1990,1033,957,2012,51529
17279,1162,642,520,2012,51530
17280,828,402,426,2012,51531
17281,657,286,371,2012,51532
17282,930,511,419,2012,51533
17283,9319,4517,4802,2012,51534
17284,1616,794,822,2012,51535
17285,387,190,197,2012,51536
17286,6746,3179,3567,2012,51537
17287,528,263,265,2012,51540
17288,322,164,158,2012,51541
17289,972,558,414,2012,51542
17290,423,214,209,2012,51543
17291,1018,573,445,2012,51544
17292,425,225,200,2012,51545
17293,2778,1276,1502,2012,51546
17294,311,152,159,2012,51548
17295,364,197,167,2012,51549
17296,173,90,83,2012,51550
17297,1758,868,890,2012,51551
17298,223,101,122,2012,51552
17299,1167,567,600,2012,51553
17300,204,162,42,2012,51554
17301,5209,2621,2588,2012,51555
17302,484,244,240,2012,51556
17303,925,484,441,2012,51557
17304,665,367,298,2012,51558
17305,1774,729,1045,2012,51559
17306,2121,1030,1091,2012,51560
17307,1276,676,600,2012,51561
17308,414,215,199,2012,51562
17309,576,250,326,2012,51563
17310,437,243,194,2012,51564
17311,513,264,249,2012,51565
17312,6961,3480,3481,2012,51566
17313,838,365,473,2012,51570
17314,765,390,375,2012,51571
17315,328,171,157,2012,51572
17316,1121,543,578,2012,51573
17317,1570,781,789,2012,51575
17318,1987,1068,919,2012,51576
17319,1308,617,691,2012,51577
17320,79,36,43,2012,51578
17321,2356,1165,1191,2012,51579
17322,6007,2906,3101,2012,51601
17323,152,75,77,2012,51630
17324,266,135,131,2012,51631
17325,7145,3839,3306,2012,51632
17326,451,201,250,2012,51636
17327,250,117,133,2012,51637
17328,1369,665,704,2012,51638
17329,981,493,488,2012,51639
17330,1687,762,925,2012,51640
17331,253,130,123,2012,51645
17332,867,463,404,2012,51646
17333,197,96,101,2012,51647
17334,148,71,77,2012,51648
17335,337,162,175,2012,51649
17336,380,201,179,2012,51650
17337,1621,871,750,2012,51652
17338,1597,773,824,2012,51653
17339,446,226,220,2012,51654
17340,74,38,36,2012,51656
17341,43560,20459,23101,2012,52001
17342,14569,7561,7008,2012,52002
17343,13560,6634,6926,2012,52003
17344,430,227,203,2012,52030
17345,5490,2793,2697,2012,52031
17346,1445,781,664,2012,52032
17347,2950,1551,1399,2012,52033
17348,996,542,454,2012,52035
17349,1309,612,697,2012,52037
17350,456,222,234,2012,52038
17351,808,417,391,2012,52039
17352,5535,2785,2750,2012,52040
17353,1518,741,777,2012,52041
17354,1791,834,957,2012,52042
17355,2275,1181,1094,2012,52043
17356,301,178,123,2012,52044
17357,2537,1348,1189,2012,52045
17358,2385,1244,1141,2012,52046
17359,537,310,227,2012,52047
17360,249,113,136,2012,52048
17361,1394,720,674,2012,52049
17362,613,321,292,2012,52050
17363,3003,1398,1605,2012,52052
17364,886,440,446,2012,52053
17365,830,429,401,2012,52054
17366,7973,3926,4047,2012,52057
17367,8622,4089,4533,2012,52060
17368,824,446,378,2012,52064
17369,1071,550,521,2012,52065
17370,72,40,32,2012,52066
17371,4011,2024,1987,2012,52068
17372,1624,774,850,2012,52069
17373,1013,539,474,2012,52070
17374,301,134,167,2012,52072
17375,1538,844,694,2012,52073
17376,364,164,200,2012,52074
17377,2479,1219,1260,2012,52076
17378,412,217,195,2012,52077
17379,1047,500,547,2012,52078
17380,657,400,257,2012,52079
17381,13816,6657,7159,2012,52101
17382,1822,910,912,2012,52132
17383,575,329,246,2012,52133
17384,403,156,247,2012,52134
17385,975,484,491,2012,52135
17386,5784,2879,2905,2012,52136
17387,518,306,212,2012,52140
17388,1456,685,771,2012,52141
17389,1695,968,727,2012,52142
17390,1265,676,589,2012,52144
17391,958,563,395,2012,52146
17392,1001,524,477,2012,52147
17393,1977,989,988,2012,52151
17394,754,381,373,2012,52154
17395,1094,525,569,2012,52155
17396,782,347,435,2012,52156
17397,1790,875,915,2012,52157
17398,275,158,117,2012,52158
17399,2584,1324,1260,2012,52159
17400,910,492,418,2012,52160
17401,1569,860,709,2012,52161
17402,3419,1604,1815,2012,52162
17403,306,156,150,2012,52163
17404,169,93,76,2012,52164
17405,926,495,431,2012,52165
17406,83,53,30,2012,52166
17407,158,67,91,2012,52168
17408,509,240,269,2012,52169
17409,659,364,295,2012,52170
17410,1027,497,530,2012,52171
17411,6273,3048,3225,2012,52172
17412,3718,1793,1925,2012,52175
17413,1178,576,602,2012,52201
17414,1006,493,513,2012,52202
17415,1957,969,988,2012,52203
17416,8595,4623,3972,2012,52205
17417,2383,1166,1217,2012,52206
17418,433,229,204,2012,52207
17419,3051,1607,1444,2012,52208
17420,1059,519,540,2012,52209
17421,800,401,399,2012,52210
17422,2714,1380,1334,2012,52211
17423,246,92,154,2012,52212
17424,4332,2283,2049,2012,52213
17425,2981,1507,1474,2012,52214
17426,832,457,375,2012,52215
17427,1430,768,662,2012,52216
17428,512,234,278,2012,52217
17429,1921,1013,908,2012,52218
17430,186,97,89,2012,52219
17431,248,112,136,2012,52220
17432,196,106,90,2012,52221
17433,644,352,292,2012,52222
17434,1583,850,733,2012,52223
17435,2411,1235,1176,2012,52224
17436,335,178,157,2012,52225
17437,2556,1233,1323,2012,52227
17438,2669,1297,1372,2012,52228
17439,776,362,414,2012,52229
17440,253,125,128,2012,52231
17441,143,94,49,2012,52232
17442,7046,3781,3265,2012,52233
17443,824,381,443,2012,52235
17444,619,304,315,2012,52236
17445,1405,682,723,2012,52237
17446,32052,16343,15709,2012,52240
17447,18931,9096,9835,2012,52241
17448,1735,869,866,2012,52242
17449,22786,11140,11646,2012,52245
17450,21453,11086,10367,2012,52246
17451,5273,2408,2865,2012,52247
17452,1892,965,927,2012,52248
17453,993,546,447,2012,52249
17454,513,269,244,2012,52251
17455,2853,1420,1433,2012,52253
17456,724,378,346,2012,52254
17457,1009,473,536,2012,52255
17458,158,74,84,2012,52257
17459,3936,1928,2008,2012,52301
17460,37247,18358,18889,2012,52302
17461,596,317,279,2012,52305
17462,1864,899,965,2012,52306
17463,65,39,26,2012,52307
17464,138,75,63,2012,52308
17465,416,249,167,2012,52309
17466,6475,3228,3247,2012,52310
17467,114,55,59,2012,52312
17468,355,195,160,2012,52313
17469,6163,3038,3125,2012,52314
17470,947,425,522,2012,52315
17471,1553,708,845,2012,52316
17472,14688,7271,7417,2012,52317
17473,1180,605,575,2012,52318
17474,1215,640,575,2012,52320
17475,531,263,268,2012,52321
17476,2549,1158,1391,2012,52322
17477,1221,572,649,2012,52323
17478,1757,883,874,2012,52324
17479,919,440,479,2012,52325
17480,487,195,292,2012,52326
17481,3841,1943,1898,2012,52327
17482,2646,1316,1330,2012,52328
17483,764,432,332,2012,52329
17484,871,513,358,2012,52330
17485,1910,943,967,2012,52332
17486,6516,3286,3230,2012,52333
17487,204,132,72,2012,52334
17488,595,277,318,2012,52335
17489,2317,1091,1226,2012,52336
17490,1028,539,489,2012,52337
17491,3138,1605,1533,2012,52338
17492,4560,2236,2324,2012,52339
17493,2140,1192,948,2012,52340
17494,1338,676,662,2012,52341
17495,2940,1267,1673,2012,52342
17496,1437,783,654,2012,52345
17497,982,455,527,2012,52346
17498,1562,781,781,2012,52347
17499,47,19,28,2012,52348
17500,7731,3687,4044,2012,52349
17501,1673,858,815,2012,52351
17502,1794,911,883,2012,52352
17503,8858,4292,4566,2012,52353
17504,326,179,147,2012,52354
17505,267,141,126,2012,52355
17506,2815,1460,1355,2012,52356
17507,3622,1762,1860,2012,52358
17508,284,136,148,2012,52359
17509,4446,2159,2287,2012,52361
17510,682,358,324,2012,52362
17511,2021,1198,823,2012,52401
17512,39847,19409,20438,2012,52402
17513,22487,11134,11353,2012,52403
17514,38614,18463,20151,2012,52404
17515,24420,11836,12584,2012,52405
17516,7394,3712,3682,2012,52411
17517,29729,14415,15314,2012,52501
17518,1068,549,519,2012,52530
17519,5978,2964,3014,2012,52531
17520,1474,675,799,2012,52533
17521,184,91,93,2012,52534
17522,769,412,357,2012,52535
17523,818,365,453,2012,52536
17524,6576,3262,3314,2012,52537
17525,1441,781,660,2012,52540
17526,340,144,196,2012,52542
17527,518,285,233,2012,52543
17528,7641,3728,3913,2012,52544
17529,91,41,50,2012,52548
17530,556,261,295,2012,52549
17531,603,331,272,2012,52550
17532,625,338,287,2012,52551
17533,1030,546,484,2012,52552
17534,1580,828,752,2012,52553
17535,1683,839,844,2012,52554
17536,388,196,192,2012,52555
17537,12679,6387,6292,2012,52556
17538,78,50,28,2012,52557
17539,446,298,148,2012,52560
17540,968,484,484,2012,52561
17541,1760,952,808,2012,52563
17542,2057,1005,1052,2012,52565
17543,155,101,54,2012,52566
17544,639,356,283,2012,52567
17545,549,315,234,2012,52569
17546,1034,443,591,2012,52570
17547,1552,704,848,2012,52571
17548,1287,594,693,2012,52572
17549,84,50,34,2012,52573
17550,816,384,432,2012,52574
17551,449,238,211,2012,52576
17552,14946,7431,7515,2012,52577
17553,456,231,225,2012,52580
17554,492,262,230,2012,52581
17555,370,232,138,2012,52583
17556,701,302,399,2012,52584
17557,944,479,465,2012,52585
17558,429,195,234,2012,52586
17559,131,55,76,2012,52588
17560,1239,640,599,2012,52590
17561,3011,1469,1542,2012,52591
17562,209,102,107,2012,52593
17563,442,246,196,2012,52594
17564,541,302,239,2012,52595
17565,29837,14272,15565,2012,52601
17566,559,286,273,2012,52619
17567,814,402,412,2012,52620
17568,597,294,303,2012,52621
17569,1999,1073,926,2012,52623
17570,160,63,97,2012,52624
17571,2874,1485,1389,2012,52625
17572,1499,800,699,2012,52626
17573,13062,6639,6423,2012,52627
17574,642,339,303,2012,52630
17575,12943,6364,6579,2012,52632
17576,905,527,378,2012,52635
17577,2532,1340,1192,2012,52637
17578,429,207,222,2012,52638
17579,2257,1194,1063,2012,52639
17580,1681,905,776,2012,52640
17581,12095,6162,5933,2012,52641
17582,463,215,248,2012,52644
17583,2891,1539,1352,2012,52645
17584,325,154,171,2012,52646
17585,226,106,120,2012,52647
17586,1036,546,490,2012,52649
17587,807,465,342,2012,52650
17588,797,471,326,2012,52651
17589,3588,1829,1759,2012,52653
17590,1779,786,993,2012,52654
17591,4314,2057,2257,2012,52655
17592,2382,1174,1208,2012,52656
17593,54,29,25,2012,52657
17594,810,428,382,2012,52658
17595,1701,738,963,2012,52659
17596,151,68,83,2012,52660
17597,120,63,57,2012,52701
17598,1203,629,574,2012,52720
17599,849,391,458,2012,52721
17600,35022,16959,18063,2012,52722
17601,4337,2140,2197,2012,52726
17602,556,353,203,2012,52727
17603,864,412,452,2012,52728
17604,829,418,411,2012,52729
17605,4940,2340,2600,2012,52730
17606,726,375,351,2012,52731
17607,28613,14097,14516,2012,52732
17608,279,145,134,2012,52737
17609,3713,1842,1871,2012,52738
17610,785,419,366,2012,52739
17611,7537,3577,3960,2012,52742
17612,607,248,359,2012,52745
17613,942,504,438,2012,52746
17614,2099,997,1102,2012,52747
17615,8967,4541,4426,2012,52748
17616,1316,695,621,2012,52749
17617,493,271,222,2012,52750
17618,893,489,404,2012,52751
17619,477,229,248,2012,52752
17620,5340,2668,2672,2012,52753
17621,1334,692,642,2012,52754
17622,1963,963,1000,2012,52755
17623,2106,1052,1054,2012,52756
17624,183,100,83,2012,52757
17625,231,115,116,2012,52758
17626,361,167,194,2012,52760
17627,30635,15048,15587,2012,52761
17628,346,185,161,2012,52765
17629,851,438,413,2012,52766
17630,177,41,136,2012,52767
17631,1184,618,566,2012,52768
17632,836,419,417,2012,52769
17633,5070,2486,2584,2012,52772
17634,2317,1153,1164,2012,52773
17635,107,54,53,2012,52774
17636,4431,2204,2227,2012,52776
17637,1472,748,724,2012,52777
17638,3951,1900,2051,2012,52778
17639,1130,768,362,2012,52801
17640,10102,4938,5164,2012,52802
17641,23291,11548,11743,2012,52803
17642,27300,13099,14201,2012,52804
17643,27622,13309,14313,2012,52806
17644,13366,6715,6651,2012,52807
17645,1820,925,895,2012,53001
17646,2281,1282,999,2012,53002
17647,160,29,131,2012,53003
17648,3303,1723,1580,2012,53004
17649,19749,9561,10188,2012,53005
17650,1896,1032,864,2012,53006
17651,1816,927,889,2012,53007
17652,7866,4017,3849,2012,53010
17653,2121,1173,948,2012,53011
17654,18478,8719,9759,2012,53012
17655,3321,1655,1666,2012,53013
17656,8187,3985,4202,2012,53014
17657,2630,1341,1289,2012,53015
17658,390,205,185,2012,53016
17659,5440,2634,2806,2012,53017
17660,7784,3981,3803,2012,53018
17661,1840,952,888,2012,53019
17662,3406,1712,1694,2012,53020
17663,4770,2596,2174,2012,53021
17664,19041,9313,9728,2012,53022
17665,2341,1798,543,2012,53023
17666,16930,8243,8687,2012,53024
17667,22119,10668,11451,2012,53027
17668,20889,10253,10636,2012,53029
17669,78,39,39,2012,53031
17670,4616,2210,2406,2012,53032
17671,4776,2342,2434,2012,53033
17672,1945,992,953,2012,53034
17673,2353,1198,1155,2012,53035
17674,2400,1204,1196,2012,53036
17675,9098,4635,4463,2012,53037
17676,3917,2001,1916,2012,53038
17677,5006,2680,2326,2012,53039
17678,8401,4204,4197,2012,53040
17679,7197,3677,3520,2012,53042
17680,2495,1164,1331,2012,53044
17681,21428,10117,11311,2012,53045
17682,1147,544,603,2012,53046
17683,109,57,52,2012,53047
17684,3237,1644,1593,2012,53048
17685,2291,1192,1099,2012,53049
17686,6782,3346,3436,2012,53050
17687,35656,17442,18214,2012,53051
17688,1742,861,881,2012,53057
17689,3734,1903,1831,2012,53058
17690,1851,911,940,2012,53059
17691,5089,2757,2332,2012,53061
17692,1548,810,738,2012,53063
17693,2258,1083,1175,2012,53065
17694,34039,17284,16755,2012,53066
17695,477,243,234,2012,53069
17696,4642,2301,2341,2012,53070
17697,24026,11621,12405,2012,53072
17698,14972,7732,7240,2012,53073
17699,12712,6433,6279,2012,53074
17700,3352,1707,1645,2012,53075
17701,3445,1817,1628,2012,53076
17702,2084,1093,991,2012,53078
17703,1334,645,689,2012,53079
17704,5432,2749,2683,2012,53080
17705,43462,21409,22053,2012,53081
17706,20062,9894,10168,2012,53083
17707,11109,5398,5711,2012,53085
17708,7799,3947,3852,2012,53086
17709,438,243,195,2012,53088
17710,18080,8986,9094,2012,53089
17711,21906,10667,11239,2012,53090
17712,2099,1007,1092,2012,53091
17713,20472,9745,10727,2012,53092
17714,1954,999,955,2012,53093
17715,19197,9323,9874,2012,53094
17716,27516,13742,13774,2012,53095
17717,5883,2909,2974,2012,53097
17718,11914,5858,6056,2012,53098
17719,3749,2004,1745,2012,53103
17720,5718,2806,2912,2012,53104
17721,29632,15207,14425,2012,53105
17722,3534,1826,1708,2012,53108
17723,18275,9345,8930,2012,53110
17724,2584,1360,1224,2012,53114
17725,15863,7812,8051,2012,53115
17726,6920,3413,3507,2012,53118
17727,5503,2893,2610,2012,53119
17728,9951,4996,4955,2012,53120
17729,19672,9857,9815,2012,53121
17730,6058,2945,3113,2012,53122
17731,1654,812,842,2012,53125
17732,6179,3129,3050,2012,53126
17733,8123,4045,4078,2012,53128
17734,14068,6521,7547,2012,53129
17735,7713,3712,4001,2012,53130
17736,34680,17981,16699,2012,53132
17737,1951,1097,854,2012,53137
17738,3036,1484,1552,2012,53139
17739,30856,15180,15676,2012,53140
17740,31999,15417,16582,2012,53142
17741,22829,11058,11771,2012,53143
17742,27174,13375,13799,2012,53144
17743,6993,3619,3374,2012,53146
17744,16978,8220,8758,2012,53147
17745,19221,9622,9599,2012,53149
17746,24992,12226,12766,2012,53150
17747,32484,15316,17168,2012,53151
17748,2263,979,1284,2012,53153
17749,34190,17253,16937,2012,53154
17750,2983,1499,1484,2012,53156
17751,15951,7985,7966,2012,53158
17752,415,248,167,2012,53167
17753,8487,4279,4208,2012,53168
17754,2157,1204,953,2012,53170
17755,21119,10436,10683,2012,53172
17756,8641,5233,3408,2012,53177
17757,2711,1403,1308,2012,53178
17758,6370,3326,3044,2012,53179
17759,7261,3858,3403,2012,53181
17760,9327,4440,4887,2012,53182
17761,2955,1516,1439,2012,53183
17762,4385,2164,2221,2012,53184
17763,18295,9012,9283,2012,53185
17764,34685,16811,17874,2012,53186
17765,34532,17162,17370,2012,53188
17766,25240,12298,12942,2012,53189
17767,18984,9999,8985,2012,53190
17768,2870,1400,1470,2012,53191
17769,155,54,101,2012,53192
17770,86,52,34,2012,53195
17771,23290,11830,11460,2012,53202
17772,1103,674,429,2012,53203
17773,41529,21248,20281,2012,53204
17774,9522,4094,5428,2012,53205
17775,29046,13229,15817,2012,53206
17776,36050,17221,18829,2012,53207
17777,32518,16418,16100,2012,53208
17778,45295,20316,24979,2012,53209
17779,28052,12842,15210,2012,53210
17780,35175,17683,17492,2012,53211
17781,31065,15212,15853,2012,53212
17782,25924,12102,13822,2012,53213
17783,34789,17393,17396,2012,53214
17784,59066,29457,29609,2012,53215
17785,32231,14728,17503,2012,53216
17786,28979,14014,14965,2012,53217
17787,40323,17964,22359,2012,53218
17788,35504,16888,18616,2012,53219
17789,26286,12770,13516,2012,53220
17790,37707,18279,19428,2012,53221
17791,26362,12173,14189,2012,53222
17792,28411,12901,15510,2012,53223
17793,22849,10803,12046,2012,53224
17794,24259,10823,13436,2012,53225
17795,19246,9748,9498,2012,53226
17796,22591,10715,11876,2012,53227
17797,14579,7357,7222,2012,53228
17798,15421,8186,7235,2012,53233
17799,9325,4638,4687,2012,53235
17800,104,96,8,2012,53295
17801,31876,15577,16299,2012,53402
17802,27413,13661,13752,2012,53403
17803,16081,8202,7879,2012,53404
17804,25619,12086,13533,2012,53405
17805,25555,11892,13663,2012,53406
17806,0,0,0,2012,53501
17807,2419,1219,1200,2012,53502
17808,1891,950,941,2012,53503
17809,2048,1106,942,2012,53504
17810,421,220,201,2012,53505
17811,1137,559,578,2012,53506
17812,2209,1140,1069,2012,53507
17813,5454,2750,2704,2012,53508
17814,1501,722,779,2012,53510
17815,48932,23417,25515,2012,53511
17816,2251,1120,1131,2012,53515
17817,1994,979,1015,2012,53516
17818,1632,825,807,2012,53517
17819,1124,596,528,2012,53518
17820,6617,3290,3327,2012,53520
17821,3603,1780,1823,2012,53521
17822,1176,585,591,2012,53522
17823,4653,2384,2269,2012,53523
17824,3665,1931,1734,2012,53525
17825,532,291,241,2012,53526
17826,10072,4954,5118,2012,53527
17827,5794,2930,2864,2012,53528
17828,2153,1155,998,2012,53529
17829,4602,2436,2166,2012,53530
17830,4430,2258,2172,2012,53531
17831,13532,6736,6796,2012,53532
17832,6937,3221,3716,2012,53533
17833,11108,5665,5443,2012,53534
17834,8782,4451,4331,2012,53536
17835,681,329,352,2012,53537
17836,18731,9331,9400,2012,53538
17837,154,77,77,2012,53540
17838,797,379,418,2012,53541
17839,1729,911,818,2012,53543
17840,762,411,351,2012,53544
17841,22703,11393,11310,2012,53545
17842,31906,15546,16360,2012,53546
17843,18293,8836,9457,2012,53548
17844,10147,4933,5214,2012,53549
17845,1352,725,627,2012,53550
17846,8267,4013,4254,2012,53551
17847,659,349,310,2012,53553
17848,1112,534,578,2012,53554
17849,8469,4193,4276,2012,53555
17850,2750,1427,1323,2012,53556
17851,481,249,232,2012,53557
17852,10681,5207,5474,2012,53558
17853,6121,3083,3038,2012,53559
17854,3538,1707,1831,2012,53560
17855,1519,737,782,2012,53561
17856,24071,11457,12614,2012,53562
17857,10529,5116,5413,2012,53563
17858,5147,2540,2607,2012,53565
17859,15225,7342,7883,2012,53566
17860,1098,558,540,2012,53569
17861,2550,1336,1214,2012,53570
17862,327,162,165,2012,53571
17863,9676,4684,4992,2012,53572
17864,3056,1540,1516,2012,53573
17865,3820,1894,1926,2012,53574
17866,15437,8189,7248,2012,53575
17867,2528,1381,1147,2012,53576
17868,1448,758,690,2012,53577
17869,5953,2955,2998,2012,53578
17870,1834,917,917,2012,53579
17871,717,383,334,2012,53580
17872,11099,5375,5724,2012,53581
17873,998,534,464,2012,53582
17874,5827,2747,3080,2012,53583
17875,2029,1003,1026,2012,53585
17876,2357,1136,1221,2012,53586
17877,1292,687,605,2012,53587
17878,3898,1949,1949,2012,53588
17879,20129,10161,9968,2012,53589
17880,36112,17894,18218,2012,53590
17881,19546,9738,9808,2012,53593
17882,5136,2409,2727,2012,53594
17883,16883,7769,9114,2012,53597
17884,2652,1428,1224,2012,53598
17885,70,41,29,2012,53599
17886,37,18,19,2012,53702
17887,27280,13055,14225,2012,53703
17888,43142,21177,21965,2012,53704
17889,23683,11491,12192,2012,53705
17890,6251,3380,2871,2012,53706
17891,43555,21662,21893,2012,53711
17892,23506,12292,11214,2012,53713
17893,15735,7813,7922,2012,53714
17894,12738,6612,6126,2012,53715
17895,18195,8808,9387,2012,53716
17896,11753,5795,5958,2012,53717
17897,12510,6023,6487,2012,53718
17898,30151,14405,15746,2012,53719
17899,5740,3127,2613,2012,53726
17900,15,15,0,2012,53792
17901,934,463,471,2012,53801
17902,50,23,27,2012,53802
17903,1405,734,671,2012,53803
17904,1419,742,677,2012,53804
17905,5377,2879,2498,2012,53805
17906,1856,962,894,2012,53806
17907,4671,2327,2344,2012,53807
17908,927,470,457,2012,53808
17909,3827,1981,1846,2012,53809
17910,441,225,216,2012,53810
17911,3291,1578,1713,2012,53811
17912,6128,3050,3078,2012,53813
17913,923,495,428,2012,53816
17914,217,108,109,2012,53817
17915,14681,7954,6727,2012,53818
17916,2715,1494,1221,2012,53820
17917,8423,4279,4144,2012,53821
17918,620,325,295,2012,53825
17919,1378,734,644,2012,53826
17920,265,153,112,2012,53827
17921,14992,7968,7024,2012,53901
17922,3138,1581,1557,2012,53910
17923,1294,646,648,2012,53911
17924,20159,10205,9954,2012,53913
17925,22361,11383,10978,2012,53916
17926,2814,1394,1420,2012,53919
17927,387,189,198,2012,53920
17928,1009,550,459,2012,53922
17929,2082,1057,1025,2012,53923
17930,1149,604,545,2012,53924
17931,7758,3836,3922,2012,53925
17932,1555,790,765,2012,53926
17933,174,109,65,2012,53928
17934,2695,1360,1335,2012,53929
17935,1241,579,662,2012,53930
17936,280,150,130,2012,53931
17937,2354,1213,1141,2012,53932
17938,4135,2799,1336,2012,53933
17939,4536,2301,2235,2012,53934
17940,320,146,174,2012,53935
17941,2691,1961,730,2012,53936
17942,1120,629,491,2012,53937
17943,227,121,106,2012,53939
17944,2860,1503,1357,2012,53941
17945,954,466,488,2012,53943
17946,2283,1275,1008,2012,53944
17947,4287,2058,2229,2012,53946
17948,87,45,42,2012,53947
17949,8311,4237,4074,2012,53948
17950,6117,3150,2967,2012,53949
17951,5435,2978,2457,2012,53950
17952,2484,1240,1244,2012,53951
17953,3208,1649,1559,2012,53952
17954,336,171,165,2012,53953
17955,7002,3473,3529,2012,53954
17956,5356,2684,2672,2012,53955
17957,3280,1724,1556,2012,53956
17958,13268,6389,6879,2012,53959
17959,3285,1703,1582,2012,53960
17960,834,425,409,2012,53961
17961,13761,8116,5645,2012,53963
17962,3531,1818,1713,2012,53964
17963,10308,5445,4863,2012,53965
17964,2472,1294,1178,2012,53968
17965,464,164,300,2012,53969
17966,8032,3894,4138,2012,54001
17967,6474,3353,3121,2012,54002
17968,1002,477,525,2012,54003
17969,2382,1259,1123,2012,54004
17970,2987,1490,1497,2012,54005
17971,709,389,320,2012,54006
17972,1488,778,710,2012,54007
17973,2367,1215,1152,2012,54009
17974,15,7,8,2012,54010
17975,6504,3448,3056,2012,54011
17976,3303,1680,1623,2012,54013
17977,2505,1324,1181,2012,54014
17978,3435,1761,1674,2012,54015
17979,30424,15296,15128,2012,54016
17980,16442,8060,8382,2012,54017
17981,7450,3493,3957,2012,54020
17982,6675,3376,3299,2012,54021
17983,21920,10300,11620,2012,54022
17984,3882,1965,1917,2012,54023
17985,4595,2318,2277,2012,54024
17986,7010,3418,3592,2012,54025
17987,2013,1086,927,2012,54026
17988,984,528,456,2012,54027
17989,2248,1065,1183,2012,54028
17990,1860,944,916,2012,54082
17991,2877,1424,1453,2012,54101
17992,839,433,406,2012,54102
17993,304,172,132,2012,54103
17994,1129,582,547,2012,54104
17995,4812,2490,2322,2012,54106
17996,3713,1856,1857,2012,54107
17997,5373,2677,2696,2012,54110
17998,2349,1191,1158,2012,54111
17999,2279,1168,1111,2012,54112
18000,3294,1664,1630,2012,54113
18001,5352,2748,2604,2012,54114
18002,40335,19471,20864,2012,54115
18003,1052,444,608,2012,54119
18004,144,81,63,2012,54120
18005,3102,1554,1548,2012,54121
18006,234,101,133,2012,54123
18007,3929,1943,1986,2012,54124
18008,565,273,292,2012,54125
18009,3725,1997,1728,2012,54126
18010,48,24,24,2012,54127
18011,1756,785,971,2012,54128
18012,3146,1629,1517,2012,54129
18013,25194,12698,12496,2012,54130
18014,3099,1543,1556,2012,54135
18015,6356,3111,3245,2012,54136
18016,1131,566,565,2012,54137
18017,867,449,418,2012,54138
18018,3237,1736,1501,2012,54139
18019,8727,4315,4412,2012,54140
18020,2521,1412,1109,2012,54141
18021,14870,7468,7402,2012,54143
18022,1207,634,573,2012,54149
18023,1057,500,557,2012,54150
18024,3494,1713,1781,2012,54151
18025,7294,3700,3594,2012,54153
18026,5545,2752,2793,2012,54154
18027,6160,3048,3112,2012,54155
18028,1661,809,852,2012,54156
18029,6134,2879,3255,2012,54157
18030,1369,678,691,2012,54159
18031,198,106,92,2012,54160
18032,2842,1467,1375,2012,54161
18033,8944,4375,4569,2012,54162
18034,7503,3640,3863,2012,54165
18035,16979,8368,8611,2012,54166
18036,2580,1296,1284,2012,54169
18037,3586,1899,1687,2012,54170
18038,3268,1617,1651,2012,54171
18039,4311,2133,2178,2012,54173
18040,2791,1357,1434,2012,54174
18041,971,528,443,2012,54175
18042,2827,1482,1345,2012,54177
18043,2908,1455,1453,2012,54180
18044,5448,2745,2703,2012,54201
18045,1654,856,798,2012,54202
18046,1671,840,831,2012,54204
18047,2070,1038,1032,2012,54205
18048,174,96,78,2012,54207
18049,6375,3392,2983,2012,54208
18050,1188,532,656,2012,54209
18051,764,377,387,2012,54210
18052,228,94,134,2012,54211
18053,1127,565,562,2012,54212
18054,1596,837,759,2012,54213
18055,248,107,141,2012,54214
18056,6035,3121,2914,2012,54216
18057,7567,3862,3705,2012,54217
18058,39927,19371,20556,2012,54220
18059,1575,852,723,2012,54227
18060,2632,1334,1298,2012,54228
18061,4230,2084,2146,2012,54229
18062,4641,2436,2205,2012,54230
18063,816,444,372,2012,54232
18064,1488,657,831,2012,54234
18065,16964,8419,8545,2012,54235
18066,14789,7150,7639,2012,54241
18067,2443,1261,1182,2012,54245
18068,716,341,375,2012,54246
18069,2249,1138,1111,2012,54247
18070,22572,11278,11294,2012,54301
18071,29765,14414,15351,2012,54302
18072,28393,13690,14703,2012,54303
18073,27707,13683,14024,2012,54304
18074,1260,1260,0,2012,54307
18075,33620,16528,17092,2012,54311
18076,36151,18422,17729,2012,54313
18077,30333,15159,15174,2012,54401
18078,24792,12632,12160,2012,54403
18079,2730,1499,1231,2012,54405
18080,3507,1803,1704,2012,54406
18081,1448,768,680,2012,54407
18082,1086,592,494,2012,54408
18083,13046,6577,6469,2012,54409
18084,2250,1055,1195,2012,54410
18085,5766,3060,2706,2012,54411
18086,1962,1057,905,2012,54412
18087,138,73,65,2012,54413
18088,3358,1762,1596,2012,54414
18089,1810,832,978,2012,54416
18090,90,48,42,2012,54417
18091,1010,484,526,2012,54418
18092,1269,666,603,2012,54420
18093,3090,1471,1619,2012,54421
18094,1272,680,592,2012,54422
18095,2274,1143,1131,2012,54423
18096,1776,926,850,2012,54424
18097,2067,1065,1002,2012,54425
18098,4344,2225,2119,2012,54426
18099,1249,627,622,2012,54427
18100,1139,559,580,2012,54428
18101,127,62,65,2012,54430
18102,1660,919,741,2012,54433
18103,2090,1080,1010,2012,54435
18104,2332,1200,1132,2012,54436
18105,3347,1685,1662,2012,54437
18106,3068,1610,1458,2012,54440
18107,949,471,478,2012,54441
18108,1166,682,484,2012,54442
18109,2203,1082,1121,2012,54443
18110,3130,1558,1572,2012,54446
18111,543,294,249,2012,54447
18112,4541,2256,2285,2012,54448
18113,25891,12653,13238,2012,54449
18114,368,183,185,2012,54450
18115,11712,5835,5877,2012,54451
18116,19254,9686,9568,2012,54452
18117,1304,661,643,2012,54454
18118,17126,8713,8413,2012,54455
18119,6387,3196,3191,2012,54456
18120,8377,4216,4161,2012,54457
18121,153,76,77,2012,54458
18122,1194,644,550,2012,54459
18123,2716,1369,1347,2012,54460
18124,413,224,189,2012,54462
18125,836,451,385,2012,54463
18126,734,360,374,2012,54465
18127,2890,1474,1416,2012,54466
18128,13722,7157,6565,2012,54467
18129,1876,847,1029,2012,54469
18130,2136,1107,1029,2012,54470
18131,1708,862,846,2012,54471
18132,2461,1302,1159,2012,54473
18133,3897,1775,2122,2012,54474
18134,1660,841,819,2012,54475
18135,18773,9174,9599,2012,54476
18136,4198,2088,2110,2012,54479
18137,1394,706,688,2012,54480
18138,29014,13478,15536,2012,54481
18139,9279,4813,4466,2012,54482
18140,5028,2603,2425,2012,54484
18141,281,160,121,2012,54485
18142,2271,1181,1090,2012,54486
18143,9436,4571,4865,2012,54487
18144,1287,676,611,2012,54488
18145,1533,784,749,2012,54489
18146,866,422,444,2012,54490
18147,1541,807,734,2012,54491
18148,684,356,328,2012,54493
18149,26769,13202,13567,2012,54494
18150,7790,3833,3957,2012,54495
18151,2190,1123,1067,2012,54498
18152,2995,1535,1460,2012,54499
18153,19801,9702,10099,2012,54501
18154,1329,746,583,2012,54511
18155,990,469,521,2012,54512
18156,384,193,191,2012,54513
18157,1909,979,930,2012,54514
18158,465,250,215,2012,54515
18159,146,69,77,2012,54517
18160,1196,622,574,2012,54519
18161,4298,2130,2168,2012,54520
18162,7177,3806,3371,2012,54521
18163,628,343,285,2012,54524
18164,240,111,129,2012,54525
18165,823,425,398,2012,54526
18166,1096,533,563,2012,54527
18167,1170,600,570,2012,54529
18168,791,439,352,2012,54530
18169,1446,787,659,2012,54531
18170,2244,1055,1189,2012,54534
18171,243,132,111,2012,54536
18172,504,267,237,2012,54537
18173,3164,1532,1632,2012,54538
18174,1334,734,600,2012,54539
18175,1136,583,553,2012,54540
18176,1466,747,719,2012,54541
18177,466,244,222,2012,54542
18178,853,442,411,2012,54545
18179,1296,646,650,2012,54546
18180,1356,742,614,2012,54547
18181,4702,2417,2285,2012,54548
18182,626,338,288,2012,54550
18183,4431,2274,2157,2012,54552
18184,1281,614,667,2012,54554
18185,4958,2422,2536,2012,54555
18186,1341,663,678,2012,54556
18187,887,430,457,2012,54557
18188,2434,1242,1192,2012,54558
18189,727,369,358,2012,54559
18190,537,299,238,2012,54560
18191,9,7,2,2012,54561
18192,1863,1034,829,2012,54562
18193,616,316,300,2012,54563
18194,455,227,228,2012,54564
18195,97,52,45,2012,54565
18196,1432,720,712,2012,54566
18197,5085,2439,2646,2012,54568
18198,49395,23433,25962,2012,54601
18199,14469,7202,7267,2012,54603
18200,1653,894,759,2012,54610
18201,1240,615,625,2012,54611
18202,5109,2727,2382,2012,54612
18203,2045,1116,929,2012,54613
18204,2919,1532,1387,2012,54614
18205,10708,5855,4853,2012,54615
18206,2696,1354,1342,2012,54616
18207,2286,1167,1119,2012,54618
18208,3785,1976,1809,2012,54619
18209,1048,567,481,2012,54621
18210,2083,1015,1068,2012,54622
18211,1977,983,994,2012,54623
18212,1290,677,613,2012,54624
18213,262,144,118,2012,54625
18214,1327,739,588,2012,54626
18215,1852,1007,845,2012,54627
18216,984,559,425,2012,54628
18217,2511,1291,1220,2012,54629
18218,3864,1843,2021,2012,54630
18219,1917,993,924,2012,54631
18220,1188,599,589,2012,54632
18221,4342,2192,2150,2012,54634
18222,1718,870,848,2012,54635
18223,13930,7127,6803,2012,54636
18224,223,116,107,2012,54637
18225,1514,771,743,2012,54638
18226,2561,1308,1253,2012,54639
18227,0,0,0,2012,54641
18228,2065,1101,964,2012,54642
18229,7,3,4,2012,54643
18230,1125,601,524,2012,54644
18231,72,41,31,2012,54645
18232,4086,2080,2006,2012,54646
18233,1702,896,806,2012,54648
18234,23286,11380,11906,2012,54650
18235,1395,653,742,2012,54651
18236,980,459,521,2012,54652
18237,1048,551,497,2012,54653
18238,164,84,80,2012,54654
18239,1688,845,843,2012,54655
18240,17201,8789,8412,2012,54656
18241,391,203,188,2012,54657
18242,2204,1129,1075,2012,54658
18243,1462,766,696,2012,54659
18244,16014,7902,8112,2012,54660
18245,3283,1596,1687,2012,54661
18246,1425,680,745,2012,54664
18247,8505,4109,4396,2012,54665
18248,2414,1289,1125,2012,54666
18249,4705,2465,2240,2012,54667
18250,7583,3697,3886,2012,54669
18251,1937,1041,896,2012,54670
18252,40259,19209,21050,2012,54701
18253,41550,20956,20594,2012,54703
18254,7005,3278,3727,2012,54720
18255,1392,764,628,2012,54721
18256,4265,2345,1920,2012,54722
18257,1186,631,555,2012,54723
18258,7286,3409,3877,2012,54724
18259,2903,1486,1417,2012,54725
18260,1735,914,821,2012,54726
18261,5108,2620,2488,2012,54727
18262,6326,3217,3109,2012,54728
18263,31369,16310,15059,2012,54729
18264,4937,2606,2331,2012,54730
18265,776,379,397,2012,54731
18266,2855,1508,1347,2012,54732
18267,1372,730,642,2012,54733
18268,814,401,413,2012,54734
18269,3960,2062,1898,2012,54736
18270,493,255,238,2012,54737
18271,3003,1579,1424,2012,54738
18272,4549,2356,2193,2012,54739
18273,2138,1067,1071,2012,54740
18274,1565,710,855,2012,54741
18275,4009,2007,2002,2012,54742
18276,2110,1038,1072,2012,54745
18277,673,336,337,2012,54746
18278,2686,1419,1267,2012,54747
18279,1042,494,548,2012,54748
18280,1132,613,519,2012,54749
18281,1021,570,451,2012,54750
18282,25957,12902,13055,2012,54751
18283,1729,820,909,2012,54754
18284,7563,3716,3847,2012,54755
18285,875,470,405,2012,54756
18286,3380,1759,1621,2012,54757
18287,4675,2404,2271,2012,54758
18288,1565,753,812,2012,54759
18289,209,103,106,2012,54760
18290,1195,632,563,2012,54761
18291,1167,602,565,2012,54762
18292,1129,556,573,2012,54763
18293,13,6,7,2012,54765
18294,1641,855,786,2012,54766
18295,3208,1632,1576,2012,54767
18296,6029,3240,2789,2012,54768
18297,427,216,211,2012,54769
18298,2126,1104,1022,2012,54770
18299,4289,2103,2186,2012,54771
18300,1098,547,551,2012,54772
18301,3338,1649,1689,2012,54773
18302,6426,3083,3343,2012,54801
18303,1482,785,697,2012,54805
18304,11631,5851,5780,2012,54806
18305,2402,1253,1149,2012,54810
18306,5520,2800,2720,2012,54812
18307,577,310,267,2012,54813
18308,2598,1275,1323,2012,54814
18309,2139,1048,1091,2012,54817
18310,2633,1351,1282,2012,54819
18311,687,350,337,2012,54820
18312,1395,729,666,2012,54821
18313,4695,2258,2437,2012,54822
18314,2047,1050,997,2012,54824
18315,801,407,394,2012,54826
18316,151,81,70,2012,54827
18317,887,448,439,2012,54828
18318,5155,2539,2616,2012,54829
18319,2986,1570,1416,2012,54830
18320,450,210,240,2012,54832
18321,939,516,423,2012,54835
18322,1170,663,507,2012,54836
18323,3752,1843,1909,2012,54837
18324,1329,736,593,2012,54838
18325,288,155,133,2012,54839
18326,4376,2124,2252,2012,54840
18327,251,129,122,2012,54841
18328,54,21,33,2012,54842
18329,11234,5492,5742,2012,54843
18330,229,127,102,2012,54844
18331,168,78,90,2012,54845
18332,594,301,293,2012,54846
18333,2368,1227,1141,2012,54847
18334,6156,2966,3190,2012,54848
18335,2044,1051,993,2012,54849
18336,251,120,131,2012,54850
18337,4275,2160,2115,2012,54853
18338,1062,536,526,2012,54854
18339,800,442,358,2012,54855
18340,1422,763,659,2012,54856
18341,26,13,13,2012,54857
18342,1609,879,730,2012,54858
18343,1727,857,870,2012,54859
18344,204,90,114,2012,54861
18345,245,109,136,2012,54862
18346,1581,821,760,2012,54864
18347,443,227,216,2012,54865
18348,298,152,146,2012,54867
18349,15472,7685,7787,2012,54868
18350,1692,835,857,2012,54870
18351,3288,1695,1593,2012,54871
18352,2684,1366,1318,2012,54872
18353,2653,1369,1284,2012,54873
18354,3522,1834,1688,2012,54874
18355,1039,573,466,2012,54875
18356,1637,850,787,2012,54876
18357,30384,14781,15603,2012,54880
18358,1339,677,662,2012,54888
18359,3059,1547,1512,2012,54889
18360,3422,1760,1662,2012,54891
18361,3619,1908,1711,2012,54893
18362,1099,573,526,2012,54895
18363,1544,814,730,2012,54896
18364,38361,20494,17867,2012,54901
18365,22504,11067,11437,2012,54902
18366,20723,10149,10574,2012,54904
18367,2340,1255,1085,2012,54909
18368,25841,12990,12851,2012,54911
18369,17412,8723,8689,2012,54913
18370,30958,14766,16192,2012,54914
18371,41715,20738,20977,2012,54915
18372,1262,663,599,2012,54921
18373,1527,822,705,2012,54922
18374,8892,4530,4362,2012,54923
18375,531,289,242,2012,54927
18376,407,220,187,2012,54928
18377,8984,4510,4474,2012,54929
18378,1700,868,832,2012,54930
18379,235,128,107,2012,54931
18380,1115,536,579,2012,54932
18381,207,107,100,2012,54933
18382,84,48,36,2012,54934
18383,42279,20401,21878,2012,54935
18384,18825,9385,9440,2012,54937
18385,3742,1948,1794,2012,54940
18386,2557,1285,1272,2012,54941
18387,8867,4607,4260,2012,54942
18388,1903,958,945,2012,54943
18389,8297,4234,4063,2012,54944
18390,3422,1691,1731,2012,54945
18391,57,34,23,2012,54946
18392,2450,1187,1263,2012,54947
18393,262,152,110,2012,54948
18394,3258,1695,1563,2012,54949
18395,3066,1574,1492,2012,54950
18396,25646,12652,12994,2012,54952
18397,43223,20986,22237,2012,54956
18398,2706,1404,1302,2012,54960
18399,14096,7176,6920,2012,54961
18400,1133,596,537,2012,54962
18401,7172,3646,3526,2012,54963
18402,1001,505,496,2012,54964
18403,1402,717,685,2012,54965
18404,2011,1003,1008,2012,54966
18405,522,238,284,2012,54967
18406,2920,1417,1503,2012,54968
18407,3876,2388,1488,2012,54970
18408,10738,5053,5685,2012,54971
18409,1452,711,741,2012,54974
18410,1425,768,657,2012,54977
18411,1499,741,758,2012,54979
18412,132,45,87,2012,54980
18413,15655,7801,7854,2012,54981
18414,7188,3708,3480,2012,54982
18415,4664,2380,2284,2012,54983
18416,3192,1555,1637,2012,54984
18417,461,434,27,2012,54985
18418,4310,2132,2178,2012,54986
18419,2908,1449,1459,2012,55001
18420,3514,1975,1539,2012,55003
18421,4571,2407,2164,2012,55005
18422,4024,1969,2055,2012,55006
18423,2585,1317,1268,2012,55007
18424,14754,7298,7456,2012,55008
18425,7996,3982,4014,2012,55009
18426,9696,5105,4591,2012,55011
18427,2172,1140,1032,2012,55012
18428,6623,3342,3281,2012,55013
18429,27693,14458,13235,2012,55014
18430,34369,17230,17139,2012,55016
18431,851,418,433,2012,55017
18432,840,464,376,2012,55018
18433,1866,944,922,2012,55019
18434,3473,1731,1742,2012,55020
18435,29787,15898,13889,2012,55021
18436,32031,15628,16403,2012,55024
18437,23283,11459,11824,2012,55025
18438,440,230,210,2012,55026
18439,2886,1389,1497,2012,55027
18440,4,4,0,2012,55029
18441,1294,663,631,2012,55030
18442,2118,1158,960,2012,55031
18443,3284,1692,1592,2012,55032
18444,29372,14496,14876,2012,55033
18445,34,25,9,2012,55036
18446,4862,2418,2444,2012,55037
18447,20625,10316,10309,2012,55038
18448,12710,6512,6198,2012,55040
18449,7899,3876,4023,2012,55041
18450,8821,4452,4369,2012,55042
18451,3463,1730,1733,2012,55043
18452,47414,23488,23926,2012,55044
18453,7636,3767,3869,2012,55045
18454,5339,2679,2660,2012,55046
18455,2730,1525,1205,2012,55047
18456,2688,1338,1350,2012,55049
18457,9706,4852,4854,2012,55051
18458,1834,943,891,2012,55052
18459,982,513,469,2012,55053
18460,2355,1202,1153,2012,55054
18461,3459,1743,1716,2012,55055
18462,13763,6605,7158,2012,55056
18463,24524,11852,12672,2012,55057
18464,28899,14253,14646,2012,55060
18465,9147,4852,4295,2012,55063
18466,1101,553,548,2012,55065
18467,18344,9064,9280,2012,55066
18468,27374,13404,13970,2012,55068
18469,5500,3524,1976,2012,55069
18470,7447,3796,3651,2012,55070
18471,5689,2878,2811,2012,55071
18472,4582,2828,1754,2012,55072
18473,3116,1586,1530,2012,55073
18474,2022,1108,914,2012,55074
18475,20308,10345,9963,2012,55075
18476,21037,9979,11058,2012,55076
18477,12842,6574,6268,2012,55077
18478,7674,4148,3526,2012,55079
18479,2392,1279,1113,2012,55080
18480,34954,17540,17414,2012,55082
18481,1776,884,892,2012,55084
18482,439,233,206,2012,55085
18483,382,195,187,2012,55087
18484,1554,794,760,2012,55088
18485,2018,1075,943,2012,55089
18486,424,195,229,2012,55090
18487,11042,5488,5554,2012,55092
18488,5621,2940,2681,2012,55101
18489,16986,8233,8753,2012,55102
18490,13526,6638,6888,2012,55103
18491,43700,22107,21593,2012,55104
18492,27055,12133,14922,2012,55105
18493,54382,26596,27786,2012,55106
18494,15664,7544,8120,2012,55107
18495,15368,7045,8323,2012,55108
18496,31356,15042,16314,2012,55109
18497,37399,18213,19186,2012,55110
18498,0,0,0,2012,55111
18499,43423,21061,22362,2012,55112
18500,38991,18894,20097,2012,55113
18501,2847,1303,1544,2012,55114
18502,8811,4276,4535,2012,55115
18503,24622,11677,12945,2012,55116
18504,42476,20727,21749,2012,55117
18505,27915,13318,14597,2012,55118
18506,39120,19590,19530,2012,55119
18507,4261,1936,2325,2012,55120
18508,8012,4002,4010,2012,55121
18509,30430,15069,15361,2012,55122
18510,26096,13011,13085,2012,55123
18511,49336,24328,25008,2012,55124
18512,42918,20510,22408,2012,55125
18513,25266,11801,13465,2012,55126
18514,16893,8104,8789,2012,55127
18515,28365,14022,14343,2012,55128
18516,19240,9651,9589,2012,55129
18517,16763,8601,8162,2012,55130
18518,153,68,85,2012,55150
18519,0,0,0,2012,55155
18520,10412,5412,5000,2012,55301
18521,7098,3526,3572,2012,55302
18522,46429,23259,23170,2012,55303
18523,46030,23499,22531,2012,55304
18524,18350,8294,10056,2012,55305
18525,16069,8038,8031,2012,55306
18526,3433,1740,1693,2012,55307
18527,8834,4673,4161,2012,55308
18528,18465,9164,9301,2012,55309
18529,1454,766,688,2012,55310
18530,32426,15828,16598,2012,55311
18531,1566,772,794,2012,55312
18532,23526,11862,11664,2012,55313
18533,1416,772,644,2012,55314
18534,4836,2498,2338,2012,55315
18535,23198,11685,11513,2012,55316
18536,19310,9368,9942,2012,55317
18537,25449,12432,13017,2012,55318
18538,5180,2775,2405,2012,55319
18539,4641,2365,2276,2012,55320
18540,5402,2822,2580,2012,55321
18541,3181,1667,1514,2012,55322
18542,1278,679,599,2012,55324
18543,4525,2284,2241,2012,55325
18544,3271,1657,1614,2012,55327
18545,8623,4385,4238,2012,55328
18546,1937,937,1000,2012,55329
18547,35709,18280,17429,2012,55330
18548,17892,8960,8932,2012,55331
18549,1754,883,871,2012,55332
18550,903,484,419,2012,55333
18551,2888,1434,1454,2012,55334
18552,1591,842,749,2012,55335
18553,8062,3906,4156,2012,55336
18554,44607,21261,23346,2012,55337
18555,990,503,487,2012,55338
18556,983,555,428,2012,55339
18557,6364,3252,3112,2012,55340
18558,2717,1301,1416,2012,55341
18559,2105,1047,1058,2012,55342
18560,24724,11760,12964,2012,55343
18561,15130,7650,7480,2012,55344
18562,21736,10467,11269,2012,55345
18563,16180,7754,8426,2012,55346
18564,29533,14465,15068,2012,55347
18565,3818,1844,1974,2012,55349
18566,18228,9128,9100,2012,55350
18567,8714,4294,4420,2012,55352
18568,3377,1702,1675,2012,55353
18569,2722,1349,1373,2012,55354
18570,9789,4911,4878,2012,55355
18571,6220,3135,3085,2012,55356
18572,3436,1716,1720,2012,55357
18573,5096,2596,2500,2012,55358
18574,5678,2878,2800,2012,55359
18575,2593,1333,1260,2012,55360
18576,18764,9279,9485,2012,55362
18577,4569,2399,2170,2012,55363
18578,14544,7263,7281,2012,55364
18579,598,299,299,2012,55366
18580,1053,493,560,2012,55367
18581,2111,1065,1046,2012,55368
18582,33481,16251,17230,2012,55369
18583,846,441,405,2012,55370
18584,16761,8423,8338,2012,55371
18585,30281,15374,14907,2012,55372
18586,5330,2740,2590,2012,55373
18587,12327,6038,6289,2012,55374
18588,4368,2310,2058,2012,55375
18589,16325,8069,8256,2012,55376
18590,26703,13201,13502,2012,55378
18591,40784,20290,20494,2012,55379
18592,2171,1144,1027,2012,55381
18593,3187,1623,1564,2012,55382
18594,1726,806,920,2012,55384
18595,1341,661,680,2012,55385
18596,6447,3284,3163,2012,55386
18597,12439,6283,6156,2012,55387
18598,5568,2679,2889,2012,55388
18599,2600,1358,1242,2012,55389
18600,2253,1211,1042,2012,55390
18601,14389,7169,7220,2012,55391
18602,2679,1316,1363,2012,55395
18603,2274,1026,1248,2012,55396
18604,2875,1407,1468,2012,55397
18605,15782,7828,7954,2012,55398
18606,7157,4061,3096,2012,55401
18607,381,241,140,2012,55402
18608,14489,7435,7054,2012,55403
18609,27265,14015,13250,2012,55404
18610,15105,8052,7053,2012,55405
18611,32084,15675,16409,2012,55406
18612,37364,18361,19003,2012,55407
18613,31401,16596,14805,2012,55408
18614,12698,6123,6575,2012,55409
18615,19712,9013,10699,2012,55410
18616,27739,13154,14585,2012,55411
18617,21306,10267,11039,2012,55412
18618,13073,6622,6451,2012,55413
18619,27104,14240,12864,2012,55414
18620,2905,1979,926,2012,55415
18621,29587,13690,15897,2012,55416
18622,24963,12369,12594,2012,55417
18623,29981,14972,15009,2012,55418
18624,26733,12888,13845,2012,55419
18625,21343,10156,11187,2012,55420
18626,26914,13398,13516,2012,55421
18627,28261,13703,14558,2012,55422
18628,35525,17425,18100,2012,55423
18629,10015,5217,4798,2012,55424
18630,9452,4564,4888,2012,55425
18631,25093,12370,12723,2012,55426
18632,22282,10835,11447,2012,55427
18633,29911,14504,15407,2012,55428
18634,27224,13271,13953,2012,55429
18635,22277,10937,11340,2012,55430
18636,18175,8623,9552,2012,55431
18637,30321,14451,15870,2012,55432
18638,33953,16342,17611,2012,55433
18639,28227,13654,14573,2012,55434
18640,11954,5141,6813,2012,55435
18641,12761,6280,6481,2012,55436
18642,18034,8759,9275,2012,55437
18643,16654,8104,8550,2012,55438
18644,8772,4109,4663,2012,55439
18645,17807,8564,9243,2012,55441
18646,12970,6299,6671,2012,55442
18647,33054,16532,16522,2012,55443
18648,14079,6835,7244,2012,55444
18649,9808,4996,4812,2012,55445
18650,19467,9705,9762,2012,55446
18651,21183,10355,10828,2012,55447
18652,27786,13580,14206,2012,55448
18653,23918,11870,12048,2012,55449
18654,59,0,59,2012,55450
18655,7359,4001,3358,2012,55454
18656,1960,856,1104,2012,55455
18657,122,67,55,2012,55601
18658,156,89,67,2012,55602
18659,510,297,213,2012,55603
18660,3436,1668,1768,2012,55604
18661,505,309,196,2012,55605
18662,192,77,115,2012,55606
18663,136,63,73,2012,55607
18664,222,101,121,2012,55609
18665,610,354,256,2012,55612
18666,235,127,108,2012,55613
18667,2586,1373,1213,2012,55614
18668,228,122,106,2012,55615
18669,6998,3491,3507,2012,55616
18670,448,235,213,2012,55702
18671,734,423,311,2012,55703
18672,1280,654,626,2012,55704
18673,3323,1745,1578,2012,55705
18674,1657,823,834,2012,55706
18675,3561,1845,1716,2012,55707
18676,1148,547,601,2012,55708
18677,4130,2202,1928,2012,55709
18678,1214,564,650,2012,55710
18679,570,305,265,2012,55711
18680,630,317,313,2012,55712
18681,1076,595,481,2012,55713
18682,357,174,183,2012,55716
18683,252,141,111,2012,55717
18684,2974,1560,1414,2012,55718
18685,5942,2909,3033,2012,55719
18686,17040,8502,8538,2012,55720
18687,3237,1587,1650,2012,55721
18688,1105,583,522,2012,55722
18689,2368,1183,1185,2012,55723
18690,834,421,413,2012,55724
18691,119,59,60,2012,55725
18692,926,458,468,2012,55726
18693,5987,3049,2938,2012,55731
18694,1366,769,597,2012,55732
18695,4633,2432,2201,2012,55733
18696,6219,3010,3209,2012,55734
18697,1892,1022,870,2012,55735
18698,1389,657,732,2012,55736
18699,512,284,228,2012,55738
18700,3087,1524,1563,2012,55741
18701,303,171,132,2012,55742
18702,20590,10241,10349,2012,55744
18703,17149,8275,8874,2012,55746
18704,1517,759,758,2012,55748
18705,551,312,239,2012,55749
18706,1967,942,1025,2012,55750
18707,1511,783,728,2012,55751
18708,394,214,180,2012,55752
18709,1044,504,540,2012,55753
18710,359,183,176,2012,55756
18711,953,503,450,2012,55757
18712,161,83,78,2012,55758
18713,2981,1535,1446,2012,55760
18714,590,306,284,2012,55763
18715,555,319,236,2012,55764
18716,790,390,400,2012,55765
18717,43,21,22,2012,55766
18718,4630,2846,1784,2012,55767
18719,2874,1411,1463,2012,55768
18720,2459,1130,1329,2012,55769
18721,1828,1001,827,2012,55771
18722,74,46,28,2012,55772
18723,1177,641,536,2012,55775
18724,3846,2157,1689,2012,55779
18725,223,87,136,2012,55780
18726,565,263,302,2012,55781
18727,469,247,222,2012,55782
18728,2494,1295,1199,2012,55783
18729,74,43,31,2012,55784
18730,181,94,87,2012,55785
18731,343,162,181,2012,55786
18732,454,223,231,2012,55787
18733,1908,1002,906,2012,55790
18734,10053,5008,5045,2012,55792
18735,513,258,255,2012,55793
18736,1655,875,780,2012,55795
18737,1591,826,765,2012,55797
18738,525,289,236,2012,55798
18739,2243,939,1304,2012,55802
18740,17510,8890,8620,2012,55803
18741,14108,6660,7448,2012,55804
18742,10398,5243,5155,2012,55805
18743,9848,5042,4806,2012,55806
18744,9686,4648,5038,2012,55807
18745,5861,2854,3007,2012,55808
18746,8673,4494,4179,2012,55810
18747,26499,12882,13617,2012,55811
18748,10975,5948,5027,2012,55812
18749,714,702,12,2012,55814
18750,51007,24710,26297,2012,55901
18751,22853,10893,11960,2012,55902
18752,26193,13491,12702,2012,55904
18753,0,0,0,2012,55905
18754,18023,8779,9244,2012,55906
18755,1445,679,766,2012,55909
18756,1517,834,683,2012,55910
18757,28617,14194,14423,2012,55912
18758,3686,1756,1930,2012,55917
18759,1035,514,521,2012,55918
18760,1033,528,505,2012,55919
18761,7027,3476,3551,2012,55920
18762,5009,2568,2441,2012,55921
18763,859,459,400,2012,55922
18764,4328,2147,2181,2012,55923
18765,1391,782,609,2012,55924
18766,1178,587,591,2012,55925
18767,739,367,372,2012,55926
18768,3984,1999,1985,2012,55927
18769,1160,564,596,2012,55929
18770,304,162,142,2012,55931
18771,2243,1169,1074,2012,55932
18772,279,152,127,2012,55933
18773,3542,1777,1765,2012,55934
18774,879,461,418,2012,55935
18775,1833,875,958,2012,55936
18776,2086,1059,1027,2012,55939
18777,2647,1369,1278,2012,55940
18778,784,416,368,2012,55941
18779,2976,1459,1517,2012,55943
18780,6998,3399,3599,2012,55944
18781,1329,699,630,2012,55945
18782,3310,1675,1635,2012,55946
18783,7673,3616,4057,2012,55947
18784,1692,840,852,2012,55949
18785,83,39,44,2012,55950
18786,1485,741,744,2012,55951
18787,2563,1367,1196,2012,55952
18788,879,435,444,2012,55953
18789,1396,653,743,2012,55954
18790,2770,1376,1394,2012,55955
18791,1800,952,848,2012,55956
18792,741,357,384,2012,55957
18793,2137,1091,1046,2012,55959
18794,3104,1576,1528,2012,55960
18795,497,233,264,2012,55961
18796,781,425,356,2012,55962
18797,5126,2497,2629,2012,55963
18798,4356,2175,2181,2012,55964
18799,2340,1221,1119,2012,55965
18800,883,454,429,2012,55967
18801,164,89,75,2012,55968
18802,1230,638,592,2012,55969
18803,1098,560,538,2012,55970
18804,3287,1629,1658,2012,55971
18805,4902,2579,2323,2012,55972
18806,275,137,138,2012,55973
18807,2186,1098,1088,2012,55974
18808,4202,2097,2105,2012,55975
18809,7477,3516,3961,2012,55976
18810,211,106,105,2012,55977
18811,1043,579,464,2012,55979
18812,3975,1941,2034,2012,55981
18813,459,251,208,2012,55982
18814,1445,730,715,2012,55983
18815,2051,996,1055,2012,55985
18816,35855,17041,18814,2012,55987
18817,983,468,515,2012,55990
18818,1214,604,610,2012,55991
18819,4923,2385,2538,2012,55992
18820,46348,22923,23425,2012,56001
18821,14207,7086,7121,2012,56003
18822,21217,10374,10843,2012,56007
18823,1637,852,785,2012,56009
18824,1268,665,603,2012,56010
18825,8788,4141,4647,2012,56011
18826,4420,2132,2288,2012,56013
18827,688,338,350,2012,56014
18828,1009,511,498,2012,56016
18829,1521,804,717,2012,56017
18830,1030,536,494,2012,56019
18831,91,45,46,2012,56020
18832,1110,575,535,2012,56021
18833,57,27,30,2012,56022
18834,556,286,270,2012,56023
18835,2829,1464,1365,2012,56024
18836,494,260,234,2012,56025
18837,1842,959,883,2012,56026
18838,997,544,453,2012,56027
18839,1138,526,612,2012,56028
18840,742,398,344,2012,56029
18841,12344,6009,6335,2012,56031
18842,255,138,117,2012,56032
18843,352,186,166,2012,56033
18844,584,327,257,2012,56034
18845,503,240,263,2012,56035
18846,2060,1080,980,2012,56036
18847,1571,800,771,2012,56037
18848,876,454,422,2012,56039
18849,1035,524,511,2012,56041
18850,667,340,327,2012,56042
18851,440,228,212,2012,56043
18852,2001,1050,951,2012,56044
18853,799,431,368,2012,56045
18854,73,35,38,2012,56046
18855,130,64,66,2012,56047
18856,3628,1863,1765,2012,56048
18857,1631,816,815,2012,56050
18858,742,389,353,2012,56051
18859,1042,534,508,2012,56052
18860,981,511,470,2012,56054
18861,3892,2074,1818,2012,56055
18862,81,43,38,2012,56056
18863,3783,1860,1923,2012,56057
18864,5975,3001,2974,2012,56058
18865,419,226,193,2012,56060
18866,3277,1768,1509,2012,56062
18867,2718,1354,1364,2012,56063
18868,2900,1483,1417,2012,56065
18869,996,484,512,2012,56068
18870,4352,2175,2177,2012,56069
18871,12025,6131,5894,2012,56071
18872,2142,1105,1037,2012,56072
18873,16693,8304,8389,2012,56073
18874,2043,1065,978,2012,56074
18875,236,117,119,2012,56075
18876,474,229,245,2012,56078
18877,518,262,256,2012,56080
18878,5957,2862,3095,2012,56081
18879,13620,6697,6923,2012,56082
18880,842,415,427,2012,56083
18881,5458,2700,2758,2012,56085
18882,3124,1506,1618,2012,56087
18883,1958,974,984,2012,56088
18884,202,113,89,2012,56089
18885,741,361,380,2012,56090
18886,255,137,118,2012,56091
18887,13404,6205,7199,2012,56093
18888,2993,1517,1476,2012,56096
18889,3892,1949,1943,2012,56097
18890,2165,1124,1041,2012,56098
18891,5836,2821,3015,2012,56101
18892,1913,953,960,2012,56110
18893,440,222,218,2012,56111
18894,219,126,93,2012,56113
18895,417,224,193,2012,56114
18896,1224,660,564,2012,56115
18897,600,314,286,2012,56116
18898,389,190,199,2012,56117
18899,448,242,206,2012,56118
18900,1129,576,553,2012,56119
18901,1027,535,492,2012,56120
18902,670,350,320,2012,56121
18903,557,275,282,2012,56122
18904,460,230,230,2012,56123
18905,63,27,36,2012,56125
18906,439,228,211,2012,56127
18907,2045,1050,995,2012,56128
18908,797,357,440,2012,56129
18909,2390,1155,1235,2012,56131
18910,508,262,246,2012,56132
18911,499,261,238,2012,56134
18912,1012,467,545,2012,56136
18913,1079,544,535,2012,56137
18914,876,439,437,2012,56138
18915,484,268,216,2012,56139
18916,49,24,25,2012,56140
18917,327,139,188,2012,56141
18918,995,489,506,2012,56142
18919,4531,2277,2254,2012,56143
18920,998,468,530,2012,56144
18921,624,328,296,2012,56145
18922,44,22,22,2012,56146
18923,131,69,62,2012,56147
18924,1328,677,651,2012,56149
18925,2684,1338,1346,2012,56150
18926,806,419,387,2012,56151
18927,1686,850,836,2012,56152
18928,143,67,76,2012,56153
18929,468,240,228,2012,56155
18930,6078,2905,3173,2012,56156
18931,777,398,379,2012,56157
18932,417,224,193,2012,56158
18933,2976,1477,1499,2012,56159
18934,183,93,90,2012,56160
18935,345,192,153,2012,56161
18936,365,178,187,2012,56162
18937,6016,2882,3134,2012,56164
18938,368,175,193,2012,56165
18939,267,157,110,2012,56166
18940,697,362,335,2012,56167
18941,894,468,426,2012,56168
18942,735,342,393,2012,56169
18943,540,275,265,2012,56170
18944,1592,839,753,2012,56171
18945,3107,1517,1590,2012,56172
18946,477,260,217,2012,56173
18947,348,182,166,2012,56174
18948,2996,1431,1565,2012,56175
18949,1063,482,581,2012,56176
18950,31,10,21,2012,56177
18951,1703,852,851,2012,56178
18952,1393,711,682,2012,56180
18953,1251,618,633,2012,56181
18954,1287,607,680,2012,56183
18955,502,233,269,2012,56185
18956,345,179,166,2012,56186
18957,14068,7208,6860,2012,56187
18958,23060,11608,11452,2012,56201
18959,223,126,97,2012,56207
18960,2352,1302,1050,2012,56208
18961,2261,1162,1099,2012,56209
18962,16,8,8,2012,56210
18963,448,247,201,2012,56211
18964,567,297,270,2012,56212
18965,669,339,330,2012,56214
18966,4399,2181,2218,2012,56215
18967,583,301,282,2012,56216
18968,588,321,267,2012,56218
18969,981,515,466,2012,56219
18970,3110,1558,1552,2012,56220
18971,850,438,412,2012,56221
18972,1917,918,999,2012,56222
18973,1277,629,648,2012,56223
18974,297,159,138,2012,56224
18975,719,328,391,2012,56225
18976,262,152,110,2012,56226
18977,214,113,101,2012,56227
18978,969,485,484,2012,56228
18979,1859,938,921,2012,56229
18980,777,365,412,2012,56230
18981,404,215,189,2012,56231
18982,2368,1099,1269,2012,56232
18983,423,229,194,2012,56235
18984,323,163,160,2012,56236
18985,645,343,302,2012,56237
18986,574,320,254,2012,56239
18987,920,408,512,2012,56240
18988,3976,1952,2024,2012,56241
18989,1618,776,842,2012,56243
18990,1532,816,716,2012,56244
18991,515,292,223,2012,56245
18992,883,421,462,2012,56248
18993,294,152,142,2012,56249
18994,1180,567,613,2012,56251
18995,1248,614,634,2012,56252
18996,943,485,458,2012,56253
18997,334,179,155,2012,56255
18998,2535,1280,1255,2012,56256
18999,545,273,272,2012,56257
19000,15662,7653,8009,2012,56258
19001,860,397,463,2012,56260
19002,772,388,384,2012,56262
19003,461,252,209,2012,56263
19004,2146,1059,1087,2012,56264
19005,7815,3912,3903,2012,56265
19006,1728,884,844,2012,56266
19007,6894,3322,3572,2012,56267
19008,963,526,437,2012,56270
19009,1167,605,562,2012,56271
19010,4916,2436,2480,2012,56273
19011,200,108,92,2012,56274
19012,347,195,152,2012,56276
19013,3114,1579,1535,2012,56277
19014,2810,1376,1434,2012,56278
19015,1379,721,658,2012,56279
19016,577,344,233,2012,56280
19017,590,294,296,2012,56281
19018,1581,814,767,2012,56282
19019,6546,3236,3310,2012,56283
19020,2224,1042,1182,2012,56284
19021,1154,581,573,2012,56285
19022,87,39,48,2012,56287
19023,4535,2267,2268,2012,56288
19024,647,324,323,2012,56289
19025,521,273,248,2012,56291
19026,623,322,301,2012,56292
19027,1116,538,578,2012,56293
19028,69,37,32,2012,56294
19029,340,180,160,2012,56295
19030,2032,1032,1000,2012,56296
19031,822,424,398,2012,56297
19032,32362,16798,15564,2012,56301
19033,25975,13589,12386,2012,56303
19034,16012,8108,7904,2012,56304
19035,4994,2531,2463,2012,56307
19036,24161,11952,12209,2012,56308
19037,1193,621,572,2012,56309
19038,5276,2842,2434,2012,56310
19039,706,360,346,2012,56311
19040,2253,1190,1063,2012,56312
19041,78,43,35,2012,56313
19042,1285,706,579,2012,56314
19043,1696,942,754,2012,56315
19044,1439,756,683,2012,56316
19045,1171,631,540,2012,56318
19046,1522,795,727,2012,56319
19047,7959,3914,4045,2012,56320
19048,1627,1449,178,2012,56321
19049,543,293,250,2012,56323
19050,1296,680,616,2012,56324
19051,168,90,78,2012,56325
19052,1517,722,795,2012,56326
19053,691,363,328,2012,56327
19054,103,54,49,2012,56328
19055,7336,3860,3476,2012,56329
19056,1882,919,963,2012,56330
19057,1827,957,870,2012,56331
19058,1141,579,562,2012,56332
19059,5447,2733,2714,2012,56334
19060,191,98,93,2012,56335
19061,1633,848,785,2012,56336
19062,1707,866,841,2012,56338
19063,1105,543,562,2012,56339
19064,2387,1199,1188,2012,56340
19065,2722,1379,1343,2012,56342
19066,983,473,510,2012,56343
19067,14893,7280,7613,2012,56345
19068,7123,3547,3576,2012,56347
19069,806,441,365,2012,56349
19070,556,305,251,2012,56350
19071,6120,3062,3058,2012,56352
19072,8601,4381,4220,2012,56353
19073,1349,698,651,2012,56354
19074,509,265,244,2012,56355
19075,285,135,150,2012,56356
19076,1036,493,543,2012,56357
19077,3331,1752,1579,2012,56358
19078,3899,1946,1953,2012,56359
19079,4015,2020,1995,2012,56360
19080,2327,1180,1147,2012,56361
19081,5635,2806,2829,2012,56362
19082,107,61,46,2012,56363
19083,5299,2686,2613,2012,56364
19084,6296,3418,2878,2012,56367
19085,4532,2284,2248,2012,56368
19086,522,229,293,2012,56369
19087,117,66,51,2012,56371
19088,2897,1545,1352,2012,56373
19089,9858,3711,6147,2012,56374
19090,794,410,384,2012,56375
19091,345,163,182,2012,56376
19092,17459,8389,9070,2012,56377
19093,7964,4033,3931,2012,56378
19094,16125,7814,8311,2012,56379
19095,2394,1219,1175,2012,56381
19096,1497,778,719,2012,56382
19097,412,201,211,2012,56384
19098,1061,526,535,2012,56385
19099,903,483,420,2012,56386
19100,6674,3301,3373,2012,56387
19101,99,55,44,2012,56389
19102,29349,14649,14700,2012,56401
19103,7581,3603,3978,2012,56425
19104,9334,4718,4616,2012,56431
19105,1608,805,803,2012,56433
19106,182,90,92,2012,56434
19107,2683,1364,1319,2012,56435
19108,39,26,13,2012,56436
19109,1440,698,742,2012,56437
19110,2934,1601,1333,2012,56438
19111,1358,658,700,2012,56440
19112,3351,1589,1762,2012,56441
19113,2199,1107,1092,2012,56442
19114,1567,864,703,2012,56443
19115,3031,1589,1442,2012,56444
19116,1485,749,736,2012,56446
19117,1090,586,504,2012,56447
19118,330,178,152,2012,56448
19119,2149,1124,1025,2012,56449
19120,985,492,493,2012,56450
19121,1937,1061,876,2012,56452
19122,838,430,408,2012,56453
19123,1889,888,1001,2012,56455
19124,50,24,26,2012,56456
19125,311,163,148,2012,56458
19126,3227,1684,1543,2012,56461
19127,4184,2132,2052,2012,56464
19128,2015,1043,972,2012,56465
19129,3032,1553,1479,2012,56466
19130,2362,1184,1178,2012,56467
19131,5283,2679,2604,2012,56468
19132,880,440,440,2012,56469
19133,10412,5209,5203,2012,56470
19134,7075,3624,3451,2012,56472
19135,3559,1830,1729,2012,56473
19136,3453,1824,1629,2012,56474
19137,1693,841,852,2012,56475
19138,2572,1288,1284,2012,56477
19139,5255,2545,2710,2012,56479
19140,2130,1147,983,2012,56481
19141,6734,3350,3384,2012,56482
19142,3283,1640,1643,2012,56484
19143,16367,8072,8295,2012,56501
19144,2318,1146,1172,2012,56510
19145,1827,971,856,2012,56511
19146,3541,1767,1774,2012,56514
19147,3179,1572,1607,2012,56515
19148,299,167,132,2012,56516
19149,244,126,118,2012,56517
19150,378,186,192,2012,56518
19151,305,164,141,2012,56519
19152,4029,1937,2092,2012,56520
19153,789,435,354,2012,56521
19154,713,375,338,2012,56522
19155,556,275,281,2012,56523
19156,775,411,364,2012,56524
19157,153,97,56,2012,56525
19158,729,383,346,2012,56527
19159,1454,755,699,2012,56528
19160,3996,2094,1902,2012,56529
19161,1981,989,992,2012,56531
19162,313,175,138,2012,56533
19163,1075,563,512,2012,56534
19164,1453,753,700,2012,56535
19165,454,238,216,2012,56536
19166,18541,8876,9665,2012,56537
19167,1887,936,951,2012,56540
19168,38,26,12,2012,56541
19169,2946,1453,1493,2012,56542
19170,239,131,108,2012,56543
19171,5444,2772,2672,2012,56544
19172,574,312,262,2012,56545
19173,434,216,218,2012,56546
19174,2828,1497,1331,2012,56547
19175,793,373,420,2012,56548
19176,4338,2221,2117,2012,56549
19177,375,185,190,2012,56550
19178,2234,1076,1158,2012,56551
19179,467,266,201,2012,56552
19180,293,165,128,2012,56553
19181,2438,1305,1133,2012,56554
19182,920,435,485,2012,56556
19183,2786,1427,1359,2012,56557
19184,40604,19628,20976,2012,56560
19185,155,92,63,2012,56565
19186,525,264,261,2012,56566
19187,3565,1819,1746,2012,56567
19188,177,86,91,2012,56568
19189,1316,556,760,2012,56569
19190,1310,679,631,2012,56570
19191,1687,922,765,2012,56571
19192,5377,2706,2671,2012,56572
19193,6023,2954,3069,2012,56573
19194,282,146,136,2012,56574
19195,753,385,368,2012,56575
19196,811,418,393,2012,56576
19197,15,6,9,2012,56577
19198,804,413,391,2012,56578
19199,1011,555,456,2012,56579
19200,1334,677,657,2012,56580
19201,360,186,174,2012,56581
19202,147,82,65,2012,56583
19203,1649,821,828,2012,56584
19204,1032,497,535,2012,56585
19205,1747,921,826,2012,56586
19206,1518,751,767,2012,56587
19207,593,297,296,2012,56588
19208,2278,1116,1162,2012,56589
19209,336,179,157,2012,56590
19210,169,118,51,2012,56591
19211,574,305,269,2012,56592
19212,42,10,32,2012,56593
19213,325,182,143,2012,56594
19214,33164,16340,16824,2012,56601
19215,4575,2331,2244,2012,56621
19216,2495,1253,1242,2012,56623
19217,328,116,212,2012,56626
19218,292,144,148,2012,56627
19219,1542,747,795,2012,56628
19220,268,132,136,2012,56629
19221,1983,1032,951,2012,56630
19222,4283,2235,2048,2012,56633
19223,1729,890,839,2012,56634
19224,5119,2635,2484,2012,56636
19225,182,100,82,2012,56637
19226,454,241,213,2012,56639
19227,349,170,179,2012,56641
19228,849,436,413,2012,56644
19229,345,179,166,2012,56646
19230,721,355,366,2012,56647
19231,9860,4803,5057,2012,56649
19232,755,393,362,2012,56650
19233,596,293,303,2012,56651
19234,500,260,240,2012,56652
19235,1468,805,663,2012,56653
19236,116,56,60,2012,56654
19237,1333,659,674,2012,56655
19238,180,83,97,2012,56657
19239,0,0,0,2012,56658
19240,66,33,33,2012,56659
19241,319,179,140,2012,56660
19242,888,451,437,2012,56661
19243,466,256,210,2012,56662
19244,168,97,71,2012,56663
19245,1077,577,500,2012,56666
19246,663,370,293,2012,56667
19247,160,85,75,2012,56668
19248,372,198,174,2012,56669
19249,1800,957,843,2012,56670
19250,2938,1522,1416,2012,56671
19251,2124,1004,1120,2012,56672
19252,1060,621,439,2012,56673
19253,1451,745,706,2012,56676
19254,1193,559,634,2012,56678
19255,85,38,47,2012,56680
19256,259,119,140,2012,56681
19257,741,382,359,2012,56683
19258,257,148,109,2012,56684
19259,156,85,71,2012,56685
19260,1005,571,434,2012,56686
19261,45,22,23,2012,56687
19262,153,96,57,2012,56688
19263,12520,6150,6370,2012,56701
19264,509,235,274,2012,56710
19265,56,25,31,2012,56711
19266,883,412,471,2012,56713
19267,1190,653,537,2012,56714
19268,280,151,129,2012,56715
19269,9297,4617,4680,2012,56716
19270,72,41,31,2012,56720
19271,10054,5163,4891,2012,56721
19272,381,219,162,2012,56722
19273,871,445,426,2012,56723
19274,119,55,64,2012,56724
19275,1136,545,591,2012,56725
19276,1536,773,763,2012,56726
19277,799,448,351,2012,56727
19278,1429,711,718,2012,56728
19279,138,71,67,2012,56729
19280,75,37,38,2012,56731
19281,1075,486,589,2012,56732
19282,405,217,188,2012,56733
19283,469,270,199,2012,56734
19284,764,370,394,2012,56735
19285,933,464,469,2012,56736
19286,853,442,411,2012,56737
19287,1402,759,643,2012,56738
19288,13,13,0,2012,56741
19289,973,523,450,2012,56742
19290,627,340,287,2012,56744
19291,743,391,352,2012,56748
19292,2590,1308,1282,2012,56750
19293,5666,2877,2789,2012,56751
19294,506,256,250,2012,56754
19295,131,68,63,2012,56755
19296,759,370,389,2012,56756
19297,908,460,448,2012,56757
19298,382,197,185,2012,56758
19299,386,209,177,2012,56759
19300,402,196,206,2012,56760
19301,453,245,208,2012,56761
19302,2697,1352,1345,2012,56762
19303,5238,2622,2616,2012,56763
19304,1537,780,757,2012,57001
19305,959,574,385,2012,57002
19306,1766,925,841,2012,57003
19307,3473,1752,1721,2012,57004
19308,10615,5198,5417,2012,57005
19309,24372,12468,11904,2012,57006
19310,531,302,229,2012,57010
19311,973,500,473,2012,57012
19312,4229,2243,1986,2012,57013
19313,1583,777,806,2012,57014
19314,856,443,413,2012,57015
19315,729,351,378,2012,57016
19316,1591,828,763,2012,57017
19317,1462,717,745,2012,57018
19318,1474,751,723,2012,57020
19319,372,206,166,2012,57021
19320,4682,2288,2394,2012,57022
19321,484,246,238,2012,57024
19322,2826,1434,1392,2012,57025
19323,1377,722,655,2012,57026
19324,158,106,52,2012,57027
19325,3235,1581,1654,2012,57028
19326,1887,944,943,2012,57029
19327,3514,1719,1795,2012,57030
19328,740,379,361,2012,57031
19329,6607,3189,3418,2012,57032
19330,5168,2607,2561,2012,57033
19331,765,430,335,2012,57034
19332,1197,565,632,2012,57035
19333,635,343,292,2012,57036
19334,1137,584,553,2012,57037
19335,1813,941,872,2012,57038
19336,3049,1492,1557,2012,57039
19337,342,179,163,2012,57040
19338,42,14,28,2012,57041
19339,8609,4214,4395,2012,57042
19340,1391,718,673,2012,57043
19341,1012,523,489,2012,57045
19342,567,269,298,2012,57046
19343,276,129,147,2012,57047
19344,1134,600,534,2012,57048
19345,5751,2831,2920,2012,57049
19346,254,156,98,2012,57050
19347,269,136,133,2012,57051
19348,401,237,164,2012,57052
19349,1771,940,831,2012,57053
19350,573,312,261,2012,57054
19351,1034,590,444,2012,57055
19352,152,87,65,2012,57057
19353,2078,1019,1059,2012,57058
19354,1448,633,815,2012,57059
19355,122,66,56,2012,57061
19356,2287,1645,642,2012,57062
19357,994,518,476,2012,57063
19358,5108,2632,2476,2012,57064
19359,375,223,152,2012,57065
19360,1649,855,794,2012,57066
19361,483,276,207,2012,57067
19362,1354,667,687,2012,57068
19363,11905,5847,6058,2012,57069
19364,1521,687,834,2012,57070
19365,2821,1395,1426,2012,57071
19366,762,337,425,2012,57072
19367,777,382,395,2012,57073
19368,855,494,361,2012,57075
19369,383,217,166,2012,57076
19370,1188,655,533,2012,57077
19371,18699,9846,8853,2012,57078
19372,34824,17609,17215,2012,57103
19373,26806,14652,12154,2012,57104
19374,21220,10365,10855,2012,57105
19375,39873,19327,20546,2012,57106
19376,8129,3955,4174,2012,57107
19377,17090,8245,8845,2012,57108
19378,12736,6078,6658,2012,57110
19379,43,43,0,2012,57117
19380,665,242,423,2012,57197
19381,24701,12133,12568,2012,57201
19382,1837,922,915,2012,57212
19383,397,184,213,2012,57213
19384,67,25,42,2012,57214
19385,982,513,469,2012,57216
19386,269,135,134,2012,57217
19387,305,152,153,2012,57218
19388,777,387,390,2012,57219
19389,948,479,469,2012,57220
19390,855,427,428,2012,57221
19391,1221,681,540,2012,57223
19392,202,109,93,2012,57224
19393,1801,843,958,2012,57225
19394,2316,1185,1131,2012,57226
19395,308,144,164,2012,57227
19396,1631,821,810,2012,57231
19397,292,137,155,2012,57232
19398,175,86,89,2012,57233
19399,1310,655,655,2012,57234
19400,1027,548,479,2012,57235
19401,106,53,53,2012,57236
19402,480,227,253,2012,57237
19403,371,196,175,2012,57238
19404,325,193,132,2012,57239
19405,982,514,468,2012,57241
19406,289,167,122,2012,57242
19407,685,342,343,2012,57243
19408,132,59,73,2012,57245
19409,134,70,64,2012,57246
19410,207,104,103,2012,57247
19411,1388,638,750,2012,57248
19412,997,510,487,2012,57249
19413,161,100,61,2012,57251
19414,4919,2457,2462,2012,57252
19415,506,290,216,2012,57255
19416,101,62,39,2012,57256
19417,1067,470,597,2012,57257
19418,353,187,166,2012,57258
19419,440,244,196,2012,57259
19420,1144,595,549,2012,57260
19421,247,122,125,2012,57261
19422,5208,2572,2636,2012,57262
19423,479,272,207,2012,57263
19424,231,146,85,2012,57264
19425,245,161,84,2012,57265
19426,628,329,299,2012,57266
19427,542,308,234,2012,57268
19428,383,171,212,2012,57269
19429,645,404,241,2012,57270
19430,304,173,131,2012,57271
19431,116,68,48,2012,57272
19432,1152,585,567,2012,57273
19433,2683,1314,1369,2012,57274
19434,1254,663,591,2012,57276
19435,795,411,384,2012,57278
19436,1029,538,491,2012,57279
19437,18109,9025,9084,2012,57301
19438,1502,713,789,2012,57311
19439,441,235,206,2012,57312
19440,1134,560,574,2012,57313
19441,742,413,329,2012,57314
19442,1006,532,474,2012,57315
19443,602,317,285,2012,57317
19444,1153,546,607,2012,57319
19445,414,223,191,2012,57321
19446,275,176,99,2012,57322
19447,218,96,122,2012,57323
19448,370,161,209,2012,57324
19449,3488,1633,1855,2012,57325
19450,1094,540,554,2012,57328
19451,492,245,247,2012,57329
19452,864,400,464,2012,57330
19453,621,345,276,2012,57331
19454,824,446,378,2012,57332
19455,879,454,425,2012,57334
19456,278,138,140,2012,57335
19457,71,35,36,2012,57337
19458,1410,710,700,2012,57339
19459,351,166,185,2012,57340
19460,183,90,93,2012,57341
19461,511,267,244,2012,57342
19462,153,90,63,2012,57344
19463,1332,653,679,2012,57345
19464,20,15,5,2012,57346
19465,513,265,248,2012,57348
19466,1558,779,779,2012,57349
19467,14889,7439,7450,2012,57350
19468,827,388,439,2012,57353
19469,1115,563,552,2012,57355
19470,1885,913,972,2012,57356
19471,78,31,47,2012,57358
19472,719,390,329,2012,57359
19473,115,71,44,2012,57361
19474,2062,1045,1017,2012,57362
19475,1007,546,461,2012,57363
19476,86,31,55,2012,57364
19477,585,310,275,2012,57365
19478,2406,1129,1277,2012,57366
19479,178,103,75,2012,57367
19480,1208,569,639,2012,57368
19481,2200,1056,1144,2012,57369
19482,844,476,368,2012,57370
19483,162,83,79,2012,57371
19484,532,280,252,2012,57373
19485,242,107,135,2012,57374
19486,633,337,296,2012,57375
19487,951,454,497,2012,57376
19488,38,23,15,2012,57379
19489,3510,1750,1760,2012,57380
19490,516,254,262,2012,57381
19491,1483,730,753,2012,57382
19492,796,388,408,2012,57383
19493,850,456,394,2012,57384
19494,1184,611,573,2012,57385
19495,103,56,47,2012,57386
19496,30103,14558,15545,2012,57401
19497,115,49,66,2012,57420
19498,47,28,19,2012,57421
19499,167,101,66,2012,57422
19500,329,184,145,2012,57424
19501,75,39,36,2012,57426
19502,687,345,342,2012,57427
19503,774,405,369,2012,57428
19504,142,64,78,2012,57429
19505,2376,1187,1189,2012,57430
19506,490,280,210,2012,57432
19507,521,305,216,2012,57433
19508,497,278,219,2012,57434
19509,222,111,111,2012,57435
19510,481,259,222,2012,57436
19511,1373,673,700,2012,57437
19512,1442,755,687,2012,57438
19513,65,33,32,2012,57439
19514,468,242,226,2012,57440
19515,762,402,360,2012,57441
19516,1671,810,861,2012,57442
19517,2080,1034,1046,2012,57445
19518,382,190,192,2012,57446
19519,453,225,228,2012,57448
19520,155,88,67,2012,57449
19521,654,304,350,2012,57450
19522,2136,1125,1011,2012,57451
19523,249,119,130,2012,57452
19524,622,323,299,2012,57454
19525,95,57,38,2012,57455
19526,826,451,375,2012,57456
19527,93,59,34,2012,57457
19528,297,168,129,2012,57460
19529,407,213,194,2012,57461
19530,386,193,193,2012,57465
19531,117,66,51,2012,57466
19532,283,161,122,2012,57467
19533,278,140,138,2012,57468
19534,3291,1597,1694,2012,57469
19535,191,96,95,2012,57470
19536,770,360,410,2012,57471
19537,975,496,479,2012,57472
19538,303,108,195,2012,57473
19539,140,65,75,2012,57474
19540,92,56,36,2012,57475
19541,468,239,229,2012,57476
19542,165,88,77,2012,57477
19543,598,295,303,2012,57479
19544,532,325,207,2012,57481
19545,16205,7957,8248,2012,57501
19546,131,63,68,2012,57520
19547,205,123,82,2012,57521
19548,442,221,221,2012,57522
19549,1189,581,608,2012,57523
19550,977,502,475,2012,57528
19551,535,289,246,2012,57529
19552,224,104,120,2012,57531
19553,2791,1416,1375,2012,57532
19554,1864,982,882,2012,57533
19555,132,67,65,2012,57534
19556,607,294,313,2012,57536
19557,118,57,61,2012,57537
19558,202,103,99,2012,57538
19559,85,42,43,2012,57540
19560,51,34,17,2012,57541
19561,940,477,463,2012,57543
19562,591,341,250,2012,57544
19563,229,129,100,2012,57547
19564,1406,741,665,2012,57548
19565,1981,980,1001,2012,57551
19566,572,298,274,2012,57552
19567,239,125,114,2012,57553
19568,3205,1606,1599,2012,57555
19569,727,356,371,2012,57559
19570,387,204,183,2012,57560
19571,106,34,72,2012,57562
19572,267,110,157,2012,57563
19573,1052,581,471,2012,57564
19574,1423,656,767,2012,57566
19575,1140,569,571,2012,57567
19576,622,308,314,2012,57568
19577,328,147,181,2012,57569
19578,2144,1090,1054,2012,57570
19579,19,3,16,2012,57571
19580,2224,1094,1130,2012,57572
19581,78,39,39,2012,57574
19582,93,62,31,2012,57576
19583,1137,535,602,2012,57577
19584,1337,633,704,2012,57579
19585,4356,2194,2162,2012,57580
19586,44,17,27,2012,57584
19587,271,136,135,2012,57585
19588,3928,1944,1984,2012,57601
19589,432,204,228,2012,57620
19590,464,212,252,2012,57621
19591,267,146,121,2012,57622
19592,1126,517,609,2012,57623
19593,4287,2072,2215,2012,57625
19594,966,499,467,2012,57626
19595,34,14,20,2012,57630
19596,350,177,173,2012,57631
19597,657,314,343,2012,57632
19598,558,270,288,2012,57633
19599,101,41,60,2012,57634
19600,35,20,15,2012,57636
19601,1834,926,908,2012,57638
19602,351,186,165,2012,57639
19603,220,123,97,2012,57640
19604,343,183,160,2012,57641
19605,1894,928,966,2012,57642
19606,164,80,84,2012,57644
19607,264,147,117,2012,57645
19608,188,94,94,2012,57646
19609,257,113,144,2012,57648
19610,306,148,158,2012,57649
19611,81,38,43,2012,57650
19612,120,45,75,2012,57651
19613,368,192,176,2012,57652
19614,688,350,338,2012,57656
19615,287,154,133,2012,57657
19616,328,192,136,2012,57658
19617,65,34,31,2012,57660
19618,129,78,51,2012,57661
19619,43530,21707,21823,2012,57701
19620,32509,16097,16412,2012,57702
19621,14333,7131,7202,2012,57703
19622,2836,1799,1037,2012,57706
19623,1174,594,580,2012,57714
19624,401,180,221,2012,57716
19625,7453,3829,3624,2012,57717
19626,6357,3340,3017,2012,57718
19627,6546,3474,3072,2012,57719
19628,586,297,289,2012,57720
19629,333,200,133,2012,57722
19630,287,173,114,2012,57724
19631,116,56,60,2012,57725
19632,5981,2953,3028,2012,57730
19633,2155,1158,997,2012,57732
19634,1627,832,795,2012,57735
19635,113,59,54,2012,57738
19636,82,55,27,2012,57741
19637,1552,822,730,2012,57744
19638,2051,1016,1035,2012,57745
19639,5336,2692,2644,2012,57747
19640,282,165,117,2012,57748
19641,393,211,182,2012,57750
19642,893,433,460,2012,57751
19643,2044,961,1083,2012,57752
19644,3563,1893,1670,2012,57754
19645,113,58,55,2012,57755
19646,888,397,491,2012,57756
19647,280,165,115,2012,57758
19648,791,475,316,2012,57759
19649,1849,805,1044,2012,57760
19650,1158,592,566,2012,57761
19651,438,222,216,2012,57762
19652,408,167,241,2012,57763
19653,1838,742,1096,2012,57764
19654,184,95,89,2012,57766
19655,178,75,103,2012,57767
19656,3353,1610,1743,2012,57769
19657,5838,2757,3081,2012,57770
19658,1751,1022,729,2012,57772
19659,315,141,174,2012,57773
19660,356,206,150,2012,57775
19661,11,4,7,2012,57776
19662,327,180,147,2012,57779
19663,161,83,78,2012,57780
19664,42,20,22,2012,57782
19665,14052,6828,7224,2012,57783
19666,9420,4542,4878,2012,57785
19667,374,174,200,2012,57787
19668,662,334,328,2012,57788
19669,1160,597,563,2012,57790
19670,186,99,87,2012,57791
19671,31,15,16,2012,57792
19672,2335,1081,1254,2012,57793
19673,908,474,434,2012,57794
19674,559,196,363,2012,57799
19675,90,40,50,2012,58001
19676,0,0,0,2012,58002
19677,275,140,135,2012,58004
19678,652,341,311,2012,58005
19679,422,183,239,2012,58006
19680,66,36,30,2012,58007
19681,277,146,131,2012,58008
19682,38,19,19,2012,58009
19683,385,194,191,2012,58011
19684,2337,1212,1125,2012,58012
19685,114,65,49,2012,58013
19686,267,141,126,2012,58015
19687,222,130,92,2012,58016
19688,377,198,179,2012,58017
19689,244,154,90,2012,58018
19690,377,190,187,2012,58021
19691,1152,544,608,2012,58027
19692,192,127,65,2012,58029
19693,548,282,266,2012,58030
19694,352,186,166,2012,58031
19695,726,382,344,2012,58032
19696,448,228,220,2012,58033
19697,153,75,78,2012,58035
19698,284,144,140,2012,58036
19699,282,161,121,2012,58038
19700,840,419,421,2012,58040
19701,1632,846,786,2012,58041
19702,1384,673,711,2012,58042
19703,146,85,61,2012,58043
19704,2545,1256,1289,2012,58045
19705,553,283,270,2012,58046
19706,3996,2180,1816,2012,58047
19707,494,254,240,2012,58048
19708,232,113,119,2012,58049
19709,1248,632,616,2012,58051
19710,646,334,312,2012,58052
19711,1484,717,767,2012,58053
19712,3105,1574,1531,2012,58054
19713,135,81,54,2012,58056
19714,193,117,76,2012,58057
19715,129,74,55,2012,58058
19716,1218,660,558,2012,58059
19717,1345,722,623,2012,58060
19718,429,225,204,2012,58061
19719,228,110,118,2012,58062
19720,372,195,177,2012,58063
19721,457,239,218,2012,58064
19722,47,27,20,2012,58065
19723,235,130,105,2012,58067
19724,374,191,183,2012,58068
19725,118,66,52,2012,58069
19726,427,224,203,2012,58071
19727,7934,3909,4025,2012,58072
19728,8926,4672,4254,2012,58075
19729,324,243,81,2012,58076
19730,699,359,340,2012,58077
19731,26302,13686,12616,2012,58078
19732,423,221,202,2012,58079
19733,970,530,440,2012,58081
19734,30781,16008,14773,2012,58102
19735,47442,23503,23939,2012,58103
19736,28513,13524,14989,2012,58104
19737,1809,1054,755,2012,58105
19738,35515,17422,18093,2012,58201
19739,1795,1002,793,2012,58202
19740,17720,9683,8037,2012,58203
19741,2270,1251,1019,2012,58204
19742,300,254,46,2012,58205
19743,297,154,143,2012,58210
19744,495,261,234,2012,58212
19745,313,158,155,2012,58214
19746,93,49,44,2012,58216
19747,594,341,253,2012,58218
19748,28,21,7,2012,58219
19749,2235,1112,1123,2012,58220
19750,411,234,177,2012,58222
19751,219,107,112,2012,58223
19752,19,15,4,2012,58224
19753,920,486,434,2012,58225
19754,481,245,236,2012,58227
19755,840,460,380,2012,58228
19756,172,94,78,2012,58229
19757,675,354,321,2012,58230
19758,631,346,285,2012,58231
19759,280,141,139,2012,58233
19760,459,234,225,2012,58235
19761,5402,2634,2768,2012,58237
19762,191,78,113,2012,58238
19763,50,32,18,2012,58239
19764,1384,690,694,2012,58240
19765,102,58,44,2012,58241
19766,696,364,332,2012,58243
19767,213,130,83,2012,58244
19768,2581,1314,1267,2012,58249
19769,298,171,127,2012,58250
19770,2110,1037,1073,2012,58251
19771,472,216,256,2012,58254
19772,868,452,416,2012,58256
19773,1831,893,938,2012,58257
19774,240,155,85,2012,58258
19775,384,186,198,2012,58259
19776,170,88,82,2012,58260
19777,1092,537,555,2012,58261
19778,143,62,81,2012,58262
19779,457,228,229,2012,58265
19780,220,118,102,2012,58266
19781,1265,573,692,2012,58267
19782,158,73,85,2012,58269
19783,2018,988,1030,2012,58270
19784,751,396,355,2012,58271
19785,400,213,187,2012,58272
19786,199,118,81,2012,58273
19787,1186,631,555,2012,58274
19788,819,391,428,2012,58275
19789,538,280,258,2012,58276
19790,233,120,113,2012,58277
19791,1861,969,892,2012,58278
19792,128,50,78,2012,58281
19793,1573,810,763,2012,58282
19794,9744,4915,4829,2012,58301
19795,79,36,43,2012,58311
19796,6549,3246,3303,2012,58316
19797,231,125,106,2012,58317
19798,3518,1793,1725,2012,58318
19799,212,98,114,2012,58321
19800,37,24,13,2012,58323
19801,1341,608,733,2012,58324
19802,52,33,19,2012,58325
19803,355,193,162,2012,58327
19804,3163,1551,1612,2012,58329
19805,369,197,172,2012,58330
19806,120,61,59,2012,58331
19807,317,152,165,2012,58332
19808,1456,699,757,2012,58335
19809,97,43,54,2012,58338
19810,25,13,12,2012,58339
19811,2531,1205,1326,2012,58341
19812,81,38,43,2012,58343
19813,898,482,416,2012,58344
19814,153,67,86,2012,58345
19815,656,335,321,2012,58346
19816,744,371,373,2012,58348
19817,505,296,209,2012,58351
19818,474,249,225,2012,58352
19819,48,21,27,2012,58353
19820,57,29,28,2012,58355
19821,1682,780,902,2012,58356
19822,390,174,216,2012,58357
19823,263,142,121,2012,58361
19824,33,12,21,2012,58362
19825,145,79,66,2012,58363
19826,291,157,134,2012,58365
19827,1178,604,574,2012,58366
19828,1643,809,834,2012,58367
19829,3827,1931,1896,2012,58368
19830,1414,671,743,2012,58369
19831,1479,747,732,2012,58370
19832,111,58,53,2012,58372
19833,665,352,313,2012,58374
19834,457,225,232,2012,58377
19835,365,204,161,2012,58379
19836,345,174,171,2012,58380
19837,326,187,139,2012,58381
19838,176,111,65,2012,58382
19839,529,301,228,2012,58384
19840,325,186,139,2012,58385
19841,194,127,67,2012,58386
19842,17089,8449,8640,2012,58401
19843,401,304,97,2012,58402
19844,347,167,180,2012,58405
19845,1098,558,540,2012,58413
19846,138,68,70,2012,58415
19847,428,240,188,2012,58416
19848,372,171,201,2012,58418
19849,317,154,163,2012,58420
19850,2914,1467,1447,2012,58421
19851,304,140,164,2012,58422
19852,75,36,39,2012,58423
19853,252,121,131,2012,58424
19854,1478,679,799,2012,58425
19855,217,114,103,2012,58426
19856,309,183,126,2012,58428
19857,291,154,137,2012,58429
19858,132,68,64,2012,58430
19859,120,60,60,2012,58431
19860,1008,480,528,2012,58433
19861,2053,1128,925,2012,58436
19862,669,317,352,2012,58438
19863,169,100,69,2012,58439
19864,192,103,89,2012,58440
19865,327,189,138,2012,58441
19866,532,280,252,2012,58442
19867,204,121,83,2012,58443
19868,224,113,111,2012,58444
19869,121,58,63,2012,58445
19870,268,142,126,2012,58448
19871,204,117,87,2012,58451
19872,41,18,23,2012,58452
19873,429,266,163,2012,58454
19874,316,151,165,2012,58455
19875,521,270,251,2012,58456
19876,1327,709,618,2012,58458
19877,263,144,119,2012,58460
19878,483,227,256,2012,58461
19879,562,277,285,2012,58463
19880,277,157,120,2012,58464
19881,482,268,214,2012,58466
19882,599,291,308,2012,58467
19883,427,234,193,2012,58472
19884,2700,1222,1478,2012,58474
19885,166,84,82,2012,58475
19886,260,165,95,2012,58476
19887,176,96,80,2012,58477
19888,153,81,72,2012,58478
19889,265,145,120,2012,58479
19890,339,194,145,2012,58480
19891,253,129,124,2012,58481
19892,914,471,443,2012,58482
19893,267,147,120,2012,58483
19894,75,38,37,2012,58484
19895,115,62,53,2012,58486
19896,517,274,243,2012,58487
19897,254,127,127,2012,58488
19898,305,150,155,2012,58490
19899,501,228,273,2012,58492
19900,362,207,155,2012,58494
19901,1276,592,684,2012,58495
19902,250,156,94,2012,58496
19903,258,142,116,2012,58497
19904,28215,13604,14611,2012,58501
19905,25798,12658,13140,2012,58503
19906,24821,12325,12496,2012,58504
19907,0,0,0,2012,58505
19908,300,172,128,2012,58520
19909,658,375,283,2012,58521
19910,3611,1870,1741,2012,58523
19911,56,28,28,2012,58524
19912,900,396,504,2012,58528
19913,621,276,345,2012,58529
19914,1081,550,531,2012,58530
19915,369,213,156,2012,58531
19916,285,129,156,2012,58532
19917,930,431,499,2012,58533
19918,577,297,280,2012,58535
19919,2605,1412,1193,2012,58538
19920,2286,1141,1145,2012,58540
19921,346,174,172,2012,58541
19922,273,163,110,2012,58542
19923,618,322,296,2012,58544
19924,3526,1795,1731,2012,58545
19925,154,93,61,2012,58549
19926,1646,779,867,2012,58552
19927,22888,11403,11485,2012,58554
19928,758,417,341,2012,58558
19929,148,82,66,2012,58559
19930,177,95,82,2012,58560
19931,1080,503,577,2012,58561
19932,360,199,161,2012,58562
19933,2094,1058,1036,2012,58563
19934,155,94,61,2012,58564
19935,184,109,75,2012,58565
19936,106,57,49,2012,58566
19937,405,185,220,2012,58568
19938,53,30,23,2012,58569
19939,373,191,182,2012,58570
19940,724,379,345,2012,58571
19941,373,193,180,2012,58572
19942,849,444,405,2012,58573
19943,835,411,424,2012,58575
19944,917,431,486,2012,58576
19945,1768,907,861,2012,58577
19946,1062,552,510,2012,58579
19947,315,165,150,2012,58580
19948,224,111,113,2012,58581
19949,21650,10810,10840,2012,58601
19950,221,118,103,2012,58620
19951,1131,537,594,2012,58621
19952,1523,800,723,2012,58622
19953,2308,1146,1162,2012,58623
19954,192,82,110,2012,58625
19955,265,142,123,2012,58626
19956,214,120,94,2012,58627
19957,422,237,185,2012,58630
19958,991,502,489,2012,58631
19959,165,78,87,2012,58632
19960,176,113,63,2012,58634
19961,741,406,335,2012,58636
19962,1163,602,561,2012,58638
19963,1821,907,914,2012,58639
19964,1576,781,795,2012,58640
19965,106,62,44,2012,58641
19966,334,171,163,2012,58642
19967,217,89,128,2012,58643
19968,247,159,88,2012,58645
19969,1197,573,624,2012,58646
19970,1080,521,559,2012,58647
19971,376,186,190,2012,58649
19972,419,218,201,2012,58650
19973,529,244,285,2012,58651
19974,938,510,428,2012,58652
19975,573,305,268,2012,58653
19976,331,189,142,2012,58654
19977,430,215,215,2012,58655
19978,367,208,159,2012,58656
19979,28946,14361,14585,2012,58701
19980,0,0,0,2012,58702
19981,19206,9825,9381,2012,58703
19982,4923,2617,2306,2012,58704
19983,383,360,23,2012,58705
19984,425,145,280,2012,58707
19985,484,251,233,2012,58710
19986,183,109,74,2012,58711
19987,141,68,73,2012,58712
19988,28,17,11,2012,58713
19989,131,65,66,2012,58716
19990,1153,619,534,2012,58718
19991,560,286,274,2012,58721
19992,1354,670,684,2012,58722
19993,306,159,147,2012,58723
19994,270,160,110,2012,58725
19995,277,140,137,2012,58727
19996,1250,703,547,2012,58730
19997,300,155,145,2012,58731
19998,383,200,183,2012,58733
19999,273,158,115,2012,58734
20000,447,248,199,2012,58735
20001,425,223,202,2012,58736
20002,129,58,71,2012,58737
20003,764,383,381,2012,58740
20004,648,357,291,2012,58741
20005,139,87,52,2012,58744
20006,1557,782,775,2012,58746
20007,98,45,53,2012,58748
20008,677,347,330,2012,58750
20009,187,88,99,2012,58752
20010,117,51,66,2012,58755
20011,277,155,122,2012,58756
20012,987,466,521,2012,58757
20013,266,133,133,2012,58758
20014,912,488,424,2012,58759
20015,275,140,135,2012,58760
20016,1092,572,520,2012,58761
20017,219,133,86,2012,58762
20018,3120,1609,1511,2012,58763
20019,314,190,124,2012,58765
20020,193,99,94,2012,58768
20021,256,156,100,2012,58769
20022,1428,712,716,2012,58770
20023,562,328,234,2012,58771
20024,128,66,62,2012,58772
20025,766,376,390,2012,58773
20026,384,181,203,2012,58775
20027,258,142,116,2012,58776
20028,140,70,70,2012,58778
20029,498,244,254,2012,58779
20030,787,405,382,2012,58781
20031,373,192,181,2012,58782
20032,406,224,182,2012,58783
20033,2464,1369,1095,2012,58784
20034,1121,578,543,2012,58785
20035,150,91,59,2012,58787
20036,1021,559,462,2012,58788
20037,318,165,153,2012,58789
20038,1738,816,922,2012,58790
20039,252,138,114,2012,58792
20040,648,325,323,2012,58793
20041,94,47,47,2012,58794
20042,176,90,86,2012,58795
20043,19271,9872,9399,2012,58801
20044,306,154,152,2012,58830
20045,622,380,242,2012,58831
20046,57,32,25,2012,58833
20047,364,232,132,2012,58835
20048,218,138,80,2012,58838
20049,446,228,218,2012,58843
20050,167,82,85,2012,58844
20051,292,156,136,2012,58845
20052,317,142,175,2012,58847
20053,1165,643,522,2012,58849
20054,1454,720,734,2012,58852
20055,339,195,144,2012,58853
20056,3084,1504,1580,2012,58854
20057,154,82,72,2012,58856
20058,1525,763,762,2012,59001
20059,280,132,148,2012,59002
20060,1107,536,571,2012,59003
20061,633,301,332,2012,59006
20062,114,51,63,2012,59007
20063,438,253,185,2012,59008
20064,72,41,31,2012,59010
20065,3104,1663,1441,2012,59011
20066,238,133,105,2012,59012
20067,127,53,74,2012,59013
20068,1645,794,851,2012,59014
20069,603,358,245,2012,59015
20070,732,383,349,2012,59016
20071,664,305,359,2012,59018
20072,3945,2055,1890,2012,59019
20073,28,14,14,2012,59020
20074,2087,1056,1031,2012,59022
20075,502,238,264,2012,59024
20076,104,59,45,2012,59025
20077,327,170,157,2012,59026
20078,664,361,303,2012,59027
20079,407,199,208,2012,59028
20080,867,487,380,2012,59029
20081,1464,740,724,2012,59030
20082,400,157,243,2012,59031
20083,329,170,159,2012,59032
20084,301,131,170,2012,59033
20085,5377,2530,2847,2012,59034
20086,117,75,42,2012,59035
20087,1273,561,712,2012,59036
20088,1881,893,988,2012,59037
20089,604,322,282,2012,59038
20090,34,22,12,2012,59039
20091,1786,861,925,2012,59041
20092,3206,1675,1531,2012,59043
20093,10911,5222,5689,2012,59044
20094,458,206,252,2012,59046
20095,11964,5940,6024,2012,59047
20096,1521,847,674,2012,59050
20097,150,87,63,2012,59052
20098,530,312,218,2012,59053
20099,280,146,134,2012,59054
20100,53,41,12,2012,59055
20101,617,322,295,2012,59057
20102,85,32,53,2012,59058
20103,163,87,76,2012,59059
20104,236,161,75,2012,59061
20105,58,25,33,2012,59062
20106,2136,1079,1057,2012,59063
20107,226,144,82,2012,59064
20108,82,46,36,2012,59065
20109,811,453,358,2012,59066
20110,311,139,172,2012,59067
20111,3295,1713,1582,2012,59068
20112,473,263,210,2012,59069
20113,849,450,399,2012,59070
20114,74,49,25,2012,59071
20115,4112,2069,2043,2012,59072
20116,321,172,149,2012,59074
20117,152,75,77,2012,59075
20118,64,37,27,2012,59076
20119,91,46,45,2012,59077
20120,116,77,39,2012,59078
20121,3492,1845,1647,2012,59079
20122,15,7,8,2012,59081
20123,49,21,28,2012,59082
20124,127,70,57,2012,59085
20125,805,340,465,2012,59086
20126,503,266,237,2012,59087
20127,1058,457,601,2012,59088
20128,470,218,252,2012,59089
20129,39453,19872,19581,2012,59101
20130,47155,22104,25051,2012,59102
20131,29760,14919,14841,2012,59105
20132,12581,6132,6449,2012,59106
20133,4981,2439,2542,2012,59201
20134,247,136,111,2012,59211
20135,485,218,267,2012,59212
20136,848,459,389,2012,59213
20137,126,66,60,2012,59214
20138,1210,606,604,2012,59215
20139,133,62,71,2012,59217
20140,994,535,459,2012,59218
20141,188,102,86,2012,59219
20142,1573,791,782,2012,59221
20143,209,108,101,2012,59222
20144,308,168,140,2012,59223
20145,434,188,246,2012,59225
20146,427,209,218,2012,59226
20147,4704,2323,2381,2012,59230
20148,303,133,170,2012,59231
20149,13,7,6,2012,59240
20150,419,227,192,2012,59241
20151,103,45,58,2012,59242
20152,290,170,120,2012,59243
20153,66,35,31,2012,59244
20154,379,214,165,2012,59247
20155,692,371,321,2012,59248
20156,219,116,103,2012,59250
20157,133,69,64,2012,59252
20158,105,61,44,2012,59253
20159,1894,888,1006,2012,59254
20160,3370,1586,1784,2012,59255
20161,68,52,16,2012,59256
20162,18,9,9,2012,59257
20163,128,71,57,2012,59258
20164,321,173,148,2012,59259
20165,128,59,69,2012,59260
20166,492,275,217,2012,59261
20167,771,379,392,2012,59262
20168,1364,676,688,2012,59263
20169,7467,3927,3540,2012,59270
20170,243,131,112,2012,59274
20171,336,175,161,2012,59275
20172,25,18,7,2012,59276
20173,11433,5644,5789,2012,59301
20174,197,109,88,2012,59311
20175,24,9,15,2012,59312
20176,2605,1263,1342,2012,59313
20177,90,53,37,2012,59314
20178,127,61,66,2012,59315
20179,1128,583,545,2012,59317
20180,82,39,43,2012,59318
20181,50,28,22,2012,59322
20182,2512,1165,1347,2012,59323
20183,880,417,463,2012,59324
20184,325,169,156,2012,59326
20185,2852,1446,1406,2012,59327
20186,8332,4347,3985,2012,59330
20187,157,81,76,2012,59332
20188,22,6,16,2012,59333
20189,187,105,82,2012,59336
20190,757,386,371,2012,59337
20191,124,69,55,2012,59338
20192,190,100,90,2012,59339
20193,45,27,18,2012,59343
20194,315,164,151,2012,59344
20195,302,116,186,2012,59347
20196,864,431,433,2012,59349
20197,141,79,62,2012,59351
20198,899,470,429,2012,59353
20199,85,51,34,2012,59354
20200,13858,6694,7164,2012,59401
20201,26930,13418,13512,2012,59404
20202,30504,15078,15426,2012,59405
20203,747,383,364,2012,59410
20204,172,110,62,2012,59411
20205,2019,1084,935,2012,59412
20206,1063,503,560,2012,59414
20207,449,232,217,2012,59416
20208,7896,3843,4053,2012,59417
20209,121,67,54,2012,59418
20210,174,93,81,2012,59419
20211,211,79,132,2012,59420
20212,1736,849,887,2012,59421
20213,2682,1267,1415,2012,59422
20214,59,31,28,2012,59424
20215,3455,1642,1813,2012,59425
20216,4585,2191,2394,2012,59427
20217,490,248,242,2012,59430
20218,154,70,84,2012,59432
20219,635,320,315,2012,59433
20220,769,386,383,2012,59434
20221,1630,896,734,2012,59436
20222,130,68,62,2012,59440
20223,67,44,23,2012,59441
20224,1708,871,837,2012,59442
20225,889,450,439,2012,59443
20226,261,136,125,2012,59444
20227,571,309,262,2012,59446
20228,155,72,83,2012,59447
20229,681,340,341,2012,59448
20230,514,249,265,2012,59450
20231,196,110,86,2012,59451
20232,556,248,308,2012,59452
20233,368,175,193,2012,59453
20234,185,110,75,2012,59454
20235,129,64,65,2012,59456
20236,9319,4688,4631,2012,59457
20237,165,103,62,2012,59460
20238,11,8,3,2012,59461
20239,166,78,88,2012,59462
20240,92,66,26,2012,59463
20241,414,223,191,2012,59464
20242,67,39,28,2012,59465
20243,98,58,40,2012,59466
20244,277,99,178,2012,59467
20245,686,339,347,2012,59468
20246,144,77,67,2012,59469
20247,315,122,193,2012,59471
20248,841,461,380,2012,59472
20249,3858,2219,1639,2012,59474
20250,455,247,208,2012,59477
20251,912,427,485,2012,59479
20252,529,260,269,2012,59480
20253,754,355,399,2012,59482
20254,374,203,171,2012,59483
20255,110,45,65,2012,59484
20256,575,274,301,2012,59485
20257,1508,688,820,2012,59486
20258,1435,748,687,2012,59487
20259,258,147,111,2012,59489
20260,12630,6404,6226,2012,59501
20261,1223,586,637,2012,59520
20262,3630,1820,1810,2012,59521
20263,1779,796,983,2012,59522
20264,2214,1128,1086,2012,59523
20265,677,312,365,2012,59524
20266,208,97,111,2012,59525
20267,2682,1334,1348,2012,59526
20268,812,402,410,2012,59527
20269,183,107,76,2012,59528
20270,129,76,53,2012,59529
20271,81,44,37,2012,59530
20272,326,154,172,2012,59531
20273,208,89,119,2012,59532
20274,48,28,20,2012,59535
20275,188,94,94,2012,59537
20276,2947,1461,1486,2012,59538
20277,433,233,200,2012,59540
20278,239,117,122,2012,59542
20279,153,96,57,2012,59544
20280,39,27,12,2012,59545
20281,115,34,81,2012,59546
20282,40,23,17,2012,59547
20283,29619,14656,14963,2012,59601
20284,24193,11847,12346,2012,59602
20285,244,123,121,2012,59631
20286,2207,1120,1087,2012,59632
20287,210,110,100,2012,59633
20288,4810,2561,2249,2012,59634
20289,7208,3701,3507,2012,59635
20290,10,6,4,2012,59636
20291,615,240,375,2012,59638
20292,993,506,487,2012,59639
20293,71,32,39,2012,59640
20294,45,26,19,2012,59642
20295,612,278,334,2012,59643
20296,3996,2118,1878,2012,59644
20297,1661,819,842,2012,59645
20298,410,167,243,2012,59647
20299,510,241,269,2012,59648
20300,33145,16664,16481,2012,59701
20301,125,62,63,2012,59703
20302,237,138,99,2012,59710
20303,8922,4572,4350,2012,59711
20304,202,94,108,2012,59713
20305,18973,9259,9714,2012,59714
20306,31027,16395,14632,2012,59715
20307,1880,1139,741,2012,59716
20308,27837,14632,13205,2012,59718
20309,262,146,116,2012,59720
20310,427,230,197,2012,59721
20311,5655,3654,2001,2012,59722
20312,143,71,72,2012,59724
20313,7773,3868,3905,2012,59725
20314,202,106,96,2012,59727
20315,398,207,191,2012,59728
20316,2080,1036,1044,2012,59729
20317,1776,983,793,2012,59730
20318,204,101,103,2012,59731
20319,65,28,37,2012,59732
20320,169,85,84,2012,59733
20321,458,240,218,2012,59735
20322,133,78,55,2012,59736
20323,359,157,202,2012,59739
20324,286,147,139,2012,59740
20325,4383,2170,2213,2012,59741
20326,138,84,54,2012,59743
20327,131,62,69,2012,59745
20328,76,42,34,2012,59746
20329,203,80,123,2012,59747
20330,245,151,94,2012,59748
20331,1468,705,763,2012,59749
20332,276,149,127,2012,59750
20333,249,114,135,2012,59751
20334,3047,1538,1509,2012,59752
20335,922,475,447,2012,59754
20336,224,118,106,2012,59755
20337,325,279,46,2012,59756
20338,2005,1042,963,2012,59758
20339,3370,1725,1645,2012,59759
20340,373,192,181,2012,59760
20341,350,191,159,2012,59761
20342,323,176,147,2012,59762
20343,30658,15504,15154,2012,59801
20344,18876,9957,8919,2012,59802
20345,16907,8424,8483,2012,59803
20346,7747,3760,3987,2012,59804
20347,18357,8568,9789,2012,59808
20348,1203,636,567,2012,59820
20349,2087,1046,1041,2012,59821
20350,1309,689,620,2012,59823
20351,1758,918,840,2012,59824
20352,2464,1246,1218,2012,59825
20353,474,251,223,2012,59826
20354,402,264,138,2012,59827
20355,5631,2693,2938,2012,59828
20356,2368,1235,1133,2012,59829
20357,119,71,48,2012,59830
20358,587,299,288,2012,59831
20359,950,468,482,2012,59832
20360,5494,2876,2618,2012,59833
20361,2146,1229,917,2012,59834
20362,358,169,189,2012,59837
20363,12683,6356,6327,2012,59840
20364,754,351,403,2012,59841
20365,86,47,39,2012,59842
20366,369,204,165,2012,59843
20367,904,501,403,2012,59844
20368,1232,627,605,2012,59845
20369,1337,638,699,2012,59846
20370,4976,2584,2392,2012,59847
20371,175,90,85,2012,59848
20372,324,161,163,2012,59851
20373,910,461,449,2012,59853
20374,298,151,147,2012,59854
20375,751,404,347,2012,59855
20376,412,195,217,2012,59856
20377,1336,688,648,2012,59858
20378,3031,1600,1431,2012,59859
20379,9756,4736,5020,2012,59860
20380,66,19,47,2012,59863
20381,7092,3329,3763,2012,59864
20382,3590,1727,1863,2012,59865
20383,1037,490,547,2012,59866
20384,16,3,13,2012,59867
20385,1746,944,802,2012,59868
20386,10508,5113,5395,2012,59870
20387,180,109,71,2012,59871
20388,2356,1279,1077,2012,59872
20389,3186,1578,1608,2012,59873
20390,1023,500,523,2012,59874
20391,3599,1743,1856,2012,59875
20392,49374,24000,25374,2012,59901
20393,579,331,248,2012,59910
20394,7832,4091,3741,2012,59911
20395,13357,6753,6604,2012,59912
20396,467,237,230,2012,59913
20397,156,78,78,2012,59914
20398,434,194,240,2012,59915
20399,59,40,19,2012,59916
20400,3922,2036,1886,2012,59917
20401,735,400,335,2012,59918
20402,1225,690,535,2012,59919
20403,1742,922,820,2012,59920
20404,2156,1062,1094,2012,59922
20405,10030,5050,4980,2012,59923
20406,1334,754,580,2012,59925
20407,466,261,205,2012,59926
20408,382,237,145,2012,59927
20409,59,9,50,2012,59928
20410,288,125,163,2012,59929
20411,907,408,499,2012,59930
20412,271,144,127,2012,59931
20413,1586,828,758,2012,59932
20414,62,34,28,2012,59933
20415,599,303,296,2012,59934
20416,3339,1710,1629,2012,59935
20417,512,248,264,2012,59936
20418,12911,6717,6194,2012,59937
20419,23925,12802,11123,2012,60002
20420,49650,24084,25566,2012,60004
20421,30490,14882,15608,2012,60005
20422,33837,16755,17082,2012,60007
20423,22379,11025,11354,2012,60008
20424,44209,21804,22405,2012,60010
20425,11142,5451,5691,2012,60012
20426,26975,13298,13677,2012,60013
20427,48834,24400,24434,2012,60014
20428,27218,13217,14001,2012,60015
20429,60437,29031,31406,2012,60016
20430,28957,14623,14334,2012,60018
20431,10533,5025,5508,2012,60020
20432,5680,2867,2813,2012,60021
20433,8213,4061,4152,2012,60022
20434,38689,18708,19981,2012,60025
20435,13382,6030,7352,2012,60026
20436,567,324,243,2012,60029
20437,35419,17480,17939,2012,60030
20438,37993,18181,19812,2012,60031
20439,13824,6888,6936,2012,60033
20440,1830,902,928,2012,60034
20441,29856,14406,15450,2012,60035
20442,5471,2621,2850,2012,60040
20443,8942,4612,4330,2012,60041
20444,8745,4024,4721,2012,60042
20445,2669,1297,1372,2012,60043
20446,9995,4708,5287,2012,60044
20447,20777,9995,10782,2012,60045
20448,34916,17217,17699,2012,60046
20449,41695,20528,21167,2012,60047
20450,29246,13998,15248,2012,60048
20451,32294,16290,16004,2012,60050
20452,24212,11735,12477,2012,60051
20453,23194,11178,12016,2012,60053
20454,55153,27204,27949,2012,60056
20455,38159,19560,18599,2012,60060
20456,25674,12641,13033,2012,60061
20457,40092,19544,20548,2012,60062
20458,16341,8049,8292,2012,60064
20459,38120,18926,19194,2012,60067
20460,37266,17826,19440,2012,60068
20461,8129,3868,4261,2012,60069
20462,15915,7970,7945,2012,60070
20463,3507,1813,1694,2012,60071
20464,980,489,491,2012,60072
20465,59142,29969,29173,2012,60073
20466,38843,18798,20045,2012,60074
20467,33412,16323,17089,2012,60076
20468,26400,12423,13977,2012,60077
20469,10070,5100,4970,2012,60081
20470,9833,4852,4981,2012,60083
20471,15848,7858,7990,2012,60084
20472,71038,35813,35225,2012,60085
20473,27717,13640,14077,2012,60087
20474,13743,10656,3087,2012,60088
20475,41672,19963,21709,2012,60089
20476,37543,18228,19315,2012,60090
20477,27202,13736,13466,2012,60091
20478,19064,9226,9838,2012,60093
20479,6941,3511,3430,2012,60096
20480,11082,5737,5345,2012,60097
20481,32047,15784,16263,2012,60098
20482,31308,15233,16075,2012,60099
20483,39705,19596,20109,2012,60101
20484,31689,15900,15789,2012,60102
20485,41872,20702,21170,2012,60103
20486,19105,8817,10288,2012,60104
20487,20351,10083,10268,2012,60106
20488,40313,19834,20479,2012,60107
20489,22591,11131,11460,2012,60108
20490,496,242,254,2012,60109
20491,38414,19644,18770,2012,60110
20492,414,199,215,2012,60111
20493,4532,2230,2302,2012,60112
20494,287,107,180,2012,60113
20495,46410,23353,23057,2012,60115
20496,15685,7732,7953,2012,60118
20497,10088,5162,4926,2012,60119
20498,51046,25346,25700,2012,60120
20499,48523,24467,24056,2012,60123
20500,19216,9300,9916,2012,60124
20501,46123,22544,23579,2012,60126
20502,183,95,88,2012,60129
20503,14194,6670,7524,2012,60130
20504,18037,8786,9251,2012,60131
20505,38156,18965,19191,2012,60133
20506,29634,14991,14643,2012,60134
20507,7101,3593,3508,2012,60135
20508,6829,3393,3436,2012,60136
20509,38572,18650,19922,2012,60137
20510,34755,17869,16886,2012,60139
20511,14198,6745,7453,2012,60140
20512,236,197,39,2012,60141
20513,25586,12163,13423,2012,60142
20514,10245,5135,5110,2012,60143
20515,38,20,18,2012,60144
20516,2513,1221,1292,2012,60145
20517,2717,1395,1322,2012,60146
20518,51365,24969,26396,2012,60148
20519,1542,772,770,2012,60150
20520,4281,2206,2075,2012,60151
20521,13008,6462,6546,2012,60152
20522,24187,11485,12702,2012,60153
20523,16684,8118,8566,2012,60154
20524,7928,3938,3990,2012,60155
20525,28894,14654,14240,2012,60156
20526,2153,1081,1072,2012,60157
20527,25266,12974,12292,2012,60160
20528,8136,4049,4087,2012,60162
20529,5189,2549,2640,2012,60163
20530,22194,11189,11005,2012,60164
20531,4942,2459,2483,2012,60165
20532,33934,16654,17280,2012,60169
20533,10245,4853,5392,2012,60171
20534,24287,11613,12674,2012,60172
20535,12243,6472,5771,2012,60173
20536,30853,15440,15413,2012,60174
20537,25961,13848,12113,2012,60175
20538,11782,6277,5505,2012,60176
20539,22230,11385,10845,2012,60177
20540,21907,10571,11336,2012,60178
20541,1428,671,757,2012,60180
20542,29288,14520,14768,2012,60181
20543,2753,1276,1477,2012,60184
20544,36063,18368,17695,2012,60185
20545,28778,14291,14487,2012,60187
20546,42243,20822,21421,2012,60188
20547,31078,15012,16066,2012,60189
20548,10521,5142,5379,2012,60190
20549,14036,6816,7220,2012,60191
20550,16445,8065,8380,2012,60192
20551,39495,18866,20629,2012,60193
20552,20136,9606,10530,2012,60194
20553,4239,2303,1936,2012,60195
20554,42197,20222,21975,2012,60201
20555,32422,16027,16395,2012,60202
20556,4760,2290,2470,2012,60203
20557,2298,1116,1182,2012,60301
20558,32224,14933,17291,2012,60302
20559,17259,7944,9315,2012,60304
20560,11174,5393,5781,2012,60305
20561,7720,3774,3946,2012,60401
20562,63734,30877,32857,2012,60402
20563,19646,10199,9447,2012,60403
20564,17722,8884,8838,2012,60404
20565,25876,13028,12848,2012,60406
20566,1902,990,912,2012,60407
20567,5590,2852,2738,2012,60408
20568,37164,16330,20834,2012,60409
20569,12573,6284,6289,2012,60410
20570,58499,28148,30351,2012,60411
20571,14203,7382,6821,2012,60415
20572,9209,4360,4849,2012,60416
20573,15823,7550,8273,2012,60417
20574,22923,10775,12148,2012,60419
20575,6516,2361,4155,2012,60420
20576,4110,1968,2142,2012,60421
20577,8866,3979,4887,2012,60422
20578,30264,14654,15610,2012,60423
20579,2306,1213,1093,2012,60424
20580,9098,4619,4479,2012,60425
20581,28230,12540,15690,2012,60426
20582,12502,5794,6708,2012,60428
20583,16186,7653,8533,2012,60429
20584,21001,10093,10908,2012,60430
20585,20756,9859,10897,2012,60431
20586,21925,11570,10355,2012,60432
20587,17656,9055,8601,2012,60433
20588,49078,23263,25815,2012,60435
20589,18840,9132,9708,2012,60436
20590,221,96,125,2012,60437
20591,28817,13289,15528,2012,60438
20592,22869,11223,11646,2012,60439
20593,53772,26907,26865,2012,60440
20594,34787,18031,16756,2012,60441
20595,9508,5059,4449,2012,60442
20596,20565,9924,10641,2012,60443
20597,1865,947,918,2012,60444
20598,26012,13061,12951,2012,60445
20599,39471,19482,19989,2012,60446
20600,13645,6443,7202,2012,60447
20601,24284,12159,12125,2012,60448
20602,9186,4534,4652,2012,60449
20603,20443,10361,10082,2012,60450
20604,34064,16410,17654,2012,60451
20605,27976,13616,14360,2012,60452
20606,56614,26832,29782,2012,60453
20607,16291,8130,8161,2012,60455
20608,4346,1951,2395,2012,60456
20609,14355,6914,7441,2012,60457
20610,13997,6407,7590,2012,60458
20611,28954,14134,14820,2012,60459
20612,1511,791,720,2012,60460
20613,4661,2155,2506,2012,60461
20614,38562,18469,20093,2012,60462
20615,14340,6894,7446,2012,60463
20616,9627,4152,5475,2012,60464
20617,17474,8656,8818,2012,60465
20618,22552,10686,11866,2012,60466
20619,26514,12389,14125,2012,60467
20620,6158,3286,2872,2012,60468
20621,5975,3046,2929,2012,60469
20622,569,277,292,2012,60470
20623,13757,6055,7702,2012,60471
20624,5158,2882,2276,2012,60472
20625,22376,10887,11489,2012,60473
20626,730,363,367,2012,60474
20627,9785,4866,4919,2012,60475
20628,2773,1271,1502,2012,60476
20629,38120,18484,19636,2012,60477
20630,16712,7770,8942,2012,60478
20631,904,531,373,2012,60479
20632,5045,2488,2557,2012,60480
20633,12072,6136,5936,2012,60481
20634,10991,5313,5678,2012,60482
20635,7012,3256,3756,2012,60484
20636,26428,12956,13472,2012,60487
20637,19609,9867,9742,2012,60490
20638,22657,11231,11426,2012,60491
20639,11790,5790,6000,2012,60501
20640,22770,10755,12015,2012,60502
20641,16550,8408,8142,2012,60503
20642,37961,19174,18787,2012,60504
20643,70324,35975,34349,2012,60505
20644,57139,27905,29234,2012,60506
20645,28849,14053,14796,2012,60510
20646,1534,769,765,2012,60511
20647,1025,457,568,2012,60512
20648,18843,8832,10011,2012,60513
20649,10535,4841,5694,2012,60514
20650,27902,13204,14698,2012,60515
20651,28178,13971,14207,2012,60516
20652,32317,16047,16270,2012,60517
20653,3730,1929,1801,2012,60518
20654,91,40,51,2012,60519
20655,2946,1516,1430,2012,60520
20656,17530,8665,8865,2012,60521
20657,9690,4641,5049,2012,60523
20658,31192,14956,16236,2012,60525
20659,13602,6524,7078,2012,60526
20660,28031,13226,14805,2012,60527
20661,777,388,389,2012,60530
20662,1870,928,942,2012,60531
20663,26695,13109,13586,2012,60532
20664,10620,5740,4880,2012,60534
20665,93,39,54,2012,60536
20666,766,424,342,2012,60537
20667,26430,13023,13407,2012,60538
20668,169,169,0,2012,60539
20669,43361,21317,22044,2012,60540
20670,3024,1483,1541,2012,60541
20671,16416,7762,8654,2012,60542
20672,36003,18039,17964,2012,60543
20673,25335,12375,12960,2012,60544
20674,13054,6492,6562,2012,60545
20675,15824,7510,8314,2012,60546
20676,12855,6154,6701,2012,60548
20677,928,498,430,2012,60549
20678,1397,673,724,2012,60550
20679,4669,2604,2065,2012,60551
20680,4013,2124,1889,2012,60552
20681,882,495,387,2012,60553
20682,11796,5938,5858,2012,60554
20683,13465,6837,6628,2012,60555
20684,1938,918,1020,2012,60556
20685,0,0,0,2012,60557
20686,12853,6378,6475,2012,60558
20687,24567,11623,12944,2012,60559
20688,22677,11813,10864,2012,60560
20689,23197,11463,11734,2012,60561
20690,36236,17323,18913,2012,60563
20691,41217,20540,20677,2012,60564
20692,40434,19406,21028,2012,60565
20693,22081,10979,11102,2012,60585
20694,46677,23346,23331,2012,60586
20695,9791,4916,4875,2012,60601
20696,1322,561,761,2012,60602
20697,623,277,346,2012,60603
20698,428,227,201,2012,60604
20699,22887,11225,11662,2012,60605
20700,2399,1297,1102,2012,60606
20701,24277,12195,12082,2012,60607
20702,80313,45484,34829,2012,60608
20703,63208,31633,31575,2012,60609
20704,37898,16848,21050,2012,60610
20705,29026,13490,15536,2012,60611
20706,35584,16938,18646,2012,60612
20707,49201,24390,24811,2012,60613
20708,67203,32672,34531,2012,60614
20709,41462,19097,22365,2012,60615
20710,48994,23523,25471,2012,60616
20711,84882,38573,46309,2012,60617
20712,97389,49085,48304,2012,60618
20713,66254,28960,37294,2012,60619
20714,74245,32743,41502,2012,60620
20715,34418,14841,19577,2012,60621
20716,54676,27209,27467,2012,60622
20717,85203,41534,43669,2012,60623
20718,39398,17878,21520,2012,60624
20719,78685,40425,38260,2012,60625
20720,52007,26275,25732,2012,60626
20721,74001,33075,40926,2012,60628
20722,111893,54493,57400,2012,60629
20723,56909,28164,28745,2012,60630
20724,29126,14055,15071,2012,60631
20725,90911,46272,44639,2012,60632
20726,13757,6880,6877,2012,60633
20727,73251,36099,37152,2012,60634
20728,40068,18604,21464,2012,60636
20729,47110,20688,26422,2012,60637
20730,54733,26700,28033,2012,60638
20731,90763,44346,46417,2012,60639
20732,65198,34050,31148,2012,60640
20733,71294,35560,35734,2012,60641
20734,18743,10014,8729,2012,60642
20735,49842,22621,27221,2012,60643
20736,47133,22004,25129,2012,60644
20737,45977,22039,23938,2012,60645
20738,27745,13387,14358,2012,60646
20739,87237,44556,42681,2012,60647
20740,44516,19669,24847,2012,60649
20741,63645,29944,33701,2012,60651
20742,42616,20876,21740,2012,60652
20743,31374,13505,17869,2012,60653
20744,14607,7006,7601,2012,60654
20745,28179,14141,14038,2012,60655
20746,27455,13322,14133,2012,60656
20747,68280,33308,34972,2012,60657
20748,40153,19794,20359,2012,60659
20749,41774,20973,20801,2012,60660
20750,7238,3552,3686,2012,60661
20751,23148,10888,12260,2012,60706
20752,42400,20504,21896,2012,60707
20753,12538,6037,6501,2012,60712
20754,29903,14347,15556,2012,60714
20755,22842,11072,11770,2012,60803
20756,83924,42758,41166,2012,60804
20757,19852,9297,10555,2012,60805
20758,28355,12560,15795,2012,60827
20759,37050,18492,18558,2012,60901
20760,381,176,205,2012,60910
20761,1604,869,735,2012,60911
20762,794,412,382,2012,60912
20763,1357,711,646,2012,60913
20764,28727,13958,14769,2012,60914
20765,10681,4925,5756,2012,60915
20766,717,355,362,2012,60917
20767,770,341,429,2012,60918
20768,532,286,246,2012,60919
20769,133,56,77,2012,60920
20770,1549,749,800,2012,60921
20771,2529,1175,1354,2012,60922
20772,1791,867,924,2012,60924
20773,46,18,28,2012,60926
20774,2402,1137,1265,2012,60927
20775,667,313,354,2012,60928
20776,731,371,360,2012,60929
20777,817,369,448,2012,60930
20778,560,236,324,2012,60931
20779,0,0,0,2012,60932
20780,277,131,146,2012,60933
20781,257,134,123,2012,60934
20782,1154,612,542,2012,60935
20783,4110,1993,2117,2012,60936
20784,2212,1029,1183,2012,60938
20785,3457,1781,1676,2012,60940
20786,2121,1073,1048,2012,60941
20787,6091,2931,3160,2012,60942
20788,191,108,83,2012,60945
20789,365,177,188,2012,60946
20790,1713,867,846,2012,60948
20791,591,303,288,2012,60949
20792,11947,5893,6054,2012,60950
20793,857,435,422,2012,60951
20794,753,391,362,2012,60952
20795,2492,1208,1284,2012,60953
20796,6299,3045,3254,2012,60954
20797,1736,944,792,2012,60955
20798,5556,2701,2855,2012,60957
20799,2153,960,1193,2012,60958
20800,978,502,476,2012,60959
20801,1048,596,452,2012,60960
20802,779,418,361,2012,60961
20803,670,361,309,2012,60962
20804,1718,842,876,2012,60963
20805,5166,2568,2598,2012,60964
20806,1354,695,659,2012,60966
20807,337,156,181,2012,60968
20808,50,27,23,2012,60969
20809,7257,3511,3746,2012,60970
20810,442,244,198,2012,60973
20811,280,159,121,2012,60974
20812,1275,675,600,2012,61001
20813,2011,1054,957,2012,61006
20814,520,245,275,2012,61007
20815,34364,17298,17066,2012,61008
20816,8335,3997,4338,2012,61010
20817,2272,1181,1091,2012,61011
20818,2409,1216,1193,2012,61012
20819,624,303,321,2012,61013
20820,1215,596,619,2012,61014
20821,707,389,318,2012,61015
20822,5077,2610,2467,2012,61016
20823,1293,655,638,2012,61018
20824,3448,1710,1738,2012,61019
20825,3280,1677,1603,2012,61020
20826,23706,12512,11194,2012,61021
20827,2625,1270,1355,2012,61024
20828,4823,2377,2446,2012,61025
20829,0,0,0,2012,61027
20830,1990,1020,970,2012,61028
20831,2375,1232,1143,2012,61030
20832,1635,817,818,2012,61031
20833,31482,15061,16421,2012,61032
20834,6626,3214,3412,2012,61036
20835,249,104,145,2012,61037
20836,1361,647,714,2012,61038
20837,1043,532,511,2012,61039
20838,1376,759,617,2012,61041
20839,466,253,213,2012,61042
20840,61,42,19,2012,61043
20841,129,54,75,2012,61044
20842,2648,1297,1351,2012,61046
20843,1529,765,764,2012,61047
20844,4237,2037,2200,2012,61048
20845,591,315,276,2012,61049
20846,308,122,186,2012,61050
20847,1664,805,859,2012,61051
20848,1018,576,442,2012,61052
20849,3199,1549,1650,2012,61053
20850,3967,1832,2135,2012,61054
20851,99,58,41,2012,61057
20852,149,55,94,2012,61059
20853,1470,719,751,2012,61060
20854,6721,3314,3407,2012,61061
20855,1971,1058,913,2012,61062
20856,4095,1897,2198,2012,61063
20857,3727,1940,1787,2012,61064
20858,11086,5411,5675,2012,61065
20859,821,372,449,2012,61067
20860,15032,7504,7528,2012,61068
20861,1080,564,516,2012,61070
20862,14393,7255,7138,2012,61071
20863,11534,5958,5576,2012,61072
20864,19820,9670,10150,2012,61073
20865,4202,2082,2120,2012,61074
20866,1046,555,491,2012,61075
20867,64,53,11,2012,61077
20868,1443,716,727,2012,61078
20869,88,55,33,2012,61079
20870,10805,5116,5689,2012,61080
20871,21477,10318,11159,2012,61081
20872,2792,1309,1483,2012,61084
20873,3371,1716,1655,2012,61085
20874,1652,842,810,2012,61087
20875,6409,3243,3166,2012,61088
20876,794,415,379,2012,61089
20877,103,50,53,2012,61091
20878,22912,11321,11591,2012,61101
20879,19712,10247,9465,2012,61102
20880,24392,11897,12495,2012,61103
20881,17936,8535,9401,2012,61104
20882,31072,14727,16345,2012,61107
20883,29485,14500,14985,2012,61108
20884,28475,14002,14473,2012,61109
20885,23771,11382,12389,2012,61111
20886,82,66,16,2012,61112
20887,14510,6619,7891,2012,61114
20888,23085,11367,11718,2012,61115
20889,38943,18323,20620,2012,61201
20890,1356,674,682,2012,61230
20891,5328,2534,2794,2012,61231
20892,1479,752,727,2012,61232
20893,1283,604,679,2012,61234
20894,1474,781,693,2012,61235
20895,105,58,47,2012,61236
20896,3369,1645,1724,2012,61238
20897,1242,624,618,2012,61239
20898,6112,3082,3030,2012,61240
20899,6714,3269,3445,2012,61241
20900,1092,606,486,2012,61242
20901,319,164,155,2012,61243
20902,24251,12226,12025,2012,61244
20903,2583,1231,1352,2012,61250
20904,360,192,168,2012,61251
20905,5363,2712,2651,2012,61252
20906,11284,5404,5880,2012,61254
20907,2099,1202,897,2012,61256
20908,1051,527,524,2012,61257
20909,307,142,165,2012,61258
20910,879,446,433,2012,61259
20911,1001,506,495,2012,61260
20912,1010,525,485,2012,61261
20913,1411,620,791,2012,61262
20914,570,262,308,2012,61263
20915,10516,5226,5290,2012,61264
20916,44921,21993,22928,2012,61265
20917,7089,3580,3509,2012,61270
20918,1400,667,733,2012,61272
20919,3405,1622,1783,2012,61273
20920,400,226,174,2012,61274
20921,4506,2421,2085,2012,61275
20922,106,57,49,2012,61276
20923,3074,1536,1538,2012,61277
20924,309,148,161,2012,61278
20925,1124,565,559,2012,61279
20926,2627,1337,1290,2012,61281
20927,7719,3587,4132,2012,61282
20928,1980,861,1119,2012,61283
20929,2354,1173,1181,2012,61284
20930,1698,971,727,2012,61285
20931,10684,5623,5061,2012,61301
20932,4111,2045,2066,2012,61310
20933,132,44,88,2012,61311
20934,524,248,276,2012,61312
20935,200,115,85,2012,61313
20936,854,380,474,2012,61314
20937,301,157,144,2012,61315
20938,249,112,137,2012,61316
20939,348,159,189,2012,61317
20940,633,340,293,2012,61318
20941,1131,574,557,2012,61319
20942,727,337,390,2012,61320
20943,281,139,142,2012,61321
20944,1716,991,725,2012,61322
20945,95,34,61,2012,61323
20946,52,21,31,2012,61324
20947,1029,487,542,2012,61325
20948,2296,1148,1148,2012,61326
20949,1216,639,577,2012,61327
20950,13,6,7,2012,61328
20951,1419,664,755,2012,61329
20952,1463,754,709,2012,61330
20953,0,0,0,2012,61331
20954,79,37,42,2012,61332
20955,299,132,167,2012,61333
20956,638,316,322,2012,61334
20957,500,281,219,2012,61335
20958,847,428,419,2012,61336
20959,600,299,301,2012,61337
20960,267,137,130,2012,61338
20961,371,171,200,2012,61340
20962,7877,3909,3968,2012,61341
20963,8873,4239,4634,2012,61342
20964,321,164,157,2012,61344
20965,811,370,441,2012,61345
20966,73,40,33,2012,61346
20967,4654,2302,2352,2012,61348
20968,932,424,508,2012,61349
20969,24281,12382,11899,2012,61350
20970,1385,675,710,2012,61353
20971,10851,5308,5543,2012,61354
20972,11121,5277,5844,2012,61356
20973,484,260,224,2012,61358
20974,279,131,148,2012,61359
20975,3764,2025,1739,2012,61360
20976,1776,949,827,2012,61361
20977,5673,2736,2937,2012,61362
20978,261,120,141,2012,61363
20979,20494,9758,10736,2012,61364
20980,791,364,427,2012,61367
20981,1236,621,615,2012,61368
20982,1649,780,869,2012,61369
20983,1532,798,734,2012,61370
20984,100,58,42,2012,61372
20985,1950,963,987,2012,61373
20986,93,33,60,2012,61374
20987,1052,558,494,2012,61375
20988,2244,1138,1106,2012,61376
20989,1529,729,800,2012,61377
20990,499,286,213,2012,61378
20991,1393,691,702,2012,61379
20992,34806,17531,17275,2012,61401
20993,3643,1851,1792,2012,61410
20994,367,179,188,2012,61411
20995,1650,809,841,2012,61412
20996,804,389,415,2012,61413
20997,842,429,413,2012,61414
20998,1569,794,775,2012,61415
20999,219,103,116,2012,61416
21000,166,82,84,2012,61417
21001,632,325,307,2012,61418
21002,128,65,63,2012,61419
21003,1108,530,578,2012,61420
21004,1608,831,777,2012,61421
21005,3250,1618,1632,2012,61422
21006,644,307,337,2012,61423
21007,105,57,48,2012,61424
21008,295,157,138,2012,61425
21009,113,54,59,2012,61426
21010,2361,1155,1206,2012,61427
21011,830,448,382,2012,61428
21012,784,398,386,2012,61430
21013,358,162,196,2012,61431
21014,601,289,312,2012,61432
21015,124,68,56,2012,61433
21016,3275,1691,1584,2012,61434
21017,151,83,68,2012,61435
21018,1022,540,482,2012,61436
21019,963,475,488,2012,61437
21020,828,412,416,2012,61438
21021,330,164,166,2012,61439
21022,598,284,314,2012,61440
21023,995,486,509,2012,61441
21024,580,302,278,2012,61442
21025,14065,7080,6985,2012,61443
21026,930,460,470,2012,61447
21027,3869,1746,2123,2012,61448
21028,558,306,252,2012,61449
21029,1761,885,876,2012,61450
21030,425,207,218,2012,61451
21031,400,224,176,2012,61452
21032,650,283,367,2012,61453
21033,542,255,287,2012,61454
21034,22051,11078,10973,2012,61455
21035,976,482,494,2012,61458
21036,475,207,268,2012,61459
21037,215,90,125,2012,61460
21038,11499,5697,5802,2012,61462
21039,1117,574,543,2012,61465
21040,361,221,140,2012,61466
21041,1088,577,511,2012,61467
21042,264,131,133,2012,61468
21043,2377,1292,1085,2012,61469
21044,754,376,378,2012,61470
21045,125,66,59,2012,61471
21046,640,325,315,2012,61472
21047,1539,729,810,2012,61473
21048,180,93,87,2012,61474
21049,312,129,183,2012,61475
21050,564,270,294,2012,61476
21051,680,317,363,2012,61477
21052,257,114,143,2012,61478
21053,193,123,70,2012,61479
21054,1530,663,867,2012,61480
21055,559,278,281,2012,61482
21056,1871,893,978,2012,61483
21057,1063,531,532,2012,61484
21058,522,295,227,2012,61485
21059,1598,831,767,2012,61486
21060,1243,643,600,2012,61488
21061,851,423,428,2012,61489
21062,1310,710,600,2012,61490
21063,2191,1068,1123,2012,61491
21064,2058,1070,988,2012,61501
21065,692,350,342,2012,61516
21066,2995,1501,1494,2012,61517
21067,250,134,116,2012,61519
21068,17677,9501,8176,2012,61520
21069,11273,5571,5702,2012,61523
21070,194,102,92,2012,61524
21071,8925,4343,4582,2012,61525
21072,1073,514,559,2012,61526
21073,2170,1020,1150,2012,61528
21074,3039,1560,1479,2012,61529
21075,6472,3193,3279,2012,61530
21076,3329,1683,1646,2012,61531
21077,613,319,294,2012,61532
21078,2292,1131,1161,2012,61533
21079,1648,882,766,2012,61534
21080,1546,739,807,2012,61535
21081,2880,1389,1491,2012,61536
21082,3023,1369,1654,2012,61537
21083,197,97,100,2012,61539
21084,2891,1462,1429,2012,61540
21085,117,51,66,2012,61541
21086,3910,1988,1922,2012,61542
21087,115,58,57,2012,61543
21088,747,370,377,2012,61544
21089,803,310,493,2012,61545
21090,4662,2392,2270,2012,61546
21091,3790,1846,1944,2012,61547
21092,11954,5987,5967,2012,61548
21093,17640,8847,8793,2012,61550
21094,195,100,95,2012,61552
21095,260,129,131,2012,61553
21096,43442,21346,22096,2012,61554
21097,3485,1721,1764,2012,61559
21098,536,263,273,2012,61560
21099,2716,1418,1298,2012,61561
21100,141,117,24,2012,61562
21101,406,205,201,2012,61563
21102,1215,618,597,2012,61564
21103,1467,755,712,2012,61565
21104,506,285,221,2012,61567
21105,4632,2306,2326,2012,61568
21106,954,501,453,2012,61569
21107,1847,970,877,2012,61570
21108,23716,11327,12389,2012,61571
21109,1319,669,650,2012,61572
21110,997,746,251,2012,61602
21111,16790,7565,9225,2012,61603
21112,31481,14843,16638,2012,61604
21113,15673,7205,8468,2012,61605
21114,8558,4364,4194,2012,61606
21115,11161,5748,5413,2012,61607
21116,5490,2665,2825,2012,61610
21117,25203,12547,12656,2012,61611
21118,28477,13750,14727,2012,61614
21119,22926,11356,11570,2012,61615
21120,6078,3006,3072,2012,61616
21121,603,226,377,2012,61625
21122,36618,17332,19286,2012,61701
21123,34964,17622,17342,2012,61704
21124,12327,6023,6304,2012,61705
21125,155,62,93,2012,61720
21126,780,370,410,2012,61721
21127,607,275,332,2012,61722
21128,1727,820,907,2012,61723
21129,483,209,274,2012,61724
21130,1540,780,760,2012,61725
21131,2544,1223,1321,2012,61726
21132,9888,4894,4994,2012,61727
21133,1456,749,707,2012,61728
21134,991,507,484,2012,61729
21135,454,242,212,2012,61730
21136,226,102,124,2012,61731
21137,1959,1044,915,2012,61732
21138,977,532,445,2012,61733
21139,2721,1330,1391,2012,61734
21140,597,305,292,2012,61735
21141,1729,854,875,2012,61736
21142,593,255,338,2012,61737
21143,4354,1968,2386,2012,61738
21144,4833,2376,2457,2012,61739
21145,1596,740,856,2012,61740
21146,1573,759,814,2012,61741
21147,1478,721,757,2012,61742
21148,229,112,117,2012,61743
21149,1942,976,966,2012,61744
21150,4381,2254,2127,2012,61745
21151,1562,745,817,2012,61747
21152,2624,1388,1236,2012,61748
21153,620,331,289,2012,61749
21154,55,26,29,2012,61750
21155,81,30,51,2012,61751
21156,4246,2109,2137,2012,61752
21157,3033,1435,1598,2012,61753
21158,1320,544,776,2012,61754
21159,4700,2333,2367,2012,61755
21160,2428,1178,1250,2012,61756
21161,1493,745,748,2012,61759
21162,2640,1255,1385,2012,61760
21163,53282,25339,27943,2012,61761
21164,14512,8174,6338,2012,61764
21165,507,290,217,2012,61769
21166,1115,529,586,2012,61770
21167,1109,547,562,2012,61771
21168,300,191,109,2012,61772
21169,596,268,328,2012,61773
21170,991,499,492,2012,61774
21171,433,217,216,2012,61775
21172,1834,893,941,2012,61776
21173,706,380,326,2012,61777
21174,869,422,447,2012,61778
21175,31751,16127,15624,2012,61801
21176,18320,8772,9548,2012,61802
21177,246,114,132,2012,61810
21178,866,472,394,2012,61811
21179,366,199,167,2012,61812
21180,2080,1006,1074,2012,61813
21181,1134,559,575,2012,61814
21182,329,132,197,2012,61815
21183,475,234,241,2012,61816
21184,2742,1345,1397,2012,61817
21185,1586,763,823,2012,61818
21186,36026,19628,16398,2012,61820
21187,29893,14353,15540,2012,61821
21188,22834,11159,11675,2012,61822
21189,698,397,301,2012,61830
21190,120,71,49,2012,61831
21191,37593,18232,19361,2012,61832
21192,2134,1013,1121,2012,61833
21193,7571,4065,3506,2012,61834
21194,640,333,307,2012,61839
21195,531,286,245,2012,61840
21196,1444,670,774,2012,61841
21197,3233,1620,1613,2012,61842
21198,2355,1154,1201,2012,61843
21199,908,465,443,2012,61844
21200,475,201,274,2012,61845
21201,5164,2729,2435,2012,61846
21202,1246,618,628,2012,61847
21203,227,127,100,2012,61848
21204,1719,795,924,2012,61849
21205,579,309,270,2012,61850
21206,335,156,179,2012,61851
21207,235,122,113,2012,61852
21208,12810,6199,6611,2012,61853
21209,1700,847,853,2012,61854
21210,194,86,108,2012,61855
21211,7219,3496,3723,2012,61856
21212,90,53,37,2012,61857
21213,3139,1501,1638,2012,61858
21214,1225,609,616,2012,61859
21215,445,229,216,2012,61862
21216,692,324,368,2012,61863
21217,1796,952,844,2012,61864
21218,1636,834,802,2012,61865
21219,14184,7145,7039,2012,61866
21220,1497,685,812,2012,61870
21221,252,117,135,2012,61871
21222,977,522,455,2012,61872
21223,6196,2838,3358,2012,61873
21224,6816,3082,3734,2012,61874
21225,741,369,372,2012,61875
21226,842,389,453,2012,61876
21227,1948,897,1051,2012,61877
21228,1348,672,676,2012,61878
21229,4546,2395,2151,2012,61880
21230,650,318,332,2012,61882
21231,4415,2198,2217,2012,61883
21232,1130,640,490,2012,61884
21233,4383,2052,2331,2012,61910
21234,5424,2886,2538,2012,61911
21235,1326,659,667,2012,61912
21236,1516,733,783,2012,61913
21237,1831,849,982,2012,61914
21238,680,373,307,2012,61917
21239,974,494,480,2012,61919
21240,25959,12832,13127,2012,61920
21241,2402,1185,1217,2012,61924
21242,853,426,427,2012,61925
21243,1018,555,463,2012,61928
21244,648,333,315,2012,61929
21245,587,298,289,2012,61930
21246,1137,619,518,2012,61931
21247,465,232,233,2012,61932
21248,1141,541,600,2012,61933
21249,120,55,65,2012,61936
21250,1845,933,912,2012,61937
21251,21873,9972,11901,2012,61938
21252,222,106,116,2012,61940
21253,49,17,32,2012,61941
21254,1227,604,623,2012,61942
21255,1346,633,713,2012,61943
21256,12734,6054,6680,2012,61944
21257,194,108,86,2012,61949
21258,8022,3799,4223,2012,61951
21259,6287,3131,3156,2012,61953
21260,154,72,82,2012,61955
21261,2717,1344,1373,2012,61956
21262,2009,937,1072,2012,61957
21263,1599,811,788,2012,62001
21264,32292,15665,16627,2012,62002
21265,581,325,256,2012,62006
21266,1934,1020,914,2012,62009
21267,11113,5472,5641,2012,62010
21268,315,193,122,2012,62011
21269,6758,3347,3411,2012,62012
21270,550,271,279,2012,62013
21271,4015,1993,2022,2012,62014
21272,319,148,171,2012,62015
21273,3687,1838,1849,2012,62016
21274,802,355,447,2012,62017
21275,4390,2264,2126,2012,62018
21276,477,213,264,2012,62019
21277,726,347,379,2012,62021
21278,944,477,467,2012,62022
21279,50,23,27,2012,62023
21280,9703,4834,4869,2012,62024
21281,33356,16547,16809,2012,62025
21282,513,264,249,2012,62027
21283,1275,566,709,2012,62028
21284,145,58,87,2012,62030
21285,876,468,408,2012,62031
21286,771,403,368,2012,62032
21287,4905,2562,2343,2012,62033
21288,14228,6838,7390,2012,62034
21289,16232,7580,8652,2012,62035
21290,668,346,322,2012,62036
21291,1951,881,1070,2012,62037
21292,43303,21360,21943,2012,62040
21293,2376,1161,1215,2012,62044
21294,584,305,279,2012,62045
21295,577,249,328,2012,62046
21296,1782,838,944,2012,62047
21297,1552,726,826,2012,62048
21298,10178,6895,3283,2012,62049
21299,279,159,120,2012,62050
21300,604,310,294,2012,62051
21301,13238,6643,6595,2012,62052
21302,590,289,301,2012,62053
21303,585,287,298,2012,62054
21304,8819,3757,5062,2012,62056
21305,747,380,367,2012,62058
21306,669,255,414,2012,62059
21307,5102,2305,2797,2012,62060
21308,2267,1221,1046,2012,62061
21309,7806,3829,3977,2012,62062
21310,1125,566,559,2012,62063
21311,69,39,30,2012,62065
21312,2500,1295,1205,2012,62067
21313,3263,1586,1677,2012,62069
21314,10,0,10,2012,62070
21315,1213,597,616,2012,62074
21316,3621,1685,1936,2012,62075
21317,97,46,51,2012,62076
21318,180,73,107,2012,62077
21319,99,44,55,2012,62078
21320,489,190,299,2012,62079
21321,2731,1380,1351,2012,62080
21322,313,132,181,2012,62081
21323,3098,1742,1356,2012,62082
21324,365,183,182,2012,62083
21325,1620,795,825,2012,62084
21326,216,104,112,2012,62085
21327,1477,738,739,2012,62086
21328,2247,1102,1145,2012,62087
21329,7031,3109,3922,2012,62088
21330,405,189,216,2012,62089
21331,961,330,631,2012,62090
21332,336,166,170,2012,62091
21333,3053,1444,1609,2012,62092
21334,382,195,187,2012,62093
21335,952,422,530,2012,62094
21336,11183,5077,6106,2012,62095
21337,2620,1342,1278,2012,62097
21338,122,69,53,2012,62098
21339,7205,3231,3974,2012,62201
21340,8327,4366,3961,2012,62203
21341,8627,4079,4548,2012,62204
21342,8819,4288,4531,2012,62205
21343,16734,7954,8780,2012,62206
21344,8693,3942,4751,2012,62207
21345,16899,8243,8656,2012,62208
21346,1053,537,516,2012,62214
21347,1919,958,961,2012,62215
21348,2642,1349,1293,2012,62216
21349,762,369,393,2012,62217
21350,1678,904,774,2012,62218
21351,893,424,469,2012,62219
21352,20695,10009,10686,2012,62220
21353,27571,13488,14083,2012,62221
21354,17786,8313,9473,2012,62223
21355,5586,3146,2440,2012,62225
21356,29221,13633,15588,2012,62226
21357,6315,3089,3226,2012,62230
21358,7352,3587,3765,2012,62231
21359,7114,3353,3761,2012,62232
21360,9842,6497,3345,2012,62233
21361,33038,16262,16776,2012,62234
21362,12670,6261,6409,2012,62236
21363,2787,1392,1395,2012,62237
21364,788,377,411,2012,62238
21365,4722,2148,2574,2012,62239
21366,2183,986,1197,2012,62240
21367,1381,762,619,2012,62241
21368,1539,786,753,2012,62242
21369,5870,2856,3014,2012,62243
21370,1161,555,606,2012,62244
21371,1681,855,826,2012,62245
21372,10428,4977,5451,2012,62246
21373,322,146,176,2012,62248
21374,15318,7299,8019,2012,62249
21375,584,306,278,2012,62250
21376,790,345,445,2012,62253
21377,5636,2672,2964,2012,62254
21378,843,403,440,2012,62255
21379,3430,1684,1746,2012,62257
21380,9160,4591,4569,2012,62258
21381,7167,3239,3928,2012,62260
21382,184,85,99,2012,62261
21383,1744,933,811,2012,62262
21384,5268,2605,2663,2012,62263
21385,3508,1787,1721,2012,62264
21386,4252,2092,2160,2012,62265
21387,238,86,152,2012,62266
21388,833,402,431,2012,62268
21389,31441,15419,16022,2012,62269
21390,2072,1022,1050,2012,62271
21391,1343,707,636,2012,62272
21392,413,233,180,2012,62273
21393,8337,5149,3188,2012,62274
21394,3712,1956,1756,2012,62275
21395,1174,566,608,2012,62277
21396,7329,3452,3877,2012,62278
21397,61,47,14,2012,62279
21398,491,290,201,2012,62280
21399,2058,965,1093,2012,62281
21400,489,234,255,2012,62282
21401,562,288,274,2012,62284
21402,4434,1858,2576,2012,62285
21403,6197,3126,3071,2012,62286
21404,2888,1422,1466,2012,62288
21405,351,192,159,2012,62289
21406,786,428,358,2012,62292
21407,4902,2406,2496,2012,62293
21408,14576,7848,6728,2012,62294
21409,1788,882,906,2012,62295
21410,207,114,93,2012,62297
21411,15810,8007,7803,2012,62298
21412,33552,15696,17856,2012,62301
21413,18275,9010,9265,2012,62305
21414,964,508,456,2012,62311
21415,2155,1036,1119,2012,62312
21416,468,252,216,2012,62313
21417,449,226,223,2012,62314
21418,747,407,340,2012,62316
21419,250,148,102,2012,62319
21420,2298,1108,1190,2012,62320
21421,3902,1902,2000,2012,62321
21422,143,94,49,2012,62323
21423,1215,679,536,2012,62324
21424,320,150,170,2012,62325
21425,2207,1049,1158,2012,62326
21426,1834,842,992,2012,62330
21427,122,61,61,2012,62334
21428,103,55,48,2012,62336
21429,1407,739,668,2012,62338
21430,878,433,445,2012,62339
21431,1625,750,875,2012,62340
21432,3523,1735,1788,2012,62341
21433,593,256,337,2012,62343
21434,139,52,87,2012,62344
21435,397,179,218,2012,62345
21436,176,94,82,2012,62346
21437,2609,1401,1208,2012,62347
21438,190,64,126,2012,62348
21439,525,243,282,2012,62349
21440,1967,1067,900,2012,62351
21441,425,224,201,2012,62352
21442,5444,3598,1846,2012,62353
21443,1563,736,827,2012,62354
21444,838,485,353,2012,62355
21445,629,331,298,2012,62356
21446,199,76,123,2012,62357
21447,770,367,403,2012,62358
21448,162,91,71,2012,62359
21449,1757,890,867,2012,62360
21450,631,312,319,2012,62361
21451,409,178,231,2012,62362
21452,6088,3065,3023,2012,62363
21453,880,474,406,2012,62365
21454,1817,942,875,2012,62366
21455,1224,607,617,2012,62367
21456,387,203,184,2012,62370
21457,333,122,211,2012,62373
21458,342,185,157,2012,62374
21459,607,401,206,2012,62375
21460,1095,568,527,2012,62376
21461,862,440,422,2012,62378
21462,2063,995,1068,2012,62379
21463,352,176,176,2012,62380
21464,18534,9076,9458,2012,62401
21465,997,515,482,2012,62410
21466,4484,2196,2288,2012,62411
21467,270,150,120,2012,62413
21468,1744,847,897,2012,62414
21469,2187,1019,1168,2012,62417
21470,2134,1069,1065,2012,62418
21471,390,224,166,2012,62419
21472,4786,2358,2428,2012,62420
21473,986,506,480,2012,62421
21474,1112,533,579,2012,62422
21475,866,451,415,2012,62423
21476,1915,1019,896,2012,62424
21477,621,345,276,2012,62425
21478,1081,539,542,2012,62426
21479,1739,881,858,2012,62427
21480,3366,1653,1713,2012,62428
21481,1025,498,527,2012,62431
21482,541,298,243,2012,62432
21483,1048,531,517,2012,62433
21484,192,101,91,2012,62434
21485,489,246,243,2012,62436
21486,435,203,232,2012,62438
21487,7073,3628,3445,2012,62439
21488,1407,716,691,2012,62440
21489,7370,3595,3775,2012,62441
21490,2259,1091,1168,2012,62442
21491,1852,936,916,2012,62443
21492,438,240,198,2012,62444
21493,1011,510,501,2012,62445
21494,389,189,200,2012,62446
21495,3176,1622,1554,2012,62447
21496,5821,2817,3004,2012,62448
21497,2959,1526,1433,2012,62449
21498,12152,5803,6349,2012,62450
21499,2432,1220,1212,2012,62451
21500,555,315,240,2012,62452
21501,11488,5960,5528,2012,62454
21502,2308,1168,1140,2012,62458
21503,254,124,130,2012,62459
21504,1055,522,533,2012,62460
21505,903,531,372,2012,62461
21506,1134,629,505,2012,62462
21507,1243,632,611,2012,62463
21508,1005,452,553,2012,62465
21509,6195,5223,972,2012,62466
21510,4036,2123,1913,2012,62467
21511,2462,1203,1259,2012,62468
21512,294,129,165,2012,62469
21513,9771,4900,4871,2012,62471
21514,1481,769,712,2012,62473
21515,825,362,463,2012,62474
21516,346,190,156,2012,62475
21517,1999,989,1010,2012,62476
21518,1223,661,562,2012,62477
21519,301,135,166,2012,62478
21520,917,517,400,2012,62479
21521,742,373,369,2012,62480
21522,222,79,143,2012,62481
21523,2491,1202,1289,2012,62501
21524,1766,828,938,2012,62510
21525,340,135,205,2012,62512
21526,1852,884,968,2012,62513
21527,186,80,106,2012,62514
21528,898,417,481,2012,62515
21529,338,145,193,2012,62517
21530,348,179,169,2012,62518
21531,60,27,33,2012,62519
21532,1293,653,640,2012,62520
21533,35383,17283,18100,2012,62521
21534,17235,8356,8879,2012,62522
21535,905,631,274,2012,62523
21536,33826,15226,18600,2012,62526
21537,1625,796,829,2012,62530
21538,1761,861,900,2012,62531
21539,166,89,77,2012,62532
21540,846,393,453,2012,62533
21541,1231,653,578,2012,62534
21542,3785,1906,1879,2012,62535
21543,986,560,426,2012,62536
21544,38,22,16,2012,62537
21545,350,183,167,2012,62538
21546,1408,635,773,2012,62539
21547,1572,740,832,2012,62540
21548,156,59,97,2012,62541
21549,520,239,281,2012,62543
21550,1822,905,917,2012,62544
21551,934,531,403,2012,62545
21552,1569,805,764,2012,62546
21553,890,444,446,2012,62547
21554,1787,819,968,2012,62548
21555,6019,3045,2974,2012,62549
21556,2806,1347,1459,2012,62550
21557,903,427,476,2012,62551
21558,488,258,230,2012,62553
21559,1582,744,838,2012,62554
21560,391,182,209,2012,62555
21561,438,215,223,2012,62556
21562,7109,3354,3755,2012,62557
21563,3577,1638,1939,2012,62558
21564,1215,562,653,2012,62560
21565,5269,2406,2863,2012,62561
21566,5874,2737,3137,2012,62563
21567,7517,3630,3887,2012,62565
21568,1018,450,568,2012,62567
21569,16584,8910,7674,2012,62568
21570,492,242,250,2012,62570
21571,1903,999,904,2012,62571
21572,694,295,399,2012,62572
21573,1379,768,611,2012,62573
21574,501,259,242,2012,62601
21575,311,200,111,2012,62610
21576,987,479,508,2012,62611
21577,2110,1132,978,2012,62612
21578,3597,1694,1903,2012,62613
21579,5586,2982,2604,2012,62615
21580,738,363,375,2012,62617
21581,7938,4065,3873,2012,62618
21582,1285,678,607,2012,62621
21583,0,0,0,2012,62622
21584,659,323,336,2012,62624
21585,845,441,404,2012,62625
21586,8312,4172,4140,2012,62626
21587,1076,490,586,2012,62627
21588,876,409,467,2012,62628
21589,13138,6287,6851,2012,62629
21590,514,257,257,2012,62630
21591,253,135,118,2012,62631
21592,598,302,296,2012,62633
21593,556,254,302,2012,62634
21594,553,288,265,2012,62635
21595,1251,620,631,2012,62638
21596,187,90,97,2012,62639
21597,3777,1881,1896,2012,62640
21598,1526,789,737,2012,62642
21599,400,170,230,2012,62643
21600,5346,2453,2893,2012,62644
21601,553,337,216,2012,62649
21602,27100,13592,13508,2012,62650
21603,571,284,287,2012,62655
21604,22720,12038,10682,2012,62656
21605,1029,514,515,2012,62661
21606,454,219,235,2012,62663
21607,3107,1602,1505,2012,62664
21608,1533,720,813,2012,62665
21609,512,237,275,2012,62666
21610,468,196,272,2012,62667
21611,1409,704,705,2012,62668
21612,3274,1612,1662,2012,62670
21613,457,196,261,2012,62671
21614,211,95,116,2012,62672
21615,609,230,379,2012,62673
21616,1493,741,752,2012,62674
21617,6214,3049,3165,2012,62675
21618,2684,1465,1219,2012,62677
21619,5491,2855,2636,2012,62681
21620,751,390,361,2012,62682
21621,5601,2591,3010,2012,62684
21622,2093,1021,1072,2012,62685
21623,792,439,353,2012,62688
21624,427,235,192,2012,62689
21625,4200,1993,2207,2012,62690
21626,2156,1065,1091,2012,62691
21627,2011,1060,951,2012,62692
21628,1536,761,775,2012,62693
21629,3029,1408,1621,2012,62694
21630,270,110,160,2012,62695
21631,983,601,382,2012,62701
21632,37820,17815,20005,2012,62702
21633,29593,14056,15537,2012,62703
21634,39925,18958,20967,2012,62704
21635,7669,3774,3895,2012,62707
21636,15721,7423,8298,2012,62711
21637,9804,5003,4801,2012,62712
21638,22613,11532,11081,2012,62801
21639,1006,516,490,2012,62803
21640,3359,1690,1669,2012,62806
21641,1040,461,579,2012,62807
21642,1744,879,865,2012,62808
21643,121,62,59,2012,62809
21644,1024,516,508,2012,62810
21645,231,122,109,2012,62811
21646,11352,5467,5885,2012,62812
21647,1929,971,958,2012,62814
21648,358,166,192,2012,62815
21649,1319,715,604,2012,62816
21650,784,356,428,2012,62817
21651,427,215,212,2012,62818
21652,389,182,207,2012,62819
21653,179,86,93,2012,62820
21654,7513,3453,4060,2012,62821
21655,2745,1353,1392,2012,62822
21656,1782,915,867,2012,62823
21657,1773,886,887,2012,62824
21658,211,128,83,2012,62825
21659,1337,651,686,2012,62827
21660,1276,615,661,2012,62828
21661,118,68,50,2012,62829
21662,1426,694,732,2012,62830
21663,495,261,234,2012,62831
21664,9023,4495,4528,2012,62832
21665,227,114,113,2012,62833
21666,1177,611,566,2012,62835
21667,742,380,362,2012,62836
21668,9015,4272,4743,2012,62837
21669,1795,912,883,2012,62838
21670,6608,3095,3513,2012,62839
21671,103,52,51,2012,62841
21672,970,409,561,2012,62842
21673,131,67,64,2012,62843
21674,1943,874,1069,2012,62844
21675,2544,2115,429,2012,62846
21676,626,325,301,2012,62848
21677,2451,1235,1216,2012,62849
21678,305,166,139,2012,62850
21679,249,140,109,2012,62851
21680,129,81,48,2012,62852
21681,856,407,449,2012,62853
21682,1606,790,816,2012,62854
21683,217,120,97,2012,62856
21684,3325,1710,1615,2012,62858
21685,5611,2807,2804,2012,62859
21686,481,225,256,2012,62860
21687,133,69,64,2012,62861
21688,343,180,163,2012,62862
21689,10115,4877,5238,2012,62863
21690,24305,11852,12453,2012,62864
21691,1823,915,908,2012,62865
21692,528,269,259,2012,62867
21693,1715,851,864,2012,62868
21694,2746,1471,1275,2012,62869
21695,1995,1067,928,2012,62870
21696,640,346,294,2012,62871
21697,1114,552,562,2012,62872
21698,341,156,185,2012,62874
21699,1139,566,573,2012,62875
21700,252,136,116,2012,62876
21701,498,268,230,2012,62877
21702,295,163,132,2012,62878
21703,113,62,51,2012,62879
21704,573,307,266,2012,62880
21705,11386,5576,5810,2012,62881
21706,2175,1038,1137,2012,62882
21707,803,439,364,2012,62883
21708,2884,1466,1418,2012,62884
21709,769,416,353,2012,62885
21710,480,251,229,2012,62886
21711,237,94,143,2012,62887
21712,2504,1255,1249,2012,62888
21713,852,362,490,2012,62889
21714,3422,1785,1637,2012,62890
21715,596,319,277,2012,62891
21716,247,123,124,2012,62892
21717,887,474,413,2012,62893
21718,1022,532,490,2012,62894
21719,2094,1077,1017,2012,62895
21720,12605,6171,6434,2012,62896
21721,550,266,284,2012,62897
21722,2012,992,1020,2012,62898
21723,1779,916,863,2012,62899
21724,27823,14407,13416,2012,62901
21725,4506,2165,2341,2012,62902
21726,2248,1190,1058,2012,62903
21727,800,408,392,2012,62905
21728,7007,3437,3570,2012,62906
21729,2362,1205,1157,2012,62907
21730,458,249,209,2012,62908
21731,2535,1121,1414,2012,62910
21732,1198,627,571,2012,62912
21733,3008,1296,1712,2012,62914
21734,392,222,170,2012,62915
21735,878,494,384,2012,62916
21736,2315,1133,1182,2012,62917
21737,9589,4636,4953,2012,62918
21738,861,490,371,2012,62919
21739,3643,1887,1756,2012,62920
21740,486,204,282,2012,62921
21741,3415,1718,1697,2012,62922
21742,671,340,331,2012,62923
21743,2880,1468,1412,2012,62924
21744,2104,1053,1051,2012,62926
21745,235,102,133,2012,62927
21746,288,139,149,2012,62928
21747,6204,2822,3382,2012,62930
21748,1712,917,795,2012,62931
21749,1618,926,692,2012,62932
21750,972,415,557,2012,62933
21751,965,504,461,2012,62934
21752,2009,950,1059,2012,62935
21753,2793,1408,1385,2012,62938
21754,3036,1426,1610,2012,62939
21755,510,253,257,2012,62940
21756,753,340,413,2012,62941
21757,675,364,311,2012,62942
21758,703,449,254,2012,62943
21759,13224,6656,6568,2012,62946
21760,583,278,305,2012,62947
21761,12771,6364,6407,2012,62948
21762,806,411,395,2012,62949
21763,264,144,120,2012,62950
21764,5375,2541,2834,2012,62951
21765,3220,1556,1664,2012,62952
21766,311,151,160,2012,62953
21767,645,298,347,2012,62954
21768,951,397,554,2012,62956
21769,1229,575,654,2012,62957
21770,2032,999,1033,2012,62958
21771,26628,13314,13314,2012,62959
21772,11937,5663,6274,2012,62960
21773,80,34,46,2012,62961
21774,84,49,35,2012,62962
21775,791,395,396,2012,62963
21776,1339,677,662,2012,62964
21777,112,53,59,2012,62965
21778,15527,7315,8212,2012,62966
21779,269,140,129,2012,62967
21780,689,353,336,2012,62969
21781,732,377,355,2012,62970
21782,1022,493,529,2012,62972
21783,1463,752,711,2012,62974
21784,161,88,73,2012,62975
21785,441,253,188,2012,62976
21786,577,279,298,2012,62977
21787,1311,577,734,2012,62979
21788,1365,751,614,2012,62982
21789,1365,695,670,2012,62983
21790,1753,836,917,2012,62984
21791,1404,862,542,2012,62985
21792,887,446,441,2012,62987
21793,2143,1351,792,2012,62988
21794,966,533,433,2012,62990
21795,996,516,480,2012,62992
21796,733,407,326,2012,62994
21797,5210,3292,1918,2012,62995
21798,413,216,197,2012,62996
21799,503,227,276,2012,62997
21800,371,238,133,2012,62998
21801,1922,912,1010,2012,62999
21802,17741,8786,8955,2012,63005
21803,36304,17952,18352,2012,63010
21804,37114,17747,19367,2012,63011
21805,10334,5115,5219,2012,63012
21806,1697,940,757,2012,63013
21807,483,222,261,2012,63014
21808,1883,808,1075,2012,63015
21809,8088,3918,4170,2012,63016
21810,41402,19779,21623,2012,63017
21811,4512,2241,2271,2012,63019
21812,20781,10272,10509,2012,63020
21813,56102,26971,29131,2012,63021
21814,4925,2682,2243,2012,63023
21815,13184,6399,6785,2012,63025
21816,43886,21431,22455,2012,63026
21817,26152,12665,13487,2012,63028
21818,333,157,176,2012,63030
21819,48529,22748,25781,2012,63031
21820,41502,19626,21876,2012,63033
21821,18035,8574,9461,2012,63034
21822,680,346,334,2012,63036
21823,3093,1561,1532,2012,63037
21824,6797,3412,3385,2012,63038
21825,1378,777,601,2012,63039
21826,8795,4344,4451,2012,63040
21827,363,209,154,2012,63041
21828,19924,9899,10025,2012,63042
21829,22311,10709,11602,2012,63043
21830,10645,5033,5612,2012,63044
21831,0,0,0,2012,63045
21832,0,0,0,2012,63047
21833,3397,1638,1759,2012,63048
21834,16098,8192,7906,2012,63049
21835,14604,7226,7378,2012,63050
21836,14345,7517,6828,2012,63051
21837,25501,12569,12932,2012,63052
21838,89,57,32,2012,63053
21839,2329,1177,1152,2012,63055
21840,1914,1023,891,2012,63056
21841,61,61,0,2012,63057
21842,2518,1211,1307,2012,63060
21843,191,47,144,2012,63061
21844,5074,2477,2597,2012,63068
21845,14815,7477,7338,2012,63069
21846,7850,4123,3727,2012,63070
21847,1284,565,719,2012,63071
21848,3360,1763,1597,2012,63072
21849,331,125,206,2012,63073
21850,15420,7314,8106,2012,63074
21851,11280,5868,5412,2012,63077
21852,34,22,12,2012,63079
21853,15015,7331,7684,2012,63080
21854,17919,8998,8921,2012,63084
21855,1044,418,626,2012,63087
21856,8058,3632,4426,2012,63088
21857,5387,2760,2627,2012,63089
21858,21833,10765,11068,2012,63090
21859,1315,630,685,2012,63091
21860,1989,1134,855,2012,63101
21861,2154,1539,615,2012,63102
21862,6242,3000,3242,2012,63103
21863,19454,9430,10024,2012,63104
21864,17380,9053,8327,2012,63105
21865,11546,4754,6792,2012,63106
21866,12349,5732,6617,2012,63107
21867,21175,10352,10823,2012,63108
21868,27255,13321,13934,2012,63109
21869,16217,7847,8370,2012,63110
21870,21363,10698,10665,2012,63111
21871,20024,9338,10686,2012,63112
21872,13045,6389,6656,2012,63113
21873,36400,18160,18240,2012,63114
21874,22192,9802,12390,2012,63115
21875,43884,21726,22158,2012,63116
21876,9331,4333,4998,2012,63117
21877,26862,13238,13624,2012,63118
21878,33856,15829,18027,2012,63119
21879,8890,4082,4808,2012,63120
21880,26736,11568,15168,2012,63121
21881,38582,17749,20833,2012,63122
21882,48869,23782,25087,2012,63123
21883,10418,4841,5577,2012,63124
21884,32685,15502,17183,2012,63125
21885,14907,7135,7772,2012,63126
21886,4610,2335,2275,2012,63127
21887,29082,13844,15238,2012,63128
21888,52927,25466,27461,2012,63129
21889,30832,14635,16197,2012,63130
21890,17281,8334,8947,2012,63131
21891,13817,6566,7251,2012,63132
21892,8616,3778,4838,2012,63133
21893,14173,6028,8145,2012,63134
21894,21943,9674,12269,2012,63135
21895,47430,20723,26707,2012,63136
21896,20604,9051,11553,2012,63137
21897,21118,9414,11704,2012,63138
21898,22384,10510,11874,2012,63139
21899,426,197,229,2012,63140
21900,20326,10191,10135,2012,63141
21901,9668,4667,5001,2012,63143
21902,8869,4270,4599,2012,63144
21903,30027,14202,15825,2012,63146
21904,10994,5455,5539,2012,63147
21905,0,0,0,2012,63155
21906,49478,25152,24326,2012,63301
21907,45781,22260,23521,2012,63303
21908,39986,19685,20301,2012,63304
21909,123,84,39,2012,63330
21910,1233,670,563,2012,63332
21911,825,430,395,2012,63333
21912,9480,5626,3854,2012,63334
21913,1012,494,518,2012,63336
21914,984,458,526,2012,63339
21915,3712,1919,1793,2012,63341
21916,4424,2230,2194,2012,63343
21917,1606,775,831,2012,63344
21918,491,242,249,2012,63345
21919,2969,1557,1412,2012,63347
21920,6471,3386,3085,2012,63348
21921,1523,781,742,2012,63349
21922,855,444,411,2012,63350
21923,1852,846,1006,2012,63351
21924,943,477,466,2012,63352
21925,4733,2456,2277,2012,63353
21926,4574,2444,2130,2012,63357
21927,1281,658,623,2012,63359
21928,4484,2348,2136,2012,63361
21929,5893,2916,2977,2012,63362
21930,1712,917,795,2012,63363
21931,47464,23234,24230,2012,63366
21932,20018,9755,10263,2012,63367
21933,42201,20603,21598,2012,63368
21934,2284,1198,1086,2012,63369
21935,17,12,5,2012,63370
21936,530,275,255,2012,63373
21937,71241,34007,37234,2012,63376
21938,2472,1190,1282,2012,63377
21939,23911,11629,12282,2012,63379
21940,434,267,167,2012,63381
21941,5026,1831,3195,2012,63382
21942,15783,7786,7997,2012,63383
21943,1899,861,1038,2012,63384
21944,33903,16756,17147,2012,63385
21945,648,353,295,2012,63386
21946,82,33,49,2012,63387
21947,820,370,450,2012,63388
21948,6945,3622,3323,2012,63389
21949,9905,4981,4924,2012,63390
21950,21229,10431,10798,2012,63401
21951,555,318,237,2012,63430
21952,108,59,49,2012,63431
21953,483,227,256,2012,63432
21954,17,8,9,2012,63433
21955,662,341,321,2012,63434
21956,4734,2261,2473,2012,63435
21957,991,511,480,2012,63436
21958,1419,709,710,2012,63437
21959,772,394,378,2012,63438
21960,39,23,16,2012,63439
21961,1392,714,678,2012,63440
21962,998,509,489,2012,63441
21963,464,246,218,2012,63443
21964,3678,1854,1824,2012,63445
21965,746,337,409,2012,63446
21966,1143,614,529,2012,63447
21967,1463,714,749,2012,63448
21968,142,78,64,2012,63450
21969,291,152,139,2012,63451
21970,1091,542,549,2012,63452
21971,537,242,295,2012,63453
21972,1032,538,494,2012,63454
21973,3985,1780,2205,2012,63456
21974,298,175,123,2012,63457
21975,199,98,101,2012,63458
21976,4651,2199,2452,2012,63459
21977,405,170,235,2012,63460
21978,5752,2702,3050,2012,63461
21979,1650,815,835,2012,63462
21980,645,318,327,2012,63463
21981,65,46,19,2012,63464
21982,468,264,204,2012,63465
21983,70,58,12,2012,63467
21984,2327,1027,1300,2012,63468
21985,1364,728,636,2012,63469
21986,680,367,313,2012,63471
21987,440,209,231,2012,63472
21988,312,161,151,2012,63473
21989,539,256,283,2012,63474
21990,21293,9886,11407,2012,63501
21991,897,405,492,2012,63530
21992,381,207,174,2012,63531
21993,1187,607,580,2012,63532
21994,960,506,454,2012,63533
21995,818,417,401,2012,63534
21996,208,104,104,2012,63535
21997,766,376,390,2012,63536
21998,1812,906,906,2012,63537
21999,325,171,154,2012,63538
22000,181,90,91,2012,63539
22001,326,166,160,2012,63540
22002,343,180,163,2012,63541
22003,418,185,233,2012,63543
22004,994,504,490,2012,63544
22005,1160,541,619,2012,63545
22006,1213,634,579,2012,63546
22007,619,322,297,2012,63547
22008,1185,526,659,2012,63548
22009,2763,1372,1391,2012,63549
22010,305,138,167,2012,63551
22011,7929,3782,4147,2012,63552
22012,3128,1568,1560,2012,63555
22013,3583,1896,1687,2012,63556
22014,240,103,137,2012,63557
22015,675,343,332,2012,63558
22016,1523,836,687,2012,63559
22017,244,124,120,2012,63560
22018,1531,750,781,2012,63561
22019,645,318,327,2012,63563
22020,4005,2052,1953,2012,63565
22021,152,65,87,2012,63566
22022,276,115,161,2012,63567
22023,16391,7770,8621,2012,63601
22024,1468,743,725,2012,63620
22025,1437,669,768,2012,63621
22026,835,451,384,2012,63622
22027,795,384,411,2012,63623
22028,3457,1670,1787,2012,63624
22029,441,233,208,2012,63625
22030,934,413,521,2012,63626
22031,2776,1392,1384,2012,63627
22032,16944,10284,6660,2012,63628
22033,1503,827,676,2012,63629
22034,4362,1987,2375,2012,63630
22035,1178,622,556,2012,63631
22036,1066,515,551,2012,63633
22037,563,267,296,2012,63636
22038,1053,529,524,2012,63637
22039,2595,1278,1317,2012,63638
22040,26864,14585,12279,2012,63640
22041,11335,5558,5777,2012,63645
22042,1711,825,886,2012,63648
22043,4406,2326,2080,2012,63650
22044,1197,624,573,2012,63653
22045,616,304,312,2012,63654
22046,1763,875,888,2012,63655
22047,344,175,169,2012,63656
22048,4017,2463,1554,2012,63660
22049,1451,730,721,2012,63662
22050,709,347,362,2012,63663
22051,8230,4096,4134,2012,63664
22052,254,154,100,2012,63665
22053,127,58,69,2012,63666
22054,10854,5375,5479,2012,63670
22055,2105,1097,1008,2012,63673
22056,203,108,95,2012,63674
22057,265,124,141,2012,63675
22058,34967,17074,17893,2012,63701
22059,9411,4377,5034,2012,63703
22060,3793,1880,1913,2012,63730
22061,718,335,383,2012,63732
22062,773,397,376,2012,63735
22063,3335,1561,1774,2012,63736
22064,34,16,18,2012,63738
22065,533,352,181,2012,63739
22066,5645,2843,2802,2012,63740
22067,55,33,22,2012,63742
22068,114,41,73,2012,63743
22069,124,64,60,2012,63744
22070,36,21,15,2012,63745
22071,4,0,4,2012,63746
22072,560,279,281,2012,63747
22073,1014,546,468,2012,63748
22074,12,6,6,2012,63750
22075,1103,502,601,2012,63751
22076,24504,11508,12996,2012,63755
22077,111,48,63,2012,63758
22078,843,444,399,2012,63760
22079,261,158,103,2012,63763
22080,5244,2554,2690,2012,63764
22081,1058,560,498,2012,63766
22082,608,309,299,2012,63767
22083,1597,921,676,2012,63769
22084,135,63,72,2012,63770
22085,2695,1282,1413,2012,63771
22086,71,46,25,2012,63774
22087,16553,8331,8222,2012,63775
22088,6690,3256,3434,2012,63780
22089,1130,528,602,2012,63781
22090,356,203,153,2012,63782
22091,192,108,84,2012,63783
22092,299,126,173,2012,63784
22093,1071,541,530,2012,63785
22094,1019,533,486,2012,63787
22095,23370,11189,12181,2012,63801
22096,383,202,181,2012,63820
22097,1097,566,531,2012,63821
22098,3136,1442,1694,2012,63822
22099,1296,716,580,2012,63823
22100,231,123,108,2012,63824
22101,4364,2215,2149,2012,63825
22102,30,14,16,2012,63826
22103,905,461,444,2012,63827
22104,257,140,117,2012,63828
22105,1168,596,572,2012,63829
22106,7044,3298,3746,2012,63830
22107,278,110,168,2012,63833
22108,6766,3820,2946,2012,63834
22109,1514,762,752,2012,63837
22110,486,235,251,2012,63839
22111,12868,6041,6827,2012,63841
22112,5671,2730,2941,2012,63845
22113,1591,794,797,2012,63846
22114,35,20,15,2012,63847
22115,1461,694,767,2012,63848
22116,267,118,149,2012,63849
22117,4011,1901,2110,2012,63851
22118,1386,757,629,2012,63852
22119,308,155,153,2012,63853
22120,1283,724,559,2012,63855
22121,13000,6069,6931,2012,63857
22122,116,27,89,2012,63860
22123,1492,638,854,2012,63862
22124,6208,2981,3227,2012,63863
22125,502,260,242,2012,63866
22126,1416,693,723,2012,63867
22127,776,373,403,2012,63868
22128,3795,1869,1926,2012,63869
22129,1012,510,502,2012,63870
22130,5149,2501,2648,2012,63873
22131,293,136,157,2012,63874
22132,2121,1037,1084,2012,63876
22133,4046,1888,2158,2012,63877
22134,128,62,66,2012,63878
22135,676,342,334,2012,63879
22136,89,52,37,2012,63880
22137,480,264,216,2012,63882
22138,34429,16546,17883,2012,63901
22139,0,0,0,2012,63902
22140,1197,576,621,2012,63932
22141,3825,1764,2061,2012,63933
22142,94,43,51,2012,63934
22143,10064,4940,5124,2012,63935
22144,831,482,349,2012,63936
22145,3084,1603,1481,2012,63937
22146,1521,679,842,2012,63939
22147,1429,774,655,2012,63940
22148,548,251,297,2012,63941
22149,777,398,379,2012,63942
22150,1038,502,536,2012,63943
22151,1827,874,953,2012,63944
22152,1245,491,754,2012,63945
22153,384,152,232,2012,63951
22154,383,174,209,2012,63952
22155,1594,798,796,2012,63953
22156,1081,542,539,2012,63954
22157,200,110,90,2012,63955
22158,959,510,449,2012,63956
22159,5985,2927,3058,2012,63957
22160,3153,1695,1458,2012,63960
22161,1910,876,1034,2012,63961
22162,0,0,0,2012,63962
22163,613,262,351,2012,63964
22164,2534,1267,1267,2012,63965
22165,2159,1221,938,2012,63966
22166,1717,885,832,2012,63967
22167,623,318,305,2012,64001
22168,3167,1543,1624,2012,64011
22169,27259,13445,13814,2012,64012
22170,25991,12210,13781,2012,64014
22171,30151,15136,15015,2012,64015
22172,4995,2485,2510,2012,64016
22173,395,200,195,2012,64017
22174,932,491,441,2012,64018
22175,1861,891,970,2012,64019
22176,3663,1585,2078,2012,64020
22177,471,243,228,2012,64021
22178,158,90,68,2012,64022
22179,16715,7975,8740,2012,64024
22180,16210,8300,7910,2012,64029
22181,24463,11442,13021,2012,64030
22182,8190,3948,4242,2012,64034
22183,1013,544,469,2012,64035
22184,363,246,117,2012,64036
22185,6419,3198,3221,2012,64037
22186,6313,3118,3195,2012,64040
22187,4480,2266,2214,2012,64048
22188,21631,10178,11453,2012,64050
22189,20945,9903,11042,2012,64052
22190,5256,2586,2670,2012,64053
22191,3841,1995,1846,2012,64054
22192,33467,16014,17453,2012,64055
22193,16756,8094,8662,2012,64056
22194,13680,6304,7376,2012,64057
22195,7079,3381,3698,2012,64058
22196,13017,6551,6466,2012,64060
22197,3516,1667,1849,2012,64061
22198,5713,2814,2899,2012,64062
22199,20467,9920,10547,2012,64063
22200,16457,8109,8348,2012,64064
22201,94,35,59,2012,64065
22202,19,15,4,2012,64066
22203,5707,2685,3022,2012,64067
22204,36474,18304,18170,2012,64068
22205,3347,1600,1747,2012,64070
22206,904,415,489,2012,64071
22207,227,124,103,2012,64072
22208,779,423,356,2012,64074
22209,11611,5619,5992,2012,64075
22210,9368,4774,4594,2012,64076
22211,1791,938,853,2012,64077
22212,9669,4907,4762,2012,64078
22213,12569,6389,6180,2012,64079
22214,12070,5793,6277,2012,64080
22215,22728,10862,11866,2012,64081
22216,14208,7037,7171,2012,64082
22217,20375,9992,10383,2012,64083
22218,1812,864,948,2012,64084
22219,8694,4142,4552,2012,64085
22220,21121,10242,10879,2012,64086
22221,1226,601,625,2012,64088
22222,10866,5548,5318,2012,64089
22223,64,31,33,2012,64090
22224,64,30,34,2012,64092
22225,27401,13923,13478,2012,64093
22226,1187,589,598,2012,64096
22227,1482,847,635,2012,64097
22228,2843,1409,1434,2012,64098
22229,339,310,29,2012,64101
22230,0,0,0,2012,64102
22231,3698,1954,1744,2012,64105
22232,7712,4195,3517,2012,64106
22233,8348,4463,3885,2012,64108
22234,9279,4724,4555,2012,64109
22235,14896,7203,7693,2012,64110
22236,15848,8379,7469,2012,64111
22237,7949,3478,4471,2012,64112
22238,11719,5700,6019,2012,64113
22239,24451,11504,12947,2012,64114
22240,14445,7211,7234,2012,64116
22241,13609,6559,7050,2012,64117
22242,41760,20263,21497,2012,64118
22243,27683,13615,14068,2012,64119
22244,373,214,159,2012,64120
22245,10082,4972,5110,2012,64123
22246,11267,5728,5539,2012,64124
22247,1678,827,851,2012,64125
22248,5985,2986,2999,2012,64126
22249,16343,7555,8788,2012,64127
22250,12014,5322,6692,2012,64128
22251,9178,3996,5182,2012,64129
22252,21250,9849,11401,2012,64130
22253,22559,11104,11455,2012,64131
22254,13228,5861,7367,2012,64132
22255,34953,17272,17681,2012,64133
22256,21832,10452,11380,2012,64134
22257,2156,932,1224,2012,64136
22258,11737,6134,5603,2012,64137
22259,24727,11390,13337,2012,64138
22260,1816,902,914,2012,64139
22261,5154,2461,2693,2012,64145
22262,1467,770,697,2012,64146
22263,751,289,462,2012,64147
22264,277,156,121,2012,64149
22265,3083,1544,1539,2012,64150
22266,24023,11359,12664,2012,64151
22267,26126,12811,13315,2012,64152
22268,5045,2656,2389,2012,64153
22269,9606,4756,4850,2012,64154
22270,22080,10629,11451,2012,64155
22271,4907,2223,2684,2012,64156
22272,15807,7446,8361,2012,64157
22273,5074,2473,2601,2012,64158
22274,361,197,164,2012,64161
22275,636,374,262,2012,64163
22276,327,175,152,2012,64164
22277,19,15,4,2012,64165
22278,358,202,156,2012,64166
22279,410,177,233,2012,64167
22280,0,0,0,2012,64192
22281,1256,599,657,2012,64401
22282,2636,1200,1436,2012,64402
22283,95,41,54,2012,64420
22284,659,315,344,2012,64421
22285,199,103,96,2012,64422
22286,832,421,411,2012,64423
22287,4309,2045,2264,2012,64424
22288,337,159,178,2012,64426
22289,657,304,353,2012,64427
22290,908,416,492,2012,64428
22291,13444,8194,5250,2012,64429
22292,669,346,323,2012,64430
22293,443,213,230,2012,64431
22294,149,59,90,2012,64432
22295,239,159,80,2012,64433
22296,440,238,202,2012,64434
22297,748,359,389,2012,64436
22298,789,403,386,2012,64437
22299,349,147,202,2012,64438
22300,1695,821,874,2012,64439
22301,887,418,469,2012,64440
22302,136,56,80,2012,64441
22303,777,402,375,2012,64442
22304,1443,611,832,2012,64443
22305,1509,744,765,2012,64444
22306,258,121,137,2012,64445
22307,980,492,488,2012,64446
22308,1161,607,554,2012,64448
22309,450,246,204,2012,64449
22310,488,238,250,2012,64451
22311,187,119,68,2012,64453
22312,2693,1390,1303,2012,64454
22313,336,167,169,2012,64455
22314,1317,650,667,2012,64456
22315,252,112,140,2012,64457
22316,204,104,100,2012,64458
22317,370,211,159,2012,64459
22318,814,385,429,2012,64461
22319,1631,824,807,2012,64463
22320,4189,2110,2079,2012,64465
22321,499,250,249,2012,64466
22322,169,88,81,2012,64467
22323,15915,8226,7689,2012,64468
22324,2369,1233,1136,2012,64469
22325,1475,695,780,2012,64470
22326,566,303,263,2012,64471
22327,1540,789,751,2012,64473
22328,900,446,454,2012,64474
22329,316,166,150,2012,64475
22330,403,189,214,2012,64476
22331,3530,1738,1792,2012,64477
22332,1153,481,672,2012,64479
22333,339,131,208,2012,64480
22334,1163,630,533,2012,64481
22335,2071,1009,1062,2012,64482
22336,587,280,307,2012,64483
22337,1053,512,541,2012,64484
22338,7951,3921,4030,2012,64485
22339,586,280,306,2012,64486
22340,862,441,421,2012,64487
22341,1970,1091,879,2012,64489
22342,2236,1191,1045,2012,64490
22343,1909,976,933,2012,64491
22344,1637,927,710,2012,64492
22345,462,249,213,2012,64493
22346,986,486,500,2012,64494
22347,106,69,37,2012,64496
22348,515,225,290,2012,64497
22349,413,195,218,2012,64498
22350,94,50,44,2012,64499
22351,12554,5952,6602,2012,64501
22352,12395,5927,6468,2012,64503
22353,10964,5817,5147,2012,64504
22354,13559,6812,6747,2012,64505
22355,23377,12212,11165,2012,64506
22356,14592,6959,7633,2012,64507
22357,12093,5251,6842,2012,64601
22358,522,228,294,2012,64620
22359,704,407,297,2012,64622
22360,506,264,242,2012,64623
22361,1706,789,917,2012,64624
22362,563,289,274,2012,64625
22363,5883,2891,2992,2012,64628
22364,449,232,217,2012,64630
22365,867,427,440,2012,64631
22366,596,296,300,2012,64632
22367,5015,2329,2686,2012,64633
22368,557,247,310,2012,64635
22369,382,156,226,2012,64636
22370,583,275,308,2012,64637
22371,477,245,232,2012,64638
22372,251,109,142,2012,64639
22373,3144,1597,1547,2012,64640
22374,625,299,326,2012,64641
22375,939,504,435,2012,64642
22376,1471,756,715,2012,64643
22377,3338,1535,1803,2012,64644
22378,198,107,91,2012,64645
22379,428,219,209,2012,64646
22380,375,188,187,2012,64647
22381,2097,1052,1045,2012,64648
22382,685,330,355,2012,64649
22383,643,376,267,2012,64650
22384,672,303,369,2012,64651
22385,470,213,257,2012,64652
22386,735,353,382,2012,64653
22387,56,24,32,2012,64654
22388,124,65,59,2012,64655
22389,266,135,131,2012,64656
22390,500,202,298,2012,64657
22391,3368,1544,1824,2012,64658
22392,995,494,501,2012,64659
22393,524,288,236,2012,64660
22394,1002,486,516,2012,64661
22395,449,242,207,2012,64664
22396,357,182,175,2012,64667
22397,1382,701,681,2012,64668
22398,987,552,435,2012,64670
22399,2055,1154,901,2012,64671
22400,85,46,39,2012,64672
22401,2343,1166,1177,2012,64673
22402,427,215,212,2012,64674
22403,296,152,144,2012,64676
22404,744,344,400,2012,64679
22405,167,63,104,2012,64681
22406,292,178,114,2012,64682
22407,7865,3747,4118,2012,64683
22408,245,128,117,2012,64686
22409,643,300,343,2012,64688
22410,562,286,276,2012,64689
22411,14661,6912,7749,2012,64701
22412,4509,2257,2252,2012,64720
22413,415,177,238,2012,64722
22414,620,318,302,2012,64723
22415,2048,966,1082,2012,64724
22416,2182,1052,1130,2012,64725
22417,453,190,263,2012,64726
22418,690,358,332,2012,64728
22419,7051,3440,3611,2012,64730
22420,1251,618,633,2012,64733
22421,1952,962,990,2012,64734
22422,13653,6582,7071,2012,64735
22423,1147,606,541,2012,64738
22424,1039,531,508,2012,64739
22425,1587,760,827,2012,64740
22426,373,194,179,2012,64741
22427,2346,1153,1193,2012,64742
22428,323,146,177,2012,64743
22429,7285,3535,3750,2012,64744
22430,168,71,97,2012,64745
22431,1515,669,846,2012,64746
22432,3781,1942,1839,2012,64747
22433,1464,747,717,2012,64748
22434,384,201,183,2012,64750
22435,692,352,340,2012,64752
22436,2326,1130,1196,2012,64755
22437,746,365,381,2012,64756
22438,8525,4204,4321,2012,64759
22439,1517,733,784,2012,64761
22440,1404,706,698,2012,64762
22441,1276,654,622,2012,64763
22442,70,49,21,2012,64765
22443,408,187,221,2012,64767
22444,652,322,330,2012,64769
22445,995,507,488,2012,64770
22446,728,326,402,2012,64771
22447,13660,6538,7122,2012,64772
22448,3688,1852,1836,2012,64776
22449,617,266,351,2012,64778
22450,2575,1324,1251,2012,64779
22451,819,436,383,2012,64780
22452,125,49,76,2012,64781
22453,753,376,377,2012,64783
22454,1624,816,808,2012,64784
22455,1471,737,734,2012,64788
22456,821,358,463,2012,64790
22457,34457,16836,17621,2012,64801
22458,37947,17811,20136,2012,64804
22459,715,361,354,2012,64830
22460,6097,2929,3168,2012,64831
22461,774,424,350,2012,64832
22462,107,70,37,2012,64833
22463,9509,4396,5113,2012,64834
22464,1773,913,860,2012,64835
22465,23934,11736,12198,2012,64836
22466,2999,1456,1543,2012,64840
22467,317,139,178,2012,64841
22468,899,472,427,2012,64842
22469,3474,1952,1522,2012,64843
22470,4882,2621,2261,2012,64844
22471,426,245,181,2012,64847
22472,601,286,315,2012,64848
22473,206,136,70,2012,64849
22474,23757,11805,11952,2012,64850
22475,4334,2115,2219,2012,64854
22476,3071,1610,1461,2012,64855
22477,4064,2065,1999,2012,64856
22478,439,204,235,2012,64857
22479,258,118,140,2012,64858
22480,1070,546,524,2012,64859
22481,1226,630,596,2012,64861
22482,2615,1291,1324,2012,64862
22483,1736,874,862,2012,64863
22484,5150,2308,2842,2012,64865
22485,1346,704,642,2012,64866
22486,1473,760,713,2012,64867
22487,14443,7465,6978,2012,64870
22488,598,320,278,2012,64873
22489,849,382,467,2012,64874
22490,367,171,196,2012,65001
22491,5907,2932,2975,2012,65010
22492,2074,997,1077,2012,65011
22493,3013,1402,1611,2012,65013
22494,2659,1430,1229,2012,65014
22495,1737,888,849,2012,65016
22496,1648,668,980,2012,65017
22497,7618,3617,4001,2012,65018
22498,14155,6839,7316,2012,65020
22499,1512,775,737,2012,65023
22500,985,513,472,2012,65024
22501,721,337,384,2012,65025
22502,10928,5398,5530,2012,65026
22503,1601,854,747,2012,65032
22504,634,266,368,2012,65034
22505,1827,888,939,2012,65035
22506,4788,2274,2514,2012,65037
22507,2562,1336,1226,2012,65039
22508,1289,578,711,2012,65040
22509,5718,2685,3033,2012,65041
22510,9904,5088,4816,2012,65043
22511,1337,688,649,2012,65046
22512,1315,693,622,2012,65047
22513,44,17,27,2012,65048
22514,6443,3235,3208,2012,65049
22515,870,420,450,2012,65050
22516,4835,2558,2277,2012,65051
22517,4186,2109,2077,2012,65052
22518,1278,708,570,2012,65053
22519,651,287,364,2012,65054
22520,1269,677,592,2012,65058
22521,510,203,307,2012,65059
22522,844,457,387,2012,65061
22523,21,10,11,2012,65062
22524,4227,1981,2246,2012,65063
22525,404,212,192,2012,65064
22526,6943,3487,3456,2012,65065
22527,6551,3346,3205,2012,65066
22528,416,214,202,2012,65067
22529,743,380,363,2012,65068
22530,715,333,382,2012,65069
22531,1633,880,753,2012,65072
22532,3276,1626,1650,2012,65074
22533,787,368,419,2012,65075
22534,754,378,376,2012,65076
22535,460,240,220,2012,65077
22536,3432,1734,1698,2012,65078
22537,4392,2241,2151,2012,65079
22538,798,452,346,2012,65080
22539,3931,2618,1313,2012,65081
22540,1074,580,494,2012,65082
22541,225,108,117,2012,65083
22542,7562,3734,3828,2012,65084
22543,1124,585,539,2012,65085
22544,29216,15692,13524,2012,65101
22545,39251,19005,20246,2012,65109
22546,40537,19852,20685,2012,65201
22547,45136,21883,23253,2012,65202
22548,54409,25801,28608,2012,65203
22549,293,37,256,2012,65215
22550,656,343,313,2012,65230
22551,3073,1577,1496,2012,65231
22552,197,107,90,2012,65232
22553,11516,6244,5272,2012,65233
22554,1581,812,769,2012,65236
22555,830,426,404,2012,65237
22556,1262,621,641,2012,65239
22557,8046,4155,3891,2012,65240
22558,2914,1435,1479,2012,65243
22559,315,137,178,2012,65244
22560,105,45,60,2012,65246
22561,836,400,436,2012,65247
22562,4512,2248,2264,2012,65248
22563,560,338,222,2012,65250
22564,21990,11516,10474,2012,65251
22565,2099,977,1122,2012,65254
22566,3435,1603,1832,2012,65255
22567,1595,793,802,2012,65256
22568,1240,673,567,2012,65257
22569,484,259,225,2012,65258
22570,2753,1429,1324,2012,65259
22571,542,292,250,2012,65260
22572,958,449,509,2012,65261
22573,763,416,347,2012,65262
22574,2054,1048,1006,2012,65263
22575,643,286,357,2012,65264
22576,15139,7095,8044,2012,65265
22577,18076,9590,8486,2012,65270
22578,1855,855,1000,2012,65274
22579,2505,1183,1322,2012,65275
22580,1852,931,921,2012,65276
22581,124,76,48,2012,65278
22582,1487,761,726,2012,65279
22583,276,168,108,2012,65280
22584,3062,1504,1558,2012,65281
22585,255,105,150,2012,65282
22586,341,208,133,2012,65283
22587,1909,981,928,2012,65284
22588,843,487,356,2012,65285
22589,89,43,46,2012,65286
22590,413,173,240,2012,65287
22591,34147,16561,17586,2012,65301
22592,3514,2133,1381,2012,65305
22593,42,21,21,2012,65320
22594,442,242,200,2012,65321
22595,602,326,276,2012,65322
22596,886,465,421,2012,65323
22597,1521,842,679,2012,65324
22598,3472,1745,1727,2012,65325
22599,1647,918,729,2012,65326
22600,254,128,126,2012,65327
22601,717,363,354,2012,65329
22602,398,221,177,2012,65330
22603,1890,946,944,2012,65332
22604,608,333,275,2012,65333
22605,956,498,458,2012,65334
22606,134,77,57,2012,65335
22607,5883,2956,2927,2012,65336
22608,1986,1020,966,2012,65337
22609,3072,1575,1497,2012,65338
22610,575,257,318,2012,65339
22611,15833,7904,7929,2012,65340
22612,366,132,234,2012,65344
22613,424,202,222,2012,65345
22614,856,468,388,2012,65347
22615,1507,709,798,2012,65348
22616,2536,1332,1204,2012,65349
22617,1591,791,800,2012,65350
22618,2372,1237,1135,2012,65351
22619,482,254,228,2012,65354
22620,10257,5062,5195,2012,65355
22621,4619,2291,2328,2012,65360
22622,32073,17286,14787,2012,65401
22623,81,32,49,2012,65436
22624,2842,1445,1397,2012,65438
22625,251,115,136,2012,65439
22626,507,305,202,2012,65440
22627,5126,2529,2597,2012,65441
22628,114,37,77,2012,65443
22629,859,463,396,2012,65444
22630,320,173,147,2012,65446
22631,410,161,249,2012,65449
22632,3361,1544,1817,2012,65452
22633,8509,4435,4074,2012,65453
22634,647,426,221,2012,65456
22635,289,130,159,2012,65457
22636,7323,3856,3467,2012,65459
22637,98,49,49,2012,65461
22638,1555,704,851,2012,65462
22639,849,497,352,2012,65463
22640,573,319,254,2012,65464
22641,1834,840,994,2012,65466
22642,427,148,279,2012,65468
22643,957,508,449,2012,65470
22644,16383,11314,5069,2012,65473
22645,249,149,100,2012,65479
22646,4855,2324,2531,2012,65483
22647,243,128,115,2012,65484
22648,4004,1981,2023,2012,65486
22649,204,122,82,2012,65501
22650,282,133,149,2012,65529
22651,1211,637,574,2012,65534
22652,1762,862,900,2012,65535
22653,29603,14502,15101,2012,65536
22654,121,50,71,2012,65541
22655,6672,3960,2712,2012,65542
22656,583,300,283,2012,65543
22657,5358,2444,2914,2012,65548
22658,3890,1741,2149,2012,65550
22659,2375,1105,1270,2012,65552
22660,960,516,444,2012,65555
22661,5716,2807,2909,2012,65556
22662,106,45,61,2012,65557
22663,9045,4403,4642,2012,65559
22664,14155,6962,7193,2012,65560
22665,304,193,111,2012,65564
22666,5389,2449,2940,2012,65565
22667,857,435,422,2012,65566
22668,1046,435,611,2012,65567
22669,590,306,284,2012,65570
22670,1908,905,1003,2012,65571
22671,717,410,307,2012,65580
22672,2108,1090,1018,2012,65582
22673,11380,5916,5464,2012,65583
22674,9564,4537,5027,2012,65584
22675,18,9,9,2012,65586
22676,2604,1264,1340,2012,65588
22677,143,88,55,2012,65589
22678,1016,503,513,2012,65590
22679,1729,900,829,2012,65591
22680,676,352,324,2012,65601
22681,271,168,103,2012,65603
22682,3743,1885,1858,2012,65604
22683,11283,5483,5800,2012,65605
22684,3465,1717,1748,2012,65606
22685,9439,4569,4870,2012,65608
22686,621,308,313,2012,65609
22687,5153,2487,2666,2012,65610
22688,1796,757,1039,2012,65611
22689,1442,741,701,2012,65612
22690,16826,8251,8575,2012,65613
22691,702,329,373,2012,65614
22692,23786,11540,12246,2012,65616
22693,2812,1589,1223,2012,65617
22694,287,86,201,2012,65618
22695,7719,4060,3659,2012,65619
22696,179,102,77,2012,65620
22697,9093,4515,4578,2012,65622
22698,11,2,9,2012,65623
22699,1710,775,935,2012,65624
22700,8424,4066,4358,2012,65625
22701,1919,875,1044,2012,65626
22702,478,204,274,2012,65627
22703,499,276,223,2012,65629
22704,138,72,66,2012,65630
22705,4609,2190,2419,2012,65631
22706,2377,1161,1216,2012,65632
22707,4467,2300,2167,2012,65633
22708,935,491,444,2012,65634
22709,725,393,332,2012,65635
22710,1585,796,789,2012,65637
22711,375,175,200,2012,65638
22712,908,436,472,2012,65640
22713,1144,601,543,2012,65641
22714,3094,1721,1373,2012,65644
22715,2155,1063,1092,2012,65646
22716,2606,1314,1292,2012,65647
22717,5963,3090,2873,2012,65648
22718,1269,604,665,2012,65649
22719,1196,571,625,2012,65650
22720,3738,2126,1612,2012,65652
22721,5201,2487,2714,2012,65653
22722,146,80,66,2012,65654
22723,3513,1741,1772,2012,65655
22724,5190,2704,2486,2012,65656
22725,140,61,79,2012,65657
22726,1600,746,854,2012,65658
22727,174,87,87,2012,65660
22728,2112,1047,1065,2012,65661
22729,1068,491,577,2012,65662
22730,2675,1327,1348,2012,65663
22731,166,77,89,2012,65664
22732,3553,1772,1781,2012,65667
22733,1929,784,1145,2012,65668
22734,1855,882,973,2012,65669
22735,9577,4732,4845,2012,65672
22736,2850,1404,1446,2012,65674
22737,503,260,243,2012,65676
22738,2912,1327,1585,2012,65679
22739,1195,648,547,2012,65680
22740,2637,1374,1263,2012,65681
22741,2235,1130,1105,2012,65682
22742,566,280,286,2012,65685
22743,4289,2097,2192,2012,65686
22744,4682,2135,2547,2012,65689
22745,244,107,137,2012,65690
22746,1717,906,811,2012,65692
22747,535,200,335,2012,65702
22748,3487,1748,1739,2012,65704
22749,3608,1657,1951,2012,65705
22750,14622,6932,7690,2012,65706
22751,2204,1207,997,2012,65707
22752,13173,6541,6632,2012,65708
22753,1387,690,697,2012,65710
22754,9726,4685,5041,2012,65711
22755,9148,4591,4557,2012,65712
22756,2628,1311,1317,2012,65713
22757,29750,14696,15054,2012,65714
22758,75,32,43,2012,65715
22759,2914,1528,1386,2012,65717
22760,738,352,386,2012,65720
22761,29311,14167,15144,2012,65721
22762,1155,636,519,2012,65722
22763,4262,2012,2250,2012,65723
22764,1340,626,714,2012,65724
22765,2328,1153,1175,2012,65725
22766,401,223,178,2012,65727
22767,120,59,61,2012,65728
22768,393,232,161,2012,65729
22769,210,103,107,2012,65730
22770,108,43,65,2012,65731
22771,667,353,314,2012,65732
22772,758,357,401,2012,65733
22773,3143,1568,1575,2012,65734
22774,203,82,121,2012,65735
22775,7792,3763,4029,2012,65737
22776,17390,7867,9523,2012,65738
22777,1402,658,744,2012,65739
22778,3618,1822,1796,2012,65740
22779,11551,6107,5444,2012,65742
22780,163,76,87,2012,65744
22781,2451,1190,1261,2012,65745
22782,7721,3964,3757,2012,65746
22783,3799,1856,1943,2012,65747
22784,325,156,169,2012,65752
22785,4947,2350,2597,2012,65753
22786,878,427,451,2012,65754
22787,533,327,206,2012,65755
22788,630,315,315,2012,65756
22789,6806,3353,3453,2012,65757
22790,1315,654,661,2012,65759
22791,518,283,235,2012,65760
22792,1110,621,489,2012,65761
22793,454,231,223,2012,65762
22794,1430,719,711,2012,65764
22795,131,76,55,2012,65766
22796,1593,748,845,2012,65767
22797,596,336,260,2012,65768
22798,3296,1649,1647,2012,65769
22799,2749,1313,1436,2012,65770
22800,1771,1020,751,2012,65771
22801,2321,1244,1077,2012,65772
22802,546,336,210,2012,65773
22803,1020,423,597,2012,65774
22804,24384,11697,12687,2012,65775
22805,230,107,123,2012,65777
22806,480,237,243,2012,65778
22807,2398,1317,1081,2012,65779
22808,8034,4045,3989,2012,65781
22809,165,109,56,2012,65783
22810,0,0,0,2012,65784
22811,5443,2827,2616,2012,65785
22812,2547,1346,1201,2012,65786
22813,1397,672,725,2012,65787
22814,427,226,201,2012,65788
22815,1786,948,838,2012,65789
22816,641,330,311,2012,65790
22817,4726,2380,2346,2012,65791
22818,6852,3467,3385,2012,65793
22819,43401,21235,22166,2012,65802
22820,42610,21067,21543,2012,65803
22821,36748,17432,19316,2012,65804
22822,9377,5018,4359,2012,65806
22823,56381,27013,29368,2012,65807
22824,10792,5136,5656,2012,65809
22825,21200,10191,11009,2012,65810
22826,13867,6576,7291,2012,66002
22827,7260,3577,3683,2012,66006
22828,6228,3067,3161,2012,66007
22829,244,129,115,2012,66008
22830,603,346,257,2012,66010
22831,10810,5323,5487,2012,66012
22832,2065,1204,861,2012,66013
22833,465,209,256,2012,66014
22834,777,431,346,2012,66015
22835,317,173,144,2012,66016
22836,321,177,144,2012,66017
22837,5611,2830,2781,2012,66018
22838,334,166,168,2012,66019
22839,1696,847,849,2012,66020
22840,2212,1122,1090,2012,66021
22841,1263,611,652,2012,66023
22842,748,388,360,2012,66024
22843,7843,3755,4088,2012,66025
22844,968,511,457,2012,66026
22845,5675,2858,2817,2012,66027
22846,21225,10774,10451,2012,66030
22847,398,384,14,2012,66031
22848,5424,2590,2834,2012,66032
22849,672,364,308,2012,66033
22850,1417,684,733,2012,66035
22851,654,321,333,2012,66039
22852,2980,1472,1508,2012,66040
22853,707,373,334,2012,66041
22854,697,320,377,2012,66042
22855,10673,6475,4198,2012,66043
22856,27800,14008,13792,2012,66044
22857,2533,940,1593,2012,66045
22858,19292,10006,9286,2012,66046
22859,19172,10181,8991,2012,66047
22860,35632,18891,16741,2012,66048
22861,25623,12285,13338,2012,66049
22862,1989,1046,943,2012,66050
22863,2054,1083,971,2012,66052
22864,7496,3793,3703,2012,66053
22865,2767,1405,1362,2012,66054
22866,1598,783,815,2012,66056
22867,387,224,163,2012,66058
22868,1135,603,532,2012,66060
22869,55422,28638,26784,2012,66061
22870,74922,36820,38102,2012,66062
22871,5834,2757,3077,2012,66064
22872,2553,1394,1159,2012,66066
22873,16392,8000,8392,2012,66067
22874,2644,1319,1325,2012,66070
22875,12305,6010,6295,2012,66071
22876,1162,591,571,2012,66072
22877,2092,984,1108,2012,66073
22878,1973,949,1024,2012,66075
22879,2050,1128,922,2012,66076
22880,851,394,457,2012,66078
22881,578,292,286,2012,66079
22882,801,416,385,2012,66080
22883,8920,4566,4354,2012,66083
22884,7853,4078,3775,2012,66085
22885,9655,4861,4794,2012,66086
22886,1916,988,928,2012,66087
22887,2560,1282,1278,2012,66088
22888,2675,1327,1348,2012,66090
22889,158,107,51,2012,66091
22890,4178,2087,2091,2012,66092
22891,546,290,256,2012,66093
22892,487,254,233,2012,66094
22893,1243,640,603,2012,66095
22894,969,546,423,2012,66097
22895,13729,7204,6525,2012,66101
22896,28923,14986,13937,2012,66102
22897,13368,6763,6605,2012,66103
22898,24956,11381,13575,2012,66104
22899,2442,1107,1335,2012,66105
22900,23150,11479,11671,2012,66106
22901,21365,10827,10538,2012,66109
22902,10823,5215,5608,2012,66111
22903,11194,5010,6184,2012,66112
22904,0,0,0,2012,66115
22905,0,0,0,2012,66118
22906,16703,8005,8698,2012,66202
22907,19510,9525,9985,2012,66203
22908,18379,8458,9921,2012,66204
22909,13461,6429,7032,2012,66205
22910,10056,4767,5289,2012,66206
22911,12830,5944,6886,2012,66207
22912,21354,9640,11714,2012,66208
22913,19211,9141,10070,2012,66209
22914,17648,8590,9058,2012,66210
22915,4678,2017,2661,2012,66211
22916,32677,15311,17366,2012,66212
22917,28829,14173,14656,2012,66213
22918,11844,5486,6358,2012,66214
22919,24764,11901,12863,2012,66215
22920,25789,12433,13356,2012,66216
22921,4811,2186,2625,2012,66217
22922,7858,4064,3794,2012,66218
22923,10065,4854,5211,2012,66219
22924,7171,3547,3624,2012,66220
22925,15510,7966,7544,2012,66221
22926,21093,10428,10665,2012,66223
22927,11661,5808,5853,2012,66224
22928,12407,6214,6193,2012,66226
22929,4058,1902,2156,2012,66227
22930,1727,829,898,2012,66401
22931,2835,1367,1468,2012,66402
22932,873,429,444,2012,66403
22933,540,281,259,2012,66404
22934,424,181,243,2012,66406
22935,410,221,189,2012,66407
22936,505,254,251,2012,66408
22937,3084,1509,1575,2012,66409
22938,1305,555,750,2012,66411
22939,327,153,174,2012,66412
22940,1861,915,946,2012,66413
22941,2563,1277,1286,2012,66414
22942,979,542,437,2012,66415
22943,644,331,313,2012,66416
22944,290,168,122,2012,66417
22945,629,296,333,2012,66418
22946,341,153,188,2012,66419
22947,508,226,282,2012,66422
22948,962,512,450,2012,66423
22949,659,319,340,2012,66424
22950,484,231,253,2012,66425
22951,1189,586,603,2012,66427
22952,332,155,177,2012,66428
22953,841,423,418,2012,66429
22954,731,418,313,2012,66431
22955,433,220,213,2012,66432
22956,4762,2350,2412,2012,66434
22957,5685,2899,2786,2012,66436
22958,158,72,86,2012,66438
22959,2844,1354,1490,2012,66439
22960,1985,912,1073,2012,66440
22961,26226,13200,13026,2012,66441
22962,14430,8189,6241,2012,66442
22963,699,287,412,2012,66449
22964,1709,854,855,2012,66451
22965,267,135,132,2012,66501
22966,44126,23237,20889,2012,66502
22967,13889,6891,6998,2012,66503
22968,3898,1564,2334,2012,66506
22969,1251,624,627,2012,66507
22970,4382,2232,2150,2012,66508
22971,2739,1419,1320,2012,66509
22972,667,343,324,2012,66510
22973,3315,1789,1526,2012,66512
22974,1733,880,853,2012,66514
22975,388,173,215,2012,66515
22976,290,151,139,2012,66516
22977,1822,902,920,2012,66517
22978,184,92,92,2012,66518
22979,622,289,333,2012,66520
22980,1718,879,839,2012,66521
22981,31,15,16,2012,66522
22982,3872,1908,1964,2012,66523
22983,2689,1297,1392,2012,66524
22984,804,331,473,2012,66526
22985,303,159,144,2012,66527
22986,1044,538,506,2012,66528
22987,1261,585,676,2012,66531
22988,679,368,311,2012,66532
22989,1427,679,748,2012,66533
22990,3751,1850,1901,2012,66534
22991,2651,1262,1389,2012,66535
22992,4059,1986,2073,2012,66536
22993,1319,669,650,2012,66537
22994,3126,1579,1547,2012,66538
22995,3126,1662,1464,2012,66539
22996,431,255,176,2012,66540
22997,329,161,168,2012,66541
22998,3274,1618,1656,2012,66542
22999,1004,531,473,2012,66543
23000,301,149,152,2012,66544
23001,1131,624,507,2012,66546
23002,7503,3829,3674,2012,66547
23003,852,453,399,2012,66548
23004,1523,743,780,2012,66549
23005,512,261,251,2012,66550
23006,509,273,236,2012,66552
23007,816,423,393,2012,66554
23008,1460,728,732,2012,66603
23009,22450,10824,11626,2012,66604
23010,20786,10271,10515,2012,66605
23011,11381,5162,6219,2012,66606
23012,10961,5268,5693,2012,66607
23013,5597,2767,2830,2012,66608
23014,7362,3573,3789,2012,66609
23015,9118,4496,4622,2012,66610
23016,9204,4079,5125,2012,66611
23017,2689,1519,1170,2012,66612
23018,31569,15008,16561,2012,66614
23019,2818,1166,1652,2012,66615
23020,6024,3011,3013,2012,66616
23021,8577,4313,4264,2012,66617
23022,9626,4947,4679,2012,66618
23023,2959,1384,1575,2012,66619
23024,496,176,320,2012,66621
23025,187,183,4,2012,66622
23026,12231,6098,6133,2012,66701
23027,977,485,492,2012,66710
23028,722,366,356,2012,66711
23029,1884,908,976,2012,66712
23030,6231,3116,3115,2012,66713
23031,145,92,53,2012,66714
23032,610,290,320,2012,66716
23033,510,266,244,2012,66717
23034,11431,5541,5890,2012,66720
23035,1109,608,501,2012,66724
23036,5518,2683,2835,2012,66725
23037,0,0,0,2012,66728
23038,314,169,145,2012,66732
23039,2196,1110,1086,2012,66733
23040,225,116,109,2012,66734
23041,460,220,240,2012,66735
23042,3370,1607,1763,2012,66736
23043,407,215,192,2012,66738
23044,5384,2584,2800,2012,66739
23045,465,254,211,2012,66740
23046,119,66,53,2012,66741
23047,4086,2162,1924,2012,66743
23048,199,98,101,2012,66746
23049,2547,1223,1324,2012,66748
23050,7867,3772,4095,2012,66749
23051,1079,519,560,2012,66751
23052,1129,555,574,2012,66753
23053,547,283,264,2012,66754
23054,1054,541,513,2012,66755
23055,1128,511,617,2012,66756
23056,3510,1718,1792,2012,66757
23057,283,127,156,2012,66758
23058,39,12,27,2012,66760
23059,254,161,93,2012,66761
23060,24693,12414,12279,2012,66762
23061,3424,1664,1760,2012,66763
23062,565,255,310,2012,66767
23063,366,210,156,2012,66769
23064,1064,577,487,2012,66770
23065,1197,609,588,2012,66771
23066,360,180,180,2012,66772
23067,887,445,442,2012,66773
23068,86,54,32,2012,66775
23069,1329,691,638,2012,66776
23070,793,401,392,2012,66777
23071,135,68,67,2012,66778
23072,801,351,450,2012,66779
23073,878,420,458,2012,66780
23074,1387,691,696,2012,66781
23075,250,122,128,2012,66782
23076,2088,991,1097,2012,66783
23077,29345,14280,15065,2012,66801
23078,121,63,58,2012,66830
23079,624,279,345,2012,66833
23080,989,521,468,2012,66834
23081,1232,619,613,2012,66835
23082,264,136,128,2012,66838
23083,3633,1786,1847,2012,66839
23084,655,325,330,2012,66840
23085,265,130,135,2012,66842
23086,73,52,21,2012,66843
23087,1397,683,714,2012,66845
23088,3207,1588,1619,2012,66846
23089,571,305,266,2012,66849
23090,180,98,82,2012,66850
23091,542,261,281,2012,66851
23092,633,313,320,2012,66852
23093,515,283,232,2012,66853
23094,859,391,468,2012,66854
23095,1683,847,836,2012,66856
23096,1146,589,557,2012,66857
23097,462,269,193,2012,66858
23098,185,98,87,2012,66859
23099,1209,567,642,2012,66860
23100,3126,1513,1613,2012,66861
23101,61,22,39,2012,66862
23102,162,67,95,2012,66863
23103,452,237,215,2012,66864
23104,1110,560,550,2012,66865
23105,1874,911,963,2012,66866
23106,681,377,304,2012,66868
23107,735,366,369,2012,66869
23108,112,62,50,2012,66870
23109,1309,651,658,2012,66871
23110,1195,519,676,2012,66872
23111,267,144,123,2012,66873
23112,6585,3144,3441,2012,66901
23113,281,133,148,2012,66930
23114,106,60,46,2012,66932
23115,236,114,122,2012,66933
23116,2311,1074,1237,2012,66935
23117,335,142,193,2012,66936
23118,757,386,371,2012,66937
23119,1041,530,511,2012,66938
23120,606,291,315,2012,66939
23121,378,220,158,2012,66940
23122,219,105,114,2012,66941
23123,269,153,116,2012,66942
23124,497,251,246,2012,66943
23125,157,80,77,2012,66944
23126,1132,581,551,2012,66945
23127,156,94,62,2012,66946
23128,576,278,298,2012,66948
23129,604,330,274,2012,66949
23130,778,401,377,2012,66951
23131,552,277,275,2012,66952
23132,722,383,339,2012,66953
23133,97,53,44,2012,66955
23134,1172,591,581,2012,66956
23135,273,132,141,2012,66958
23136,237,123,114,2012,66959
23137,178,97,81,2012,66960
23138,274,150,124,2012,66962
23139,161,77,84,2012,66963
23140,199,112,87,2012,66964
23141,566,286,280,2012,66966
23142,2025,995,1030,2012,66967
23143,1663,792,871,2012,66968
23144,203,100,103,2012,66970
23145,1887,964,923,2012,67001
23146,13791,6576,7215,2012,67002
23147,2693,1333,1360,2012,67003
23148,875,428,447,2012,67004
23149,16415,7919,8496,2012,67005
23150,442,198,244,2012,67008
23151,889,396,493,2012,67009
23152,13458,6280,7178,2012,67010
23153,30,9,21,2012,67012
23154,2828,1460,1368,2012,67013
23155,451,235,216,2012,67016
23156,2533,1307,1226,2012,67017
23157,70,35,35,2012,67018
23158,935,477,458,2012,67019
23159,1576,799,777,2012,67020
23160,134,58,76,2012,67021
23161,1669,842,827,2012,67022
23162,153,90,63,2012,67023
23163,692,333,359,2012,67024
23164,3894,2046,1848,2012,67025
23165,4955,2577,2378,2012,67026
23166,264,142,122,2012,67028
23167,875,447,428,2012,67029
23168,2614,1336,1278,2012,67030
23169,2532,1193,1339,2012,67031
23170,1014,526,488,2012,67035
23171,125,59,66,2012,67036
23172,26631,13327,13304,2012,67037
23173,626,300,326,2012,67038
23174,3823,1913,1910,2012,67039
23175,239,130,109,2012,67041
23176,17970,9620,8350,2012,67042
23177,3608,1699,1909,2012,67045
23178,872,449,423,2012,67047
23179,20,13,7,2012,67049
23180,1949,894,1055,2012,67050
23181,481,224,257,2012,67051
23182,8062,4148,3914,2012,67052
23183,539,238,301,2012,67053
23184,1149,577,572,2012,67054
23185,122,7,115,2012,67055
23186,2763,1312,1451,2012,67056
23187,292,151,141,2012,67057
23188,2117,1113,1004,2012,67058
23189,988,488,500,2012,67059
23190,13920,6383,7537,2012,67060
23191,187,113,74,2012,67061
23192,4100,1999,2101,2012,67062
23193,3926,2002,1924,2012,67063
23194,188,100,88,2012,67065
23195,317,175,142,2012,67066
23196,1701,811,890,2012,67067
23197,4328,2142,2186,2012,67068
23198,1172,574,598,2012,67070
23199,91,46,45,2012,67071
23200,241,137,104,2012,67072
23201,197,99,98,2012,67073
23202,2133,1189,944,2012,67074
23203,3174,1589,1585,2012,67101
23204,408,203,205,2012,67103
23205,2409,1188,1221,2012,67104
23206,282,144,138,2012,67105
23207,326,141,185,2012,67106
23208,2976,1447,1529,2012,67107
23209,1626,804,822,2012,67108
23210,436,203,233,2012,67109
23211,7853,4171,3682,2012,67110
23212,300,171,129,2012,67111
23213,243,143,100,2012,67112
23214,22013,10773,11240,2012,67114
23215,1774,801,973,2012,67117
23216,867,401,466,2012,67118
23217,1508,676,832,2012,67119
23218,1488,738,750,2012,67120
23219,133,71,62,2012,67122
23220,759,372,387,2012,67123
23221,8358,4190,4168,2012,67124
23222,846,392,454,2012,67127
23223,167,83,84,2012,67131
23224,447,212,235,2012,67132
23225,6420,3137,3283,2012,67133
23226,388,162,226,2012,67134
23227,3514,1710,1804,2012,67135
23228,594,309,285,2012,67137
23229,325,160,165,2012,67138
23230,636,323,313,2012,67140
23231,451,203,248,2012,67142
23232,60,30,30,2012,67143
23233,2607,1350,1257,2012,67144
23234,2293,1161,1132,2012,67146
23235,9259,4641,4618,2012,67147
23236,973,456,517,2012,67149
23237,20,8,12,2012,67150
23238,665,275,390,2012,67151
23239,9426,4807,4619,2012,67152
23240,1401,750,651,2012,67154
23241,172,91,81,2012,67155
23242,15150,7818,7332,2012,67156
23243,57,38,19,2012,67159
23244,1241,863,378,2012,67202
23245,31327,15463,15864,2012,67203
23246,20960,10587,10373,2012,67204
23247,16335,8166,8169,2012,67205
23248,15587,7603,7984,2012,67206
23249,27410,13788,13622,2012,67207
23250,19102,9346,9756,2012,67208
23251,13576,6790,6786,2012,67209
23252,9562,4981,4581,2012,67210
23253,21012,10496,10516,2012,67211
23254,44772,22081,22691,2012,67212
23255,22829,10640,12189,2012,67213
23256,15451,7338,8113,2012,67214
23257,6065,2877,3188,2012,67215
23258,24150,11937,12213,2012,67216
23259,28341,14196,14145,2012,67217
23260,22264,10620,11644,2012,67218
23261,11741,5854,5887,2012,67219
23262,14313,6978,7335,2012,67220
23263,572,285,287,2012,67223
23264,17945,8713,9232,2012,67226
23265,197,87,110,2012,67227
23266,1450,785,665,2012,67228
23267,10373,5198,5175,2012,67230
23268,417,213,204,2012,67232
23269,11554,5662,5892,2012,67235
23270,0,0,0,2012,67260
23271,13579,6560,7019,2012,67301
23272,1575,712,863,2012,67330
23273,115,62,53,2012,67332
23274,3087,1336,1751,2012,67333
23275,79,38,41,2012,67334
23276,3534,1916,1618,2012,67335
23277,1815,835,980,2012,67336
23278,12777,6310,6467,2012,67337
23279,311,165,146,2012,67340
23280,304,129,175,2012,67341
23281,897,516,381,2012,67342
23282,1090,584,506,2012,67344
23283,191,90,101,2012,67345
23284,334,157,177,2012,67346
23285,443,237,206,2012,67347
23286,1080,575,505,2012,67349
23287,531,282,249,2012,67351
23288,648,341,307,2012,67352
23289,490,225,265,2012,67353
23290,777,361,416,2012,67354
23291,213,94,119,2012,67355
23292,3129,1649,1480,2012,67356
23293,12769,6375,6394,2012,67357
23294,441,193,248,2012,67360
23295,2078,1123,955,2012,67361
23296,0,0,0,2012,67363
23297,413,232,181,2012,67364
23298,51209,25393,25816,2012,67401
23299,10283,5103,5180,2012,67410
23300,1529,705,824,2012,67416
23301,174,91,83,2012,67417
23302,176,80,96,2012,67418
23303,4738,2403,2335,2012,67420
23304,1331,705,626,2012,67422
23305,305,177,128,2012,67423
23306,784,396,388,2012,67425
23307,389,186,203,2012,67427
23308,1730,901,829,2012,67428
23309,675,361,314,2012,67430
23310,2512,1303,1209,2012,67431
23311,6021,2968,3053,2012,67432
23312,648,359,289,2012,67436
23313,1273,630,643,2012,67437
23314,316,140,176,2012,67438
23315,3843,2334,1509,2012,67439
23316,985,435,550,2012,67441
23317,191,94,97,2012,67442
23318,1948,988,960,2012,67443
23319,660,331,329,2012,67444
23320,573,273,300,2012,67445
23321,480,230,250,2012,67446
23322,340,191,149,2012,67447
23323,951,452,499,2012,67448
23324,3290,1608,1682,2012,67449
23325,518,267,251,2012,67450
23326,983,485,498,2012,67451
23327,222,118,104,2012,67452
23328,496,220,276,2012,67454
23329,1986,963,1023,2012,67455
23330,4698,2305,2393,2012,67456
23331,735,355,380,2012,67457
23332,231,135,96,2012,67458
23333,178,110,68,2012,67459
23334,15016,7342,7674,2012,67460
23335,984,484,500,2012,67464
23336,873,440,433,2012,67466
23337,2775,1422,1353,2012,67467
23338,240,123,117,2012,67468
23339,492,244,248,2012,67470
23340,1699,827,872,2012,67473
23341,178,69,109,2012,67474
23342,276,157,119,2012,67475
23343,72,26,46,2012,67478
23344,1859,904,955,2012,67480
23345,585,301,284,2012,67481
23346,98,54,44,2012,67482
23347,401,215,186,2012,67483
23348,1003,503,500,2012,67484
23349,389,200,189,2012,67485
23350,1565,737,828,2012,67487
23351,986,457,529,2012,67490
23352,478,247,231,2012,67491
23353,175,95,80,2012,67492
23354,26436,13867,12569,2012,67501
23355,24145,11416,12729,2012,67502
23356,2499,1200,1299,2012,67505
23357,209,88,121,2012,67510
23358,348,162,186,2012,67511
23359,210,148,62,2012,67512
23360,87,38,49,2012,67513
23361,651,302,349,2012,67514
23362,67,34,33,2012,67515
23363,618,283,335,2012,67516
23364,14,10,4,2012,67518
23365,166,85,81,2012,67519
23366,338,169,169,2012,67520
23367,114,58,56,2012,67521
23368,2027,1057,970,2012,67522
23369,460,241,219,2012,67523
23370,630,335,295,2012,67524
23371,1063,521,542,2012,67525
23372,2826,1463,1363,2012,67526
23373,348,178,170,2012,67529
23374,19558,9572,9986,2012,67530
23375,1905,1031,874,2012,67543
23376,3216,1544,1672,2012,67544
23377,251,127,124,2012,67545
23378,2582,1313,1269,2012,67546
23379,1748,898,850,2012,67547
23380,1548,764,784,2012,67548
23381,5807,3394,2413,2012,67550
23382,766,417,349,2012,67552
23383,98,51,47,2012,67553
23384,4418,1968,2450,2012,67554
23385,427,228,199,2012,67556
23386,631,285,346,2012,67557
23387,39,26,13,2012,67559
23388,1636,814,822,2012,67560
23389,1712,840,872,2012,67561
23390,416,204,212,2012,67563
23391,219,118,101,2012,67564
23392,341,200,141,2012,67565
23393,858,402,456,2012,67566
23394,579,301,278,2012,67567
23395,299,134,165,2012,67568
23396,1664,853,811,2012,67570
23397,406,188,218,2012,67572
23398,146,76,70,2012,67573
23399,346,173,173,2012,67574
23400,370,186,184,2012,67575
23401,1902,981,921,2012,67576
23402,1402,710,692,2012,67578
23403,3104,1553,1551,2012,67579
23404,369,199,170,2012,67581
23405,888,421,467,2012,67583
23406,280,131,149,2012,67584
23407,24001,11867,12134,2012,67601
23408,517,252,265,2012,67621
23409,681,394,287,2012,67622
23410,264,147,117,2012,67623
23411,242,160,82,2012,67625
23412,143,65,78,2012,67626
23413,65,33,32,2012,67628
23414,181,86,95,2012,67629
23415,225,127,98,2012,67631
23416,336,167,169,2012,67632
23417,224,114,110,2012,67634
23418,137,66,71,2012,67635
23419,2467,1212,1255,2012,67637
23420,298,131,167,2012,67638
23421,220,110,110,2012,67639
23422,572,306,266,2012,67640
23423,1771,836,935,2012,67642
23424,223,103,120,2012,67643
23425,195,113,82,2012,67644
23426,539,284,255,2012,67645
23427,632,280,352,2012,67646
23428,252,137,115,2012,67647
23429,693,354,339,2012,67648
23430,324,173,151,2012,67649
23431,249,135,114,2012,67650
23432,431,240,191,2012,67651
23433,233,131,102,2012,67653
23434,4371,2411,1960,2012,67654
23435,34,21,13,2012,67656
23436,386,196,190,2012,67657
23437,88,44,44,2012,67658
23438,96,42,54,2012,67659
23439,80,41,39,2012,67660
23440,3333,1635,1698,2012,67661
23441,2580,1240,1340,2012,67663
23442,362,196,166,2012,67664
23443,4994,2471,2523,2012,67665
23444,219,119,100,2012,67667
23445,1721,873,848,2012,67669
23446,1549,754,795,2012,67671
23447,2621,1315,1306,2012,67672
23448,159,72,87,2012,67673
23449,138,98,40,2012,67674
23450,278,152,126,2012,67675
23451,6568,3165,3403,2012,67701
23452,1593,755,838,2012,67730
23453,636,339,297,2012,67731
23454,449,223,226,2012,67732
23455,166,98,68,2012,67733
23456,194,89,105,2012,67734
23457,5627,2811,2816,2012,67735
23458,286,149,137,2012,67736
23459,583,312,271,2012,67737
23460,541,293,248,2012,67738
23461,313,165,148,2012,67739
23462,1748,879,869,2012,67740
23463,180,95,85,2012,67741
23464,69,31,38,2012,67743
23465,188,100,88,2012,67744
23466,382,196,186,2012,67745
23467,118,62,56,2012,67747
23468,2321,1132,1189,2012,67748
23469,2315,1177,1138,2012,67749
23470,232,119,113,2012,67751
23471,1371,698,673,2012,67752
23472,611,312,299,2012,67753
23473,2042,1020,1022,2012,67756
23474,457,220,237,2012,67757
23475,968,502,466,2012,67758
23476,238,114,124,2012,67761
23477,373,172,201,2012,67762
23478,422,227,195,2012,67764
23479,29968,15509,14459,2012,67801
23480,1303,629,674,2012,67831
23481,1251,527,724,2012,67834
23482,2984,1408,1576,2012,67835
23483,131,76,55,2012,67836
23484,915,437,478,2012,67837
23485,726,389,337,2012,67838
23486,1325,617,708,2012,67839
23487,57,35,22,2012,67840
23488,460,203,257,2012,67841
23489,491,261,230,2012,67842
23490,178,130,48,2012,67843
23491,738,371,367,2012,67844
23492,33588,17163,16425,2012,67846
23493,439,204,235,2012,67849
23494,334,169,165,2012,67850
23495,2526,1219,1307,2012,67851
23496,948,462,486,2012,67853
23497,1417,725,692,2012,67854
23498,2028,1022,1006,2012,67855
23499,93,67,26,2012,67857
23500,638,331,307,2012,67859
23501,3120,1629,1491,2012,67860
23502,1949,1065,884,2012,67861
23503,225,117,108,2012,67862
23504,310,190,120,2012,67863
23505,2239,1101,1138,2012,67864
23506,919,422,497,2012,67865
23507,1614,767,847,2012,67867
23508,120,26,94,2012,67868
23509,1448,806,642,2012,67869
23510,1869,953,916,2012,67870
23511,5029,2341,2688,2012,67871
23512,1085,545,540,2012,67876
23513,2023,1014,1009,2012,67877
23514,2432,1244,1188,2012,67878
23515,1234,594,640,2012,67879
23516,7923,3941,3982,2012,67880
23517,443,205,238,2012,67882
23518,22302,11388,10914,2012,67901
23519,2584,1290,1294,2012,67950
23520,4781,2320,2461,2012,67951
23521,826,434,392,2012,67952
23522,157,62,95,2012,67953
23523,580,346,234,2012,67954
23524,123,67,56,2012,68001
23525,2063,1040,1023,2012,68002
23526,4111,2131,1980,2012,68003
23527,862,441,421,2012,68004
23528,23949,11840,12109,2012,68005
23529,7123,3457,3666,2012,68007
23530,12364,6045,6319,2012,68008
23531,881,476,405,2012,68010
23532,316,171,145,2012,68014
23533,1134,597,537,2012,68015
23534,369,187,182,2012,68016
23535,1413,690,723,2012,68017
23536,531,268,263,2012,68018
23537,583,336,247,2012,68019
23538,905,458,447,2012,68020
23539,16134,7887,8247,2012,68022
23540,2049,1062,987,2012,68023
23541,30136,14577,15559,2012,68025
23542,10716,5084,5632,2012,68028
23543,894,483,411,2012,68029
23544,772,385,387,2012,68030
23545,1812,947,865,2012,68031
23546,450,267,183,2012,68033
23547,954,458,496,2012,68034
23548,500,252,248,2012,68036
23549,2314,1158,1156,2012,68037
23550,1232,606,626,2012,68038
23551,1220,610,610,2012,68039
23552,601,359,242,2012,68040
23553,939,484,455,2012,68041
23554,128,58,70,2012,68042
23555,647,310,337,2012,68044
23556,1954,919,1035,2012,68045
23557,26274,12954,13320,2012,68046
23558,1758,906,852,2012,68047
23559,12580,6186,6394,2012,68048
23560,859,496,363,2012,68050
23561,338,165,173,2012,68055
23562,1496,723,773,2012,68057
23563,286,134,152,2012,68058
23564,2965,1545,1420,2012,68059
23565,2324,1091,1233,2012,68061
23566,321,194,127,2012,68062
23567,286,151,135,2012,68063
23568,3224,1656,1568,2012,68064
23569,1228,631,597,2012,68065
23570,5106,2361,2745,2012,68066
23571,1241,621,620,2012,68067
23572,68,30,38,2012,68068
23573,2373,1236,1137,2012,68069
23574,947,509,438,2012,68070
23575,2006,944,1062,2012,68071
23576,19,11,8,2012,68072
23577,1959,1007,952,2012,68073
23578,5767,3463,2304,2012,68102
23579,35516,17012,18504,2012,68104
23580,24564,12357,12207,2012,68105
23581,19769,9357,10412,2012,68106
23582,28069,14502,13567,2012,68107
23583,14677,7765,6912,2012,68108
23584,8740,4682,4058,2012,68110
23585,22165,10587,11578,2012,68111
23586,11699,5880,5819,2012,68112
23587,1232,716,516,2012,68113
23588,17011,8123,8888,2012,68114
23589,25618,12666,12952,2012,68116
23590,8535,4209,4326,2012,68117
23591,9358,4478,4880,2012,68118
23592,10729,5553,5176,2012,68122
23593,26510,13093,13417,2012,68123
23594,15740,7810,7930,2012,68124
23595,21511,11005,10506,2012,68127
23596,17892,8902,8990,2012,68128
23597,17699,8877,8822,2012,68130
23598,13269,6615,6654,2012,68131
23599,14054,6657,7397,2012,68132
23600,9739,4815,4924,2012,68133
23601,30026,13383,16643,2012,68134
23602,26269,13197,13072,2012,68135
23603,13472,6787,6685,2012,68136
23604,24241,11801,12440,2012,68137
23605,11869,5935,5934,2012,68138
23606,3290,1517,1773,2012,68142
23607,24304,11917,12387,2012,68144
23608,10453,5367,5086,2012,68147
23609,6026,2860,3166,2012,68152
23610,22917,11322,11595,2012,68154
23611,4621,2366,2255,2012,68157
23612,26982,12637,14345,2012,68164
23613,1323,530,793,2012,68178
23614,1304,636,668,2012,68301
23615,250,123,127,2012,68303
23616,237,133,104,2012,68304
23617,4242,2057,2185,2012,68305
23618,618,339,279,2012,68307
23619,86,45,41,2012,68309
23620,14549,7068,7481,2012,68310
23621,1038,549,489,2012,68313
23622,375,191,184,2012,68314
23623,75,28,47,2012,68315
23624,350,191,159,2012,68316
23625,1499,737,762,2012,68317
23626,429,227,202,2012,68318
23627,650,326,324,2012,68319
23628,324,139,185,2012,68320
23629,296,169,127,2012,68321
23630,472,241,231,2012,68322
23631,183,93,90,2012,68323
23632,115,64,51,2012,68324
23633,162,69,93,2012,68325
23634,263,130,133,2012,68326
23635,335,150,185,2012,68327
23636,459,228,231,2012,68328
23637,642,308,334,2012,68329
23638,966,528,438,2012,68331
23639,109,48,61,2012,68332
23640,8413,4350,4063,2012,68333
23641,471,243,228,2012,68335
23642,377,186,191,2012,68336
23643,316,157,159,2012,68337
23644,346,129,217,2012,68338
23645,1276,633,643,2012,68339
23646,1067,543,524,2012,68340
23647,989,538,451,2012,68341
23648,583,301,282,2012,68342
23649,877,416,461,2012,68343
23650,516,240,276,2012,68344
23651,302,165,137,2012,68345
23652,412,245,167,2012,68346
23653,2361,1277,1084,2012,68347
23654,204,98,106,2012,68348
23655,1209,602,607,2012,68349
23656,232,109,123,2012,68350
23657,889,423,466,2012,68351
23658,5220,2640,2580,2012,68352
23659,711,337,374,2012,68354
23660,5019,2321,2698,2012,68355
23661,326,155,171,2012,68357
23662,1797,887,910,2012,68358
23663,1568,785,783,2012,68359
23664,452,250,202,2012,68360
23665,2592,1246,1346,2012,68361
23666,25,18,7,2012,68362
23667,74,40,34,2012,68364
23668,260,112,148,2012,68365
23669,1129,578,551,2012,68366
23670,490,270,220,2012,68367
23671,393,229,164,2012,68368
23672,2036,981,1055,2012,68370
23673,1435,632,803,2012,68371
23674,3052,1500,1552,2012,68372
23675,176,109,67,2012,68375
23676,1460,730,730,2012,68376
23677,498,256,242,2012,68377
23678,801,369,432,2012,68378
23679,40,18,22,2012,68379
23680,179,130,49,2012,68380
23681,277,118,159,2012,68381
23682,50,25,25,2012,68382
23683,625,310,315,2012,68401
23684,1242,650,592,2012,68402
23685,207,99,108,2012,68403
23686,1099,556,543,2012,68404
23687,3448,1872,1576,2012,68405
23688,548,267,281,2012,68406
23689,741,381,360,2012,68407
23690,803,390,413,2012,68409
23691,8692,4298,4394,2012,68410
23692,493,229,264,2012,68413
23693,223,111,112,2012,68414
23694,698,366,332,2012,68415
23695,206,105,101,2012,68416
23696,324,183,141,2012,68417
23697,1065,538,527,2012,68418
23698,290,166,124,2012,68419
23699,1241,599,642,2012,68420
23700,1129,597,532,2012,68421
23701,455,207,248,2012,68422
23702,855,462,393,2012,68423
23703,629,299,330,2012,68424
23704,1406,712,694,2012,68428
23705,1553,754,799,2012,68430
23706,303,176,127,2012,68431
23707,346,171,175,2012,68433
23708,8379,4210,4169,2012,68434
23709,540,276,264,2012,68436
23710,243,125,118,2012,68437
23711,174,84,90,2012,68438
23712,589,256,333,2012,68439
23713,118,57,61,2012,68440
23714,329,163,166,2012,68441
23715,438,238,200,2012,68442
23716,1165,525,640,2012,68443
23717,72,40,32,2012,68444
23718,105,47,58,2012,68445
23719,2601,1212,1389,2012,68446
23720,498,221,277,2012,68447
23721,338,177,161,2012,68448
23722,3159,2033,1126,2012,68450
23723,117,69,48,2012,68452
23724,416,205,211,2012,68453
23725,814,373,441,2012,68454
23726,486,271,215,2012,68455
23727,1096,537,559,2012,68456
23728,381,171,210,2012,68457
23729,164,90,74,2012,68458
23730,905,451,454,2012,68460
23731,374,196,178,2012,68461
23732,4017,2041,1976,2012,68462
23733,1490,801,689,2012,68463
23734,490,251,239,2012,68464
23735,2468,1223,1245,2012,68465
23736,1928,855,1073,2012,68466
23737,9302,4418,4884,2012,68467
23738,26268,13897,12371,2012,68502
23739,15014,7822,7192,2012,68503
23740,16374,7723,8651,2012,68504
23741,14815,7223,7592,2012,68505
23742,28036,13073,14963,2012,68506
23743,13777,7122,6655,2012,68507
23744,14386,7614,6772,2012,68508
23745,20740,9983,10757,2012,68510
23746,11542,5487,6055,2012,68512
23747,152,83,69,2012,68514
23748,38965,19291,19674,2012,68516
23749,666,409,257,2012,68517
23750,969,479,490,2012,68520
23751,32618,16639,15979,2012,68521
23752,12749,6647,6102,2012,68522
23753,1432,731,701,2012,68523
23754,6158,3249,2909,2012,68524
23755,4570,2214,2356,2012,68526
23756,905,458,447,2012,68527
23757,6625,3520,3105,2012,68528
23758,86,8,78,2012,68531
23759,639,337,302,2012,68532
23760,27646,13619,14027,2012,68601
23761,2886,1388,1498,2012,68620
23762,507,243,264,2012,68621
23763,271,147,124,2012,68622
23764,295,132,163,2012,68623
23765,1299,575,724,2012,68624
23766,684,421,263,2012,68626
23767,618,324,294,2012,68627
23768,901,490,411,2012,68628
23769,1307,677,630,2012,68629
23770,565,281,284,2012,68631
23771,3710,1808,1902,2012,68632
23772,1504,788,716,2012,68633
23773,347,185,162,2012,68634
23774,374,202,172,2012,68635
23775,973,450,523,2012,68636
23776,223,98,125,2012,68637
23777,1807,929,878,2012,68638
23778,1546,776,770,2012,68640
23779,1082,570,512,2012,68641
23780,1814,958,856,2012,68642
23781,915,482,433,2012,68643
23782,749,411,338,2012,68644
23783,467,210,257,2012,68647
23784,507,269,238,2012,68648
23785,1878,871,1007,2012,68649
23786,1445,721,724,2012,68651
23787,759,398,361,2012,68652
23788,1058,646,412,2012,68653
23789,464,232,232,2012,68654
23790,131,77,54,2012,68655
23791,679,363,316,2012,68658
23792,229,120,109,2012,68659
23793,1257,661,596,2012,68660
23794,7133,3614,3519,2012,68661
23795,1157,554,603,2012,68662
23796,515,267,248,2012,68663
23797,342,138,204,2012,68664
23798,909,433,476,2012,68665
23799,1767,875,892,2012,68666
23800,136,63,73,2012,68667
23801,417,219,198,2012,68669
23802,30266,14830,15436,2012,68701
23803,761,340,421,2012,68710
23804,236,147,89,2012,68711
23805,2070,975,1095,2012,68713
23806,1263,587,676,2012,68714
23807,1419,758,661,2012,68715
23808,819,402,417,2012,68716
23809,202,98,104,2012,68717
23810,1924,944,980,2012,68718
23811,122,68,54,2012,68719
23812,396,215,181,2012,68720
23813,577,278,299,2012,68722
23814,617,293,324,2012,68723
23815,131,68,63,2012,68724
23816,522,265,257,2012,68725
23817,840,405,435,2012,68726
23818,879,420,459,2012,68727
23819,273,145,128,2012,68728
23820,1968,960,1008,2012,68729
23821,1699,866,833,2012,68730
23822,2909,1495,1414,2012,68731
23823,222,109,113,2012,68732
23824,1257,637,620,2012,68733
23825,146,62,84,2012,68734
23826,1149,619,530,2012,68735
23827,670,319,351,2012,68736
23828,2753,1408,1345,2012,68739
23829,646,370,276,2012,68740
23830,707,363,344,2012,68741
23831,185,65,120,2012,68742
23832,681,327,354,2012,68743
23833,1796,925,871,2012,68745
23834,417,219,198,2012,68746
23835,132,57,75,2012,68747
23836,3573,1791,1782,2012,68748
23837,34,15,19,2012,68749
23838,101,51,50,2012,68751
23839,892,422,470,2012,68752
23840,53,33,20,2012,68753
23841,303,163,140,2012,68755
23842,2094,1031,1063,2012,68756
23843,754,399,355,2012,68757
23844,928,461,467,2012,68758
23845,305,147,158,2012,68759
23846,1490,731,759,2012,68760
23847,503,239,264,2012,68761
23848,4818,2374,2444,2012,68763
23849,629,295,334,2012,68764
23850,1379,741,638,2012,68765
23851,395,194,201,2012,68766
23852,3374,1744,1630,2012,68767
23853,666,327,339,2012,68768
23854,1575,782,793,2012,68769
23855,1697,839,858,2012,68770
23856,1558,768,790,2012,68771
23857,204,99,105,2012,68773
23858,325,197,128,2012,68774
23859,15185,7482,7703,2012,68776
23860,648,312,336,2012,68777
23861,546,257,289,2012,68778
23862,2715,1345,1370,2012,68779
23863,1089,556,533,2012,68780
23864,1345,669,676,2012,68781
23865,1027,544,483,2012,68783
23866,2218,1189,1029,2012,68784
23867,166,92,74,2012,68785
23868,998,477,521,2012,68786
23869,6565,3214,3351,2012,68787
23870,5112,2564,2548,2012,68788
23871,144,76,68,2012,68789
23872,915,447,468,2012,68790
23873,1722,809,913,2012,68791
23874,334,157,177,2012,68792
23875,31357,16115,15242,2012,68801
23876,21552,10168,11384,2012,68803
23877,1108,597,511,2012,68810
23878,739,375,364,2012,68812
23879,518,267,251,2012,68813
23880,1051,516,535,2012,68814
23881,626,293,333,2012,68815
23882,179,109,70,2012,68816
23883,357,156,201,2012,68817
23884,5322,2660,2662,2012,68818
23885,411,217,194,2012,68820
23886,75,46,29,2012,68821
23887,4451,2082,2369,2012,68822
23888,2434,1209,1225,2012,68823
23889,1297,646,651,2012,68824
23890,1230,582,648,2012,68825
23891,3948,1954,1994,2012,68826
23892,668,314,354,2012,68827
23893,199,90,109,2012,68828
23894,823,446,377,2012,68831
23895,1939,965,974,2012,68832
23896,422,208,214,2012,68833
23897,315,144,171,2012,68834
23898,589,296,293,2012,68835
23899,1809,937,872,2012,68836
23900,47,17,30,2012,68837
23901,270,150,120,2012,68838
23902,2651,1355,1296,2012,68840
23903,633,318,315,2012,68841
23904,769,417,352,2012,68842
23905,742,358,384,2012,68843
23906,240,130,110,2012,68844
23907,20575,10258,10317,2012,68845
23908,297,137,160,2012,68846
23909,16197,8005,8192,2012,68847
23910,317,89,228,2012,68849
23911,12231,6296,5935,2012,68850
23912,830,444,386,2012,68852
23913,1397,676,721,2012,68853
23914,894,424,470,2012,68854
23915,416,222,194,2012,68855
23916,586,288,298,2012,68856
23917,244,117,127,2012,68858
23918,529,250,279,2012,68859
23919,246,122,124,2012,68860
23920,140,99,41,2012,68861
23921,3034,1539,1495,2012,68862
23922,1205,575,630,2012,68863
23923,1231,583,648,2012,68864
23924,905,428,477,2012,68865
23925,871,398,473,2012,68866
23926,2143,1028,1115,2012,68869
23927,353,183,170,2012,68870
23928,271,125,146,2012,68871
23929,935,456,479,2012,68872
23930,3027,1482,1545,2012,68873
23931,1096,591,505,2012,68874
23932,576,286,290,2012,68875
23933,1480,709,771,2012,68876
23934,439,221,218,2012,68878
23935,381,223,158,2012,68879
23936,105,47,58,2012,68881
23937,504,272,232,2012,68882
23938,2274,1170,1104,2012,68883
23939,26291,13028,13263,2012,68901
23940,1367,688,679,2012,68920
23941,1303,632,671,2012,68922
23942,108,50,58,2012,68923
23943,1150,566,584,2012,68924
23944,468,243,225,2012,68925
23945,793,332,461,2012,68926
23946,1205,617,588,2012,68927
23947,530,273,257,2012,68928
23948,244,102,142,2012,68929
23949,1423,618,805,2012,68930
23950,389,190,199,2012,68932
23951,935,487,448,2012,68933
23952,98,57,41,2012,68934
23953,799,403,396,2012,68935
23954,100,63,37,2012,68936
23955,1921,937,984,2012,68937
23956,446,232,214,2012,68938
23957,1339,683,656,2012,68939
23958,509,273,236,2012,68940
23959,915,402,513,2012,68941
23960,466,235,231,2012,68942
23961,214,105,109,2012,68943
23962,1079,543,536,2012,68944
23963,437,210,227,2012,68945
23964,131,76,55,2012,68946
23965,633,328,305,2012,68947
23966,250,124,126,2012,68948
23967,6496,3124,3372,2012,68949
23968,305,171,134,2012,68950
23969,92,50,42,2012,68952
23970,142,89,53,2012,68954
23971,1968,1005,963,2012,68955
23972,1323,713,610,2012,68956
23973,644,326,318,2012,68957
23974,660,361,299,2012,68958
23975,3652,1744,1908,2012,68959
23976,119,63,56,2012,68960
23977,875,379,496,2012,68961
23978,90,54,36,2012,68964
23979,779,375,404,2012,68966
23980,1286,658,628,2012,68967
23981,26,14,12,2012,68969
23982,1384,677,707,2012,68970
23983,427,232,195,2012,68971
23984,202,100,102,2012,68972
23985,431,221,210,2012,68973
23986,190,105,85,2012,68974
23987,88,47,41,2012,68975
23988,258,127,131,2012,68976
23989,335,167,168,2012,68977
23990,2287,1078,1209,2012,68978
23991,2211,1103,1108,2012,68979
23992,444,230,214,2012,68980
23993,245,115,130,2012,68981
23994,661,346,315,2012,68982
23995,9177,4574,4603,2012,69001
23996,403,178,225,2012,69020
23997,1384,661,723,2012,69021
23998,1647,834,813,2012,69022
23999,339,186,153,2012,69023
24000,1299,638,661,2012,69024
24001,1138,555,583,2012,69025
24002,173,83,90,2012,69026
24003,137,80,57,2012,69027
24004,866,431,435,2012,69028
24005,341,157,184,2012,69029
24006,379,207,172,2012,69030
24007,455,224,231,2012,69032
24008,2513,1189,1324,2012,69033
24009,1117,520,597,2012,69034
24010,32,18,14,2012,69036
24011,50,26,24,2012,69037
24012,512,272,240,2012,69038
24013,88,48,40,2012,69039
24014,642,351,291,2012,69040
24015,62,30,32,2012,69041
24016,33,14,19,2012,69042
24017,483,252,231,2012,69043
24018,837,419,418,2012,69044
24019,1265,648,617,2012,69045
24020,154,79,75,2012,69046
24021,29848,14709,15139,2012,69101
24022,907,501,406,2012,69120
24023,449,235,214,2012,69121
24024,665,370,295,2012,69122
24025,925,389,536,2012,69123
24026,444,245,199,2012,69125
24027,944,485,459,2012,69127
24028,360,179,181,2012,69128
24029,1334,633,701,2012,69129
24030,5443,2652,2791,2012,69130
24031,477,245,232,2012,69131
24032,195,85,110,2012,69132
24033,440,231,209,2012,69133
24034,273,150,123,2012,69134
24035,73,25,48,2012,69135
24036,4199,2169,2030,2012,69138
24037,1918,970,948,2012,69140
24038,295,157,138,2012,69141
24039,124,66,58,2012,69142
24040,1311,664,647,2012,69143
24041,185,85,100,2012,69144
24042,3116,1607,1509,2012,69145
24043,268,151,117,2012,69146
24044,676,362,314,2012,69147
24045,215,102,113,2012,69148
24046,671,375,296,2012,69149
24047,526,270,256,2012,69150
24048,808,416,392,2012,69151
24049,799,433,366,2012,69152
24050,5557,2727,2830,2012,69153
24051,1331,693,638,2012,69154
24052,1053,561,492,2012,69155
24053,676,358,318,2012,69156
24054,29,10,19,2012,69157
24055,57,18,39,2012,69161
24056,8017,3911,4106,2012,69162
24057,842,376,466,2012,69163
24058,1863,884,979,2012,69165
24059,768,368,400,2012,69166
24060,249,134,115,2012,69167
24061,187,96,91,2012,69168
24062,679,380,299,2012,69169
24063,376,178,198,2012,69170
24064,38,19,19,2012,69171
24065,3877,2025,1852,2012,69201
24066,2447,1170,1277,2012,69210
24067,315,170,145,2012,69211
24068,374,211,163,2012,69212
24069,247,155,92,2012,69214
24070,209,114,95,2012,69216
24071,525,255,270,2012,69217
24072,134,66,68,2012,69218
24073,131,50,81,2012,69219
24074,42,25,17,2012,69220
24075,169,96,73,2012,69221
24076,10154,4978,5176,2012,69301
24077,40,17,23,2012,69331
24078,252,129,123,2012,69333
24079,2314,1204,1110,2012,69334
24080,18,11,7,2012,69335
24081,2560,1288,1272,2012,69336
24082,7528,3706,3822,2012,69337
24083,1384,646,738,2012,69339
24084,185,72,113,2012,69340
24085,10835,5329,5506,2012,69341
24086,2480,1145,1335,2012,69343
24087,510,246,264,2012,69345
24088,491,243,248,2012,69346
24089,1227,620,607,2012,69347
24090,1512,747,765,2012,69348
24091,334,167,167,2012,69350
24092,113,53,60,2012,69351
24093,772,385,387,2012,69352
24094,10,3,7,2012,69353
24095,126,66,60,2012,69354
24096,136,66,70,2012,69355
24097,2028,981,1047,2012,69356
24098,3748,1751,1997,2012,69357
24099,1616,745,871,2012,69358
24100,1438,664,774,2012,69360
24101,17910,8532,9378,2012,69361
24102,31,22,9,2012,69365
24103,299,163,136,2012,69366
24104,204,83,121,2012,69367
24105,38019,18164,19855,2012,70001
24106,18657,9259,9398,2012,70002
24107,39449,19363,20086,2012,70003
24108,24552,12327,12225,2012,70005
24109,16355,8121,8234,2012,70006
24110,4281,2207,2074,2012,70030
24111,1239,628,611,2012,70031
24112,3687,1946,1741,2012,70032
24113,1150,571,579,2012,70036
24114,16093,7964,8129,2012,70037
24115,771,399,372,2012,70038
24116,2202,1017,1185,2012,70039
24117,1677,846,831,2012,70040
24118,1843,899,944,2012,70041
24119,16663,8658,8005,2012,70043
24120,13175,6408,6767,2012,70047
24121,2455,1089,1366,2012,70049
24122,18,18,0,2012,70050
24123,1881,878,1003,2012,70051
24124,3712,1815,1897,2012,70052
24125,16554,8622,7932,2012,70053
24126,38903,18867,20036,2012,70056
24127,4593,2456,2137,2012,70057
24128,39856,19072,20784,2012,70058
24129,17242,8480,8762,2012,70062
24130,50957,24713,26244,2012,70065
24131,3094,1586,1508,2012,70067
24132,34508,16815,17693,2012,70068
24133,12567,5878,6689,2012,70070
24134,3567,1682,1885,2012,70071
24135,56307,26872,29435,2012,70072
24136,4196,2191,2005,2012,70075
24137,697,378,319,2012,70076
24138,3110,1655,1455,2012,70079
24139,1232,640,592,2012,70080
24140,84,37,47,2012,70082
24141,2445,1178,1267,2012,70083
24142,7262,3805,3457,2012,70084
24143,4174,2016,2158,2012,70085
24144,2505,1049,1456,2012,70086
24145,8861,4163,4698,2012,70087
24146,7716,3802,3914,2012,70090
24147,289,176,113,2012,70091
24148,7227,3334,3893,2012,70092
24149,32218,15245,16973,2012,70094
24150,3452,1712,1740,2012,70112
24151,6988,3707,3281,2012,70113
24152,24794,11532,13262,2012,70114
24153,34096,16626,17470,2012,70115
24154,11644,6020,5624,2012,70116
24155,20705,10519,10186,2012,70117
24156,33797,15605,18192,2012,70118
24157,35187,17975,17212,2012,70119
24158,11945,6027,5918,2012,70121
24159,29038,13660,15378,2012,70122
24160,26574,12331,14243,2012,70123
24161,16962,8504,8458,2012,70124
24162,15967,7425,8542,2012,70125
24163,21569,10185,11384,2012,70126
24164,20329,9311,11018,2012,70127
24165,16882,7760,9122,2012,70128
24166,8806,4425,4381,2012,70129
24167,12780,6618,6162,2012,70130
24168,28411,13332,15079,2012,70131
24169,0,0,0,2012,70139
24170,0,0,0,2012,70163
24171,43984,21728,22256,2012,70301
24172,5933,2680,3253,2012,70339
24173,183,58,125,2012,70340
24174,4004,1773,2231,2012,70341
24175,4930,2468,2462,2012,70342
24176,4536,2334,2202,2012,70343
24177,6551,3342,3209,2012,70344
24178,9385,4386,4999,2012,70345
24179,11131,4969,6162,2012,70346
24180,177,55,122,2012,70352
24181,1133,577,556,2012,70353
24182,4506,2010,2496,2012,70354
24183,1153,552,601,2012,70355
24184,2098,1074,1024,2012,70356
24185,3479,1741,1738,2012,70357
24186,874,406,468,2012,70358
24187,7781,3585,4196,2012,70359
24188,27234,13210,14024,2012,70360
24189,27779,13912,13867,2012,70363
24190,30007,15167,14840,2012,70364
24191,2655,1333,1322,2012,70372
24192,6838,3359,3479,2012,70373
24193,6657,3463,3194,2012,70374
24194,137,39,98,2012,70375
24195,4619,2436,2183,2012,70377
24196,22044,11192,10852,2012,70380
24197,7730,4066,3664,2012,70390
24198,301,166,135,2012,70391
24199,8297,3855,4442,2012,70392
24200,479,277,202,2012,70393
24201,14540,6938,7602,2012,70394
24202,4607,2426,2181,2012,70395
24203,1301,510,791,2012,70397
24204,21553,10886,10667,2012,70401
24205,799,226,573,2012,70402
24206,26102,12323,13779,2012,70403
24207,9229,4469,4760,2012,70420
24208,14037,7240,6797,2012,70422
24209,6663,3846,2817,2012,70426
24210,20125,9481,10644,2012,70427
24211,4692,2564,2128,2012,70431
24212,31693,15391,16302,2012,70433
24213,17136,8012,9124,2012,70435
24214,709,413,296,2012,70436
24215,7398,3671,3727,2012,70437
24216,17575,8552,9023,2012,70438
24217,5279,2461,2818,2012,70441
24218,341,198,143,2012,70442
24219,9573,4428,5145,2012,70443
24220,9037,4359,4678,2012,70444
24221,10232,4882,5350,2012,70445
24222,6101,3023,3078,2012,70446
24223,10625,5307,5318,2012,70447
24224,24692,12282,12410,2012,70448
24225,3853,2001,1852,2012,70449
24226,3152,1566,1586,2012,70450
24227,37,19,18,2012,70451
24228,11831,5707,6124,2012,70452
24229,1108,530,578,2012,70453
24230,25461,11925,13536,2012,70454
24231,1258,502,756,2012,70455
24232,3255,1839,1416,2012,70456
24233,35004,16764,18240,2012,70458
24234,22464,11092,11372,2012,70460
24235,28002,13294,14708,2012,70461
24236,5157,2552,2605,2012,70462
24237,53,26,27,2012,70463
24238,638,240,398,2012,70464
24239,563,215,348,2012,70465
24240,8737,4398,4339,2012,70466
24241,21186,10609,10577,2012,70471
24242,29462,14275,15187,2012,70501
24243,27577,13590,13987,2012,70503
24244,43584,21902,21682,2012,70506
24245,16013,7454,8559,2012,70507
24246,35141,16554,18587,2012,70508
24247,25473,12510,12963,2012,70510
24248,10858,5137,5721,2012,70512
24249,68,37,31,2012,70513
24250,2377,1204,1173,2012,70514
24251,4098,2261,1837,2012,70515
24252,1433,651,782,2012,70516
24253,25431,12665,12766,2012,70517
24254,12154,5875,6279,2012,70518
24255,151,116,35,2012,70519
24256,18760,9199,9561,2012,70520
24257,644,312,332,2012,70523
24258,367,169,198,2012,70524
24259,12930,6272,6658,2012,70525
24260,19008,9289,9719,2012,70526
24261,2520,1099,1421,2012,70528
24262,11449,5571,5878,2012,70529
24263,1210,523,687,2012,70531
24264,2515,1238,1277,2012,70532
24265,7046,3366,3680,2012,70533
24266,1043,540,503,2012,70534
24267,18459,9525,8934,2012,70535
24268,556,307,249,2012,70537
24269,15563,7674,7889,2012,70538
24270,335,169,166,2012,70541
24271,3738,1788,1950,2012,70542
24272,4108,2086,2022,2012,70543
24273,11837,5472,6365,2012,70544
24274,16722,8164,8558,2012,70546
24275,10315,5174,5141,2012,70548
24276,3907,1697,2210,2012,70549
24277,377,159,218,2012,70550
24278,1599,933,666,2012,70552
24279,5571,2536,3035,2012,70554
24280,7691,3846,3845,2012,70555
24281,292,156,136,2012,70556
24282,112,65,47,2012,70558
24283,2591,1358,1233,2012,70559
24284,42664,20921,21743,2012,70560
24285,18419,8901,9518,2012,70563
24286,40667,19055,21612,2012,70570
24287,35,24,11,2012,70575
24288,1329,912,417,2012,70576
24289,4699,2187,2512,2012,70577
24290,16086,7622,8464,2012,70578
24291,71,16,55,2012,70580
24292,617,333,284,2012,70581
24293,19741,9669,10072,2012,70582
24294,10756,5549,5207,2012,70583
24295,7175,3419,3756,2012,70584
24296,231,119,112,2012,70585
24297,20131,10061,10070,2012,70586
24298,3005,1492,1513,2012,70589
24299,5546,2775,2771,2012,70591
24300,19785,9607,10178,2012,70592
24301,31251,14450,16801,2012,70601
24302,34234,16257,17977,2012,70605
24303,25818,12778,13040,2012,70607
24304,18777,9019,9758,2012,70611
24305,12838,6874,5964,2012,70615
24306,1321,761,560,2012,70630
24307,876,447,429,2012,70631
24308,355,224,131,2012,70632
24309,7868,4136,3732,2012,70633
24310,24595,11864,12731,2012,70634
24311,718,258,460,2012,70637
24312,842,453,389,2012,70638
24313,540,275,265,2012,70639
24314,254,138,116,2012,70640
24315,280,157,123,2012,70643
24316,160,69,91,2012,70644
24317,1256,639,617,2012,70645
24318,755,416,339,2012,70646
24319,8645,4234,4411,2012,70647
24320,8229,4762,3467,2012,70648
24321,405,187,218,2012,70650
24322,119,53,66,2012,70651
24323,2082,1056,1026,2012,70652
24324,2892,1499,1393,2012,70653
24325,150,112,38,2012,70654
24326,3273,1687,1586,2012,70655
24327,4085,2113,1972,2012,70656
24328,4630,2363,2267,2012,70657
24329,1214,594,620,2012,70658
24330,1299,672,627,2012,70659
24331,3600,2321,1279,2012,70660
24332,2178,932,1246,2012,70661
24333,468,209,259,2012,70662
24334,28195,13526,14669,2012,70663
24335,11057,5492,5565,2012,70665
24336,6723,3363,3360,2012,70668
24337,10085,5183,4902,2012,70669
24338,21809,10763,11046,2012,70706
24339,3676,1730,1946,2012,70710
24340,5583,2748,2835,2012,70711
24341,4848,4519,329,2012,70712
24342,20166,9301,10865,2012,70714
24343,1334,682,652,2012,70715
24344,4203,2021,2182,2012,70719
24345,838,470,368,2012,70721
24346,5752,2814,2938,2012,70722
24347,1726,916,810,2012,70723
24348,2001,929,1072,2012,70725
24349,52037,25596,26441,2012,70726
24350,1128,541,587,2012,70729
24351,3452,1703,1749,2012,70730
24352,1030,515,515,2012,70732
24353,1732,870,862,2012,70733
24354,7249,3855,3394,2012,70734
24355,471,235,236,2012,70736
24356,38135,19171,18964,2012,70737
24357,13688,6309,7379,2012,70739
24358,1500,709,791,2012,70740
24359,200,132,68,2012,70743
24360,5356,2681,2675,2012,70744
24361,71,41,30,2012,70747
24362,6523,4186,2337,2012,70748
24363,1223,578,645,2012,70749
24364,1644,759,885,2012,70750
24365,975,520,455,2012,70752
24366,1353,575,778,2012,70753
24367,8766,4191,4575,2012,70754
24368,2291,1116,1175,2012,70755
24369,208,86,122,2012,70756
24370,4000,2010,1990,2012,70757
24371,1495,780,715,2012,70759
24372,6496,3042,3454,2012,70760
24373,1088,477,611,2012,70761
24374,782,464,318,2012,70762
24375,3383,1735,1648,2012,70763
24376,17335,8723,8612,2012,70764
24377,14831,7393,7438,2012,70767
24378,36601,18099,18502,2012,70769
24379,3356,1546,1810,2012,70770
24380,662,348,314,2012,70772
24381,206,130,76,2012,70773
24382,10673,5263,5410,2012,70774
24383,10358,5599,4759,2012,70775
24384,5502,3124,2378,2012,70776
24385,4791,2509,2282,2012,70777
24386,2101,1137,964,2012,70778
24387,1298,648,650,2012,70780
24388,269,144,125,2012,70782
24389,2804,1246,1558,2012,70783
24390,20462,10513,9949,2012,70785
24391,100,51,49,2012,70787
24392,4243,1977,2266,2012,70788
24393,571,268,303,2012,70789
24394,24659,11569,13090,2012,70791
24395,9,9,0,2012,70801
24396,26737,13350,13387,2012,70802
24397,936,649,287,2012,70803
24398,30119,13926,16193,2012,70805
24399,28253,12573,15680,2012,70806
24400,20626,9277,11349,2012,70807
24401,33223,16499,16724,2012,70808
24402,23909,11245,12664,2012,70809
24403,37064,17931,19133,2012,70810
24404,14342,6616,7726,2012,70811
24405,11328,5495,5833,2012,70812
24406,14478,7123,7355,2012,70814
24407,30382,14494,15888,2012,70815
24408,43002,20799,22203,2012,70816
24409,30598,14825,15773,2012,70817
24410,9397,4651,4746,2012,70818
24411,4891,2446,2445,2012,70819
24412,17050,9413,7637,2012,70820
24413,0,0,0,2012,70836
24414,4564,2243,2321,2012,71001
24415,1463,751,712,2012,71003
24416,546,325,221,2012,71004
24417,11939,6035,5904,2012,71006
24418,1333,685,648,2012,71007
24419,955,497,458,2012,71008
24420,1883,912,971,2012,71016
24421,1256,645,611,2012,71018
24422,8682,4171,4511,2012,71019
24423,597,274,323,2012,71021
24424,3581,1755,1826,2012,71023
24425,1441,739,702,2012,71024
24426,2148,929,1219,2012,71027
24427,1486,706,780,2012,71028
24428,147,79,68,2012,71029
24429,1082,436,646,2012,71030
24430,1006,458,548,2012,71031
24431,1981,923,1058,2012,71032
24432,3329,1720,1609,2012,71033
24433,413,208,205,2012,71034
24434,19165,9463,9702,2012,71037
24435,4547,2412,2135,2012,71038
24436,2205,1295,910,2012,71039
24437,8786,5173,3613,2012,71040
24438,672,334,338,2012,71043
24439,625,333,292,2012,71044
24440,788,421,367,2012,71045
24441,1831,1001,830,2012,71046
24442,12196,6489,5707,2012,71047
24443,128,72,56,2012,71048
24444,3119,1457,1662,2012,71049
24445,2538,1147,1391,2012,71051
24446,10224,4606,5618,2012,71052
24447,20654,10017,10637,2012,71055
24448,2410,1138,1272,2012,71060
24449,1513,782,731,2012,71061
24450,824,411,413,2012,71063
24451,3897,2080,1817,2012,71064
24452,1169,540,629,2012,71065
24453,3701,1742,1959,2012,71067
24454,3689,1627,2062,2012,71068
24455,598,294,304,2012,71069
24456,2048,1088,960,2012,71070
24457,2650,1313,1337,2012,71071
24458,1330,607,723,2012,71072
24459,2195,977,1218,2012,71073
24460,6540,3157,3383,2012,71075
24461,5608,2894,2714,2012,71078
24462,357,218,139,2012,71079
24463,4895,2240,2655,2012,71082
24464,8032,3901,4131,2012,71101
24465,7673,3740,3933,2012,71103
24466,15093,7445,7648,2012,71104
24467,22299,11093,11206,2012,71105
24468,34755,16472,18283,2012,71106
24469,34475,16486,17989,2012,71107
24470,18572,7639,10933,2012,71108
24471,22215,10363,11852,2012,71109
24472,2962,1733,1229,2012,71110
24473,38999,18919,20080,2012,71111
24474,31498,15077,16421,2012,71112
24475,14342,6346,7996,2012,71115
24476,26071,12213,13858,2012,71118
24477,12463,6135,6328,2012,71119
24478,13315,6329,6986,2012,71129
24479,19957,9292,10665,2012,71201
24480,30580,15077,15503,2012,71202
24481,36563,16928,19635,2012,71203
24482,96,16,80,2012,71209
24483,1175,521,654,2012,71219
24484,23325,10840,12485,2012,71220
24485,3569,1743,1826,2012,71222
24486,424,217,207,2012,71223
24487,7505,3492,4013,2012,71225
24488,1783,913,870,2012,71226
24489,3606,1795,1811,2012,71227
24490,1970,1251,719,2012,71229
24491,6596,3048,3548,2012,71232
24492,207,109,98,2012,71233
24493,3496,1662,1834,2012,71234
24494,3875,1949,1926,2012,71235
24495,1973,1213,760,2012,71237
24496,2767,1357,1410,2012,71238
24497,10034,4764,5270,2012,71241
24498,145,82,63,2012,71243
24499,4483,2086,2397,2012,71245
24500,1226,653,573,2012,71247
24501,21,21,0,2012,71250
24502,9168,4672,4496,2012,71251
24503,426,215,211,2012,71253
24504,6449,3413,3036,2012,71254
24505,972,556,416,2012,71256
24506,1790,937,853,2012,71259
24507,3861,1965,1896,2012,71260
24508,1423,686,737,2012,71261
24509,7853,3822,4031,2012,71263
24510,1136,530,606,2012,71264
24511,1678,737,941,2012,71266
24512,2358,1181,1177,2012,71268
24513,12671,6193,6478,2012,71269
24514,30816,14496,16320,2012,71270
24515,2175,1132,1043,2012,71272
24516,2553,1334,1219,2012,71275
24517,434,234,200,2012,71276
24518,1412,729,683,2012,71277
24519,70,26,44,2012,71279
24520,3246,1555,1691,2012,71280
24521,11153,5654,5499,2012,71282
24522,680,363,317,2012,71286
24523,33803,15992,17811,2012,71291
24524,19821,10190,9631,2012,71292
24525,14517,7279,7238,2012,71295
24526,22830,11012,11818,2012,71301
24527,15647,6844,8803,2012,71302
24528,20376,9768,10608,2012,71303
24529,73,31,42,2012,71316
24530,6888,3583,3305,2012,71322
24531,958,435,523,2012,71323
24532,1337,625,712,2012,71325
24533,1004,418,586,2012,71326
24534,5942,3610,2332,2012,71327
24535,7843,3877,3966,2012,71328
24536,919,478,441,2012,71331
24537,799,383,416,2012,71333
24538,10080,5023,5057,2012,71334
24539,1516,629,887,2012,71336
24540,160,88,72,2012,71339
24541,1802,1257,545,2012,71340
24542,3672,1745,1927,2012,71341
24543,8322,3986,4336,2012,71342
24544,7706,3874,3832,2012,71343
24545,113,61,52,2012,71345
24546,2697,1364,1333,2012,71346
24547,3409,1645,1764,2012,71350
24548,10838,5251,5587,2012,71351
24549,1589,778,811,2012,71353
24550,1739,856,883,2012,71354
24551,3419,1556,1863,2012,71355
24552,705,364,341,2012,71356
24553,2462,1223,1239,2012,71357
24554,849,398,451,2012,71358
24555,35443,17676,17767,2012,71360
24556,2024,913,1111,2012,71362
24557,1669,800,869,2012,71366
24558,1108,589,519,2012,71367
24559,1538,786,752,2012,71368
24560,2842,1264,1578,2012,71369
24561,1639,877,762,2012,71371
24562,7018,3660,3358,2012,71373
24563,1058,427,631,2012,71375
24564,51,8,43,2012,71377
24565,2560,1161,1399,2012,71378
24566,0,0,0,2012,71401
24567,4721,2237,2484,2012,71403
24568,651,366,285,2012,71404
24569,5799,2722,3077,2012,71405
24570,362,150,212,2012,71406
24571,667,327,340,2012,71407
24572,6736,3392,3344,2012,71409
24573,94,44,50,2012,71410
24574,2798,1390,1408,2012,71411
24575,186,72,114,2012,71414
24576,1020,497,523,2012,71416
24577,5153,2728,2425,2012,71417
24578,6512,3230,3282,2012,71418
24579,2531,1321,1210,2012,71419
24580,1589,843,746,2012,71422
24581,4632,2342,2290,2012,71423
24582,1601,778,823,2012,71424
24583,124,68,56,2012,71425
24584,210,111,99,2012,71426
24585,298,165,133,2012,71427
24586,2568,1316,1252,2012,71429
24587,2764,1229,1535,2012,71430
24588,1295,593,702,2012,71432
24589,3913,1889,2024,2012,71433
24590,3947,2216,1731,2012,71435
24591,1416,660,756,2012,71438
24592,1731,873,858,2012,71439
24593,523,223,300,2012,71441
24594,23082,11716,11366,2012,71446
24595,1249,639,610,2012,71447
24596,9446,4653,4793,2012,71449
24597,1329,699,630,2012,71450
24598,42,20,22,2012,71452
24599,2639,1214,1425,2012,71454
24600,256,161,95,2012,71455
24601,990,442,548,2012,71456
24602,27356,12683,14673,2012,71457
24603,11631,6554,5077,2012,71459
24604,2558,1174,1384,2012,71461
24605,1016,506,510,2012,71462
24606,10331,6369,3962,2012,71463
24607,2975,1382,1593,2012,71465
24608,555,241,314,2012,71466
24609,7241,4851,2390,2012,71467
24610,917,449,468,2012,71468
24611,3108,1588,1520,2012,71469
24612,183,83,100,2012,71472
24613,455,181,274,2012,71473
24614,692,338,354,2012,71474
24615,610,287,323,2012,71479
24616,1226,928,298,2012,71480
24617,11612,6184,5428,2012,71483
24618,2085,955,1130,2012,71485
24619,5909,2952,2957,2012,71486
24620,17252,8096,9156,2012,71601
24621,17430,8748,8682,2012,71602
24622,34785,16533,18252,2012,71603
24623,489,231,258,2012,71630
24624,666,316,350,2012,71631
24625,12601,5992,6609,2012,71635
24626,3754,2035,1719,2012,71638
24627,6106,2724,3382,2012,71639
24628,3437,1640,1797,2012,71640
24629,648,260,388,2012,71642
24630,1801,1017,784,2012,71643
24631,3903,3354,549,2012,71644
24632,6502,3319,3183,2012,71646
24633,2080,1053,1027,2012,71647
24634,172,69,103,2012,71651
24635,1087,548,539,2012,71652
24636,4929,2241,2688,2012,71653
24637,4760,2236,2524,2012,71654
24638,15542,7474,8068,2012,71655
24639,803,427,376,2012,71658
24640,78,21,57,2012,71659
24641,836,371,465,2012,71660
24642,324,170,154,2012,71661
24643,192,138,54,2012,71662
24644,725,271,454,2012,71663
24645,6252,3108,3144,2012,71665
24646,49,29,20,2012,71666
24647,7899,3976,3923,2012,71667
24648,1394,723,671,2012,71670
24649,8638,4195,4443,2012,71671
24650,868,482,386,2012,71674
24651,1941,927,1014,2012,71675
24652,679,312,367,2012,71676
24653,178,96,82,2012,71677
24654,19657,9183,10474,2012,71701
24655,11,10,1,2012,71711
24656,3047,1526,1521,2012,71720
24657,57,39,18,2012,71722
24658,363,128,235,2012,71724
24659,603,287,316,2012,71725
24660,1081,503,578,2012,71726
24661,32302,15760,16542,2012,71730
24662,2077,1125,952,2012,71740
24663,6296,3282,3014,2012,71742
24664,4222,2111,2111,2012,71743
24665,3436,1733,1703,2012,71744
24666,284,132,152,2012,71745
24667,1009,510,499,2012,71747
24668,2372,1138,1234,2012,71749
24669,1094,647,447,2012,71751
24670,972,471,501,2012,71752
24671,17172,8217,8955,2012,71753
24672,377,168,209,2012,71758
24673,733,333,400,2012,71759
24674,2335,1210,1125,2012,71762
24675,1370,675,695,2012,71763
24676,2128,992,1136,2012,71764
24677,2369,1001,1368,2012,71765
24678,640,331,309,2012,71766
24679,3205,1469,1736,2012,71770
24680,13,6,7,2012,71772
24681,17077,8330,8747,2012,71801
24682,198,93,105,2012,71820
24683,8890,4474,4416,2012,71822
24684,59,33,26,2012,71823
24685,697,319,378,2012,71825
24686,1267,586,681,2012,71826
24687,802,400,402,2012,71827
24688,10933,5199,5734,2012,71832
24689,2364,1119,1245,2012,71833
24690,1297,663,634,2012,71834
24691,1177,514,663,2012,71835
24692,2987,1318,1669,2012,71836
24693,5886,2894,2992,2012,71837
24694,901,375,526,2012,71838
24695,358,186,172,2012,71839
24696,781,383,398,2012,71841
24697,2393,1197,1196,2012,71842
24698,2358,1085,1273,2012,71845
24699,2901,1551,1350,2012,71846
24700,698,315,383,2012,71847
24701,2333,1101,1232,2012,71851
24702,9829,4814,5015,2012,71852
24703,309,147,162,2012,71853
24704,35908,17655,18253,2012,71854
24705,492,320,172,2012,71855
24706,5935,2838,3097,2012,71857
24707,1908,997,911,2012,71858
24708,518,243,275,2012,71859
24709,3113,1594,1519,2012,71860
24710,1443,643,800,2012,71861
24711,703,361,342,2012,71862
24712,228,93,135,2012,71865
24713,456,227,229,2012,71866
24714,29073,13764,15309,2012,71901
24715,14978,7202,7776,2012,71909
24716,44188,21110,23078,2012,71913
24717,3615,1874,1741,2012,71921
24718,211,106,105,2012,71922
24719,15406,7314,8092,2012,71923
24720,4827,2462,2365,2012,71929
24721,1518,877,641,2012,71933
24722,796,428,368,2012,71935
24723,2504,1211,1293,2012,71937
24724,1429,746,683,2012,71940
24725,2145,1120,1025,2012,71941
24726,4549,2247,2302,2012,71943
24727,867,389,478,2012,71944
24728,1619,765,854,2012,71945
24729,2467,1263,1204,2012,71949
24730,813,421,392,2012,71950
24731,126,49,77,2012,71952
24732,13920,6801,7119,2012,71953
24733,1599,868,731,2012,71956
24734,3078,1483,1595,2012,71957
24735,2469,1202,1267,2012,71958
24736,835,396,439,2012,71959
24737,1739,777,962,2012,71960
24738,1121,543,578,2012,71961
24739,829,449,380,2012,71962
24740,4092,2144,1948,2012,71964
24741,187,78,109,2012,71965
24742,4732,2396,2336,2012,71968
24743,303,177,126,2012,71969
24744,1062,513,549,2012,71970
24745,660,297,363,2012,71971
24746,302,156,146,2012,71972
24747,1374,751,623,2012,71973
24748,562,215,347,2012,71998
24749,404,40,364,2012,71999
24750,392,162,230,2012,72001
24751,13534,6688,6846,2012,72002
24752,1014,464,550,2012,72003
24753,1049,525,524,2012,72004
24754,96,42,54,2012,72005
24755,2587,1270,1317,2012,72006
24756,6174,2985,3189,2012,72007
24757,6582,3264,3318,2012,72010
24758,4349,2253,2096,2012,72011
24759,11750,5227,6523,2012,72012
24760,1903,1036,867,2012,72013
24761,104,42,62,2012,72014
24762,27398,13537,13861,2012,72015
24763,3203,1629,1574,2012,72016
24764,743,440,303,2012,72017
24765,23497,11825,11672,2012,72019
24766,4072,1998,2074,2012,72020
24767,3980,1889,2091,2012,72021
24768,14822,6765,8057,2012,72022
24769,34805,16849,17956,2012,72023
24770,3444,1711,1733,2012,72024
24771,668,392,276,2012,72025
24772,436,248,188,2012,72026
24773,1710,808,902,2012,72027
24774,1879,847,1032,2012,72029
24775,723,399,324,2012,72030
24776,7376,3793,3583,2012,72031
24777,31455,15137,16318,2012,72032
24778,44598,22217,22381,2012,72034
24779,1830,637,1193,2012,72035
24780,770,351,419,2012,72036
24781,46,23,23,2012,72037
24782,47,40,7,2012,72038
24783,2338,1148,1190,2012,72039
24784,3157,1506,1651,2012,72040
24785,1335,648,687,2012,72041
24786,5209,2476,2733,2012,72042
24787,900,457,443,2012,72044
24788,1442,629,813,2012,72045
24789,4767,2241,2526,2012,72046
24790,1027,532,495,2012,72047
24791,64,44,20,2012,72048
24792,637,373,264,2012,72051
24793,784,324,460,2012,72055
24794,1135,450,685,2012,72057
24795,15769,7952,7817,2012,72058
24796,37,25,12,2012,72059
24797,364,189,175,2012,72060
24798,166,77,89,2012,72061
24799,1704,838,866,2012,72063
24800,2523,1222,1301,2012,72064
24801,4350,2019,2331,2012,72065
24802,3153,1635,1518,2012,72067
24803,470,262,208,2012,72068
24804,2046,968,1078,2012,72069
24805,1957,987,970,2012,72070
24806,568,233,335,2012,72072
24807,884,452,432,2012,72073
24808,114,48,66,2012,72074
24809,39062,19334,19728,2012,72076
24810,773,432,341,2012,72079
24811,941,477,464,2012,72080
24812,8147,3956,4191,2012,72081
24813,1889,883,1006,2012,72082
24814,238,114,124,2012,72083
24815,1522,668,854,2012,72084
24816,310,168,142,2012,72085
24817,11111,5716,5395,2012,72086
24818,2305,1131,1174,2012,72087
24819,2683,1214,1469,2012,72088
24820,450,424,26,2012,72099
24821,3356,1583,1773,2012,72101
24822,2238,1116,1122,2012,72102
24823,13679,7087,6592,2012,72103
24824,22641,11693,10948,2012,72104
24825,5409,2723,2686,2012,72106
24826,352,174,178,2012,72107
24827,18,6,12,2012,72108
24828,12132,5984,6148,2012,72110
24829,1193,661,532,2012,72111
24830,11966,5937,6029,2012,72112
24831,20977,9518,11459,2012,72113
24832,12197,5852,6345,2012,72114
24833,21287,10148,11139,2012,72116
24834,12668,5813,6855,2012,72117
24835,24062,12640,11422,2012,72118
24836,82,82,0,2012,72119
24837,30617,14471,16146,2012,72120
24838,2463,1298,1165,2012,72121
24839,976,426,550,2012,72122
24840,398,198,200,2012,72123
24841,1285,636,649,2012,72125
24842,3402,1640,1762,2012,72126
24843,1852,878,974,2012,72127
24844,829,460,369,2012,72128
24845,1218,624,594,2012,72129
24846,365,201,164,2012,72130
24847,4657,2013,2644,2012,72131
24848,2894,1340,1554,2012,72132
24849,408,218,190,2012,72134
24850,2620,1353,1267,2012,72135
24851,1684,1018,666,2012,72136
24852,2077,1071,1006,2012,72137
24853,264,110,154,2012,72139
24854,225,130,95,2012,72140
24855,790,324,466,2012,72141
24856,2734,1439,1295,2012,72142
24857,35967,17869,18098,2012,72143
24858,0,0,0,2012,72149
24859,11772,5950,5822,2012,72150
24860,261,114,147,2012,72152
24861,2394,1179,1215,2012,72153
24862,389,182,207,2012,72156
24863,1254,630,624,2012,72157
24864,10710,5217,5493,2012,72160
24865,55,15,40,2012,72165
24866,297,129,168,2012,72166
24867,1954,907,1047,2012,72167
24868,2135,1834,301,2012,72168
24869,113,43,70,2012,72169
24870,231,93,138,2012,72170
24871,9564,4815,4749,2012,72173
24872,287,118,169,2012,72175
24873,8734,4477,4257,2012,72176
24874,316,150,166,2012,72179
24875,22,17,5,2012,72181
24876,880,506,374,2012,72201
24877,11005,5356,5649,2012,72202
24878,31309,14893,16416,2012,72204
24879,21503,10403,11100,2012,72205
24880,25203,12745,12458,2012,72206
24881,10640,4989,5651,2012,72207
24882,32605,14481,18124,2012,72209
24883,15020,7438,7582,2012,72210
24884,21748,10192,11556,2012,72211
24885,12691,5936,6755,2012,72212
24886,19033,9123,9910,2012,72223
24887,12283,5882,6401,2012,72227
24888,26006,12164,13842,2012,72301
24889,180,105,75,2012,72311
24890,24162,11459,12703,2012,72315
24891,1445,1416,29,2012,72320
24892,89,36,53,2012,72321
24893,307,208,99,2012,72322
24894,2203,1056,1147,2012,72324
24895,48,27,21,2012,72325
24896,1785,838,947,2012,72326
24897,1253,567,686,2012,72327
24898,15,8,7,2012,72328
24899,55,20,35,2012,72329
24900,811,439,372,2012,72330
24901,3467,1564,1903,2012,72331
24902,109,53,56,2012,72332
24903,796,413,383,2012,72333
24904,19693,11029,8664,2012,72335
24905,62,31,31,2012,72338
24906,150,81,69,2012,72339
24907,68,33,35,2012,72340
24908,399,195,204,2012,72341
24909,5363,2490,2873,2012,72342
24910,738,468,270,2012,72346
24911,762,358,404,2012,72347
24912,3156,1651,1505,2012,72348
24913,1304,561,743,2012,72350
24914,685,329,356,2012,72351
24915,253,138,115,2012,72353
24916,2300,1098,1202,2012,72354
24917,2679,1357,1322,2012,72355
24918,1581,813,768,2012,72358
24919,652,256,396,2012,72359
24920,6258,2840,3418,2012,72360
24921,15747,7592,8155,2012,72364
24922,3183,1575,1608,2012,72365
24923,2570,1089,1481,2012,72366
24924,119,34,85,2012,72367
24925,1314,670,644,2012,72368
24926,8569,4565,4004,2012,72370
24927,2118,1051,1067,2012,72372
24928,1563,821,742,2012,72373
24929,965,533,432,2012,72374
24930,1764,981,783,2012,72376
24931,67,43,24,2012,72377
24932,85,65,20,2012,72379
24933,0,0,0,2012,72383
24934,1048,503,545,2012,72384
24935,1763,859,904,2012,72386
24936,249,99,150,2012,72389
24937,8731,4118,4613,2012,72390
24938,337,161,176,2012,72392
24939,677,429,248,2012,72394
24940,922,406,516,2012,72395
24941,13251,6277,6974,2012,72396
24942,54654,26116,28538,2012,72401
24943,22548,11275,11273,2012,72404
24944,581,310,271,2012,72410
24945,2229,1094,1135,2012,72411
24946,700,357,343,2012,72412
24947,622,313,309,2012,72413
24948,474,285,189,2012,72414
24949,1220,578,642,2012,72415
24950,6239,3107,3132,2012,72416
24951,3897,1957,1940,2012,72417
24952,1631,780,851,2012,72419
24953,326,136,190,2012,72421
24954,5214,2463,2751,2012,72422
24955,75,36,39,2012,72424
24956,484,224,260,2012,72425
24957,206,94,112,2012,72426
24958,191,96,95,2012,72427
24959,74,31,43,2012,72428
24960,428,229,199,2012,72429
24961,383,194,189,2012,72430
24962,462,267,195,2012,72431
24963,6333,3005,3328,2012,72432
24964,2899,1502,1397,2012,72433
24965,1972,926,1046,2012,72434
24966,557,314,243,2012,72435
24967,792,401,391,2012,72436
24968,2863,1311,1552,2012,72437
24969,2560,1304,1256,2012,72438
24970,211,125,86,2012,72440
24971,83,48,35,2012,72441
24972,4931,2073,2858,2012,72442
24973,3139,1555,1584,2012,72443
24974,1642,753,889,2012,72444
24975,92,36,56,2012,72445
24976,1940,988,952,2012,72447
24977,283,150,133,2012,72449
24978,36186,17731,18455,2012,72450
24979,141,66,75,2012,72453
24980,5220,2463,2757,2012,72454
24981,12889,6337,6552,2012,72455
24982,695,318,377,2012,72456
24983,164,79,85,2012,72457
24984,682,353,329,2012,72458
24985,1346,614,732,2012,72459
24986,581,258,323,2012,72460
24987,3424,1823,1601,2012,72461
24988,416,226,190,2012,72462
24989,52,17,35,2012,72464
24990,1699,799,900,2012,72466
24991,569,525,44,2012,72467
24992,1197,626,571,2012,72469
24993,142,80,62,2012,72470
24994,1079,473,606,2012,72471
24995,9536,4655,4881,2012,72472
24996,2538,1284,1254,2012,72473
24997,7220,3338,3882,2012,72476
24998,322,165,157,2012,72478
24999,1739,861,878,2012,72479
25000,1068,569,499,2012,72482
25001,24666,12001,12665,2012,72501
25002,2224,1044,1180,2012,72512
25003,2816,1435,1381,2012,72513
25004,27,7,20,2012,72515
25005,623,344,279,2012,72517
25006,2747,1571,1176,2012,72519
25007,560,285,275,2012,72520
25008,4827,2357,2470,2012,72521
25009,467,218,249,2012,72522
25010,1166,592,574,2012,72523
25011,325,194,131,2012,72524
25012,140,64,76,2012,72526
25013,487,236,251,2012,72527
25014,52,23,29,2012,72528
25015,4771,2256,2515,2012,72529
25016,1726,798,928,2012,72530
25017,383,256,127,2012,72531
25018,2156,1002,1154,2012,72532
25019,499,239,260,2012,72533
25020,1473,678,795,2012,72534
25021,314,187,127,2012,72536
25022,474,217,257,2012,72537
25023,550,313,237,2012,72538
25024,115,48,67,2012,72539
25025,172,91,81,2012,72540
25026,3517,1783,1734,2012,72542
25027,12599,6183,6416,2012,72543
25028,643,290,353,2012,72544
25029,273,156,117,2012,72546
25030,901,524,377,2012,72550
25031,67,29,38,2012,72553
25032,3230,1665,1565,2012,72554
25033,150,64,86,2012,72555
25034,3154,1452,1702,2012,72556
25035,8872,4338,4534,2012,72560
25036,995,532,463,2012,72561
25037,2463,1330,1133,2012,72562
25038,563,247,316,2012,72564
25039,883,497,386,2012,72565
25040,970,601,369,2012,72566
25041,298,158,140,2012,72567
25042,1753,842,911,2012,72568
25043,394,174,220,2012,72569
25044,282,187,95,2012,72571
25045,396,226,170,2012,72572
25046,228,103,125,2012,72573
25047,4294,2036,2258,2012,72576
25048,716,374,342,2012,72577
25049,375,202,173,2012,72578
25050,1121,601,520,2012,72579
25051,990,484,506,2012,72581
25052,1394,687,707,2012,72583
25053,559,288,271,2012,72584
25054,209,124,85,2012,72585
25055,180,100,80,2012,72587
25056,30823,15013,15810,2012,72601
25057,1849,979,870,2012,72611
25058,10187,4727,5460,2012,72616
25059,171,103,68,2012,72617
25060,1859,890,969,2012,72619
25061,588,284,304,2012,72623
25062,541,285,256,2012,72624
25063,1489,718,771,2012,72626
25064,847,433,414,2012,72628
25065,405,142,263,2012,72629
25066,223,102,121,2012,72630
25067,4314,2310,2004,2012,72631
25068,4060,2042,2018,2012,72632
25069,1672,897,775,2012,72633
25070,4969,2487,2482,2012,72634
25071,3516,1663,1853,2012,72635
25072,46,41,5,2012,72636
25073,6862,3387,3475,2012,72638
25074,834,444,390,2012,72639
25075,512,254,258,2012,72640
25076,2623,1340,1283,2012,72641
25077,1745,903,842,2012,72642
25078,2412,1251,1161,2012,72644
25079,1334,677,657,2012,72645
25080,592,347,245,2012,72648
25081,4354,2054,2300,2012,72650
25082,1165,590,575,2012,72651
25083,29003,13627,15376,2012,72653
25084,398,178,220,2012,72655
25085,1925,1058,867,2012,72658
25086,577,228,349,2012,72660
25087,398,214,184,2012,72661
25088,2862,1406,1456,2012,72662
25089,358,201,157,2012,72663
25090,193,93,100,2012,72666
25091,479,244,235,2012,72668
25092,170,80,90,2012,72669
25093,117,70,47,2012,72670
25094,321,151,170,2012,72672
25095,1313,636,677,2012,72675
25096,484,254,230,2012,72677
25097,47,15,32,2012,72679
25098,737,303,434,2012,72680
25099,150,69,81,2012,72682
25100,121,43,78,2012,72683
25101,1374,710,664,2012,72685
25102,270,173,97,2012,72686
25103,6531,3157,3374,2012,72687
25104,40259,20213,20046,2012,72701
25105,29075,14076,14999,2012,72703
25106,21114,11300,9814,2012,72704
25107,41015,20713,20302,2012,72712
25108,11895,5615,6280,2012,72714
25109,14832,7287,7545,2012,72715
25110,732,447,285,2012,72717
25111,1754,818,936,2012,72718
25112,9295,4402,4893,2012,72719
25113,295,191,104,2012,72721
25114,2866,1365,1501,2012,72722
25115,5958,2857,3101,2012,72727
25116,91,58,33,2012,72729
25117,7717,3756,3961,2012,72730
25118,4652,2389,2263,2012,72732
25119,7373,3303,4070,2012,72734
25120,5773,2917,2856,2012,72736
25121,2603,1263,1340,2012,72738
25122,599,246,353,2012,72739
25123,9475,4498,4977,2012,72740
25124,286,165,121,2012,72742
25125,4403,2254,2149,2012,72744
25126,10501,5121,5380,2012,72745
25127,159,85,74,2012,72747
25128,69,41,28,2012,72749
25129,6025,3161,2864,2012,72751
25130,348,194,154,2012,72752
25131,7581,3672,3909,2012,72753
25132,37803,19255,18548,2012,72756
25133,35583,17169,18414,2012,72758
25134,192,111,81,2012,72760
25135,21688,10622,11066,2012,72761
25136,34481,16597,17884,2012,72762
25137,51840,26094,25746,2012,72764
25138,1416,800,616,2012,72768
25139,1434,865,569,2012,72769
25140,1120,607,513,2012,72773
25141,6328,3169,3159,2012,72774
25142,613,337,276,2012,72776
25143,17903,8637,9266,2012,72801
25144,21886,10786,11100,2012,72802
25145,1774,899,875,2012,72821
25146,6365,3189,3176,2012,72823
25147,1902,956,946,2012,72824
25148,38,9,29,2012,72826
25149,106,60,46,2012,72827
25150,138,64,74,2012,72828
25151,15308,7456,7852,2012,72830
25152,1163,577,586,2012,72832
25153,4269,1957,2312,2012,72833
25154,11025,5684,5341,2012,72834
25155,908,450,458,2012,72835
25156,8084,4077,4007,2012,72837
25157,163,63,100,2012,72838
25158,48,23,25,2012,72839
25159,2146,1034,1112,2012,72840
25160,322,166,156,2012,72841
25161,1360,682,678,2012,72842
25162,2384,1197,1187,2012,72843
25163,1096,617,479,2012,72845
25164,4213,1867,2346,2012,72846
25165,2485,1387,1098,2012,72847
25166,568,289,279,2012,72851
25167,233,126,107,2012,72852
25168,1944,918,1026,2012,72853
25169,628,324,304,2012,72854
25170,6091,3049,3042,2012,72855
25171,490,249,241,2012,72856
25172,1437,800,637,2012,72857
25173,3078,1666,1412,2012,72858
25174,290,181,109,2012,72860
25175,1568,742,826,2012,72863
25176,1562,927,635,2012,72865
25177,22591,11437,11154,2012,72901
25178,25725,12628,13097,2012,72903
25179,21287,9888,11399,2012,72904
25180,13648,6766,6882,2012,72908
25181,7022,3532,3490,2012,72916
25182,13828,6451,7377,2012,72921
25183,4787,2319,2468,2012,72923
25184,464,236,228,2012,72926
25185,8937,4415,4522,2012,72927
25186,827,381,446,2012,72928
25187,267,138,129,2012,72930
25188,2045,1132,913,2012,72932
25189,4486,2425,2061,2012,72933
25190,1395,788,607,2012,72934
25191,477,238,239,2012,72935
25192,15064,7059,8005,2012,72936
25193,3568,1923,1645,2012,72937
25194,1649,872,777,2012,72938
25195,1804,928,876,2012,72940
25196,5940,2999,2941,2012,72941
25197,2392,1187,1205,2012,72943
25198,2768,1325,1443,2012,72944
25199,391,189,202,2012,72945
25200,3516,1756,1760,2012,72946
25201,4800,2566,2234,2012,72947
25202,429,243,186,2012,72948
25203,10331,4820,5511,2012,72949
25204,473,197,276,2012,72950
25205,1153,540,613,2012,72951
25206,2785,1466,1319,2012,72952
25207,196,125,71,2012,72955
25208,33058,16128,16930,2012,72956
25209,7909,4170,3739,2012,72958
25210,3052,1682,1370,2012,72959
25211,994,475,519,2012,73002
25212,20114,9448,10666,2012,73003
25213,677,354,323,2012,73004
25214,9188,4283,4905,2012,73005
25215,3775,1912,1863,2012,73006
25216,1709,773,936,2012,73007
25217,19752,9282,10470,2012,73008
25218,1348,643,705,2012,73009
25219,17462,8825,8637,2012,73010
25220,424,228,196,2012,73011
25221,26300,12702,13598,2012,73012
25222,44714,20923,23791,2012,73013
25223,1424,739,685,2012,73014
25224,2752,1351,1401,2012,73015
25225,1618,783,835,2012,73016
25226,1796,925,871,2012,73017
25227,20368,9961,10407,2012,73018
25228,80,41,39,2012,73019
25229,21085,9884,11201,2012,73020
25230,320,164,156,2012,73021
25231,618,273,345,2012,73024
25232,11334,5558,5776,2012,73025
25233,11341,5919,5422,2012,73026
25234,1612,803,809,2012,73027
25235,3272,1505,1767,2012,73028
25236,1700,834,866,2012,73029
25237,4306,2053,2253,2012,73030
25238,314,176,138,2012,73032
25239,482,248,234,2012,73033
25240,40829,20672,20157,2012,73034
25241,18618,9898,8720,2012,73036
25242,2309,1233,1076,2012,73038
25243,1895,946,949,2012,73040
25244,373,190,183,2012,73041
25245,1012,499,513,2012,73042
25246,152,89,63,2012,73043
25247,20126,10055,10071,2012,73044
25248,10286,5309,4977,2012,73045
25249,4847,3171,1676,2012,73047
25250,1993,1000,993,2012,73048
25251,5682,2855,2827,2012,73049
25252,816,397,419,2012,73050
25253,9987,6290,3697,2012,73051
25254,6310,3227,3083,2012,73052
25255,692,338,354,2012,73053
25256,4073,2167,1906,2012,73054
25257,9749,4739,5010,2012,73055
25258,590,282,308,2012,73056
25259,2338,1129,1209,2012,73057
25260,450,227,223,2012,73058
25261,2535,1307,1228,2012,73059
25262,1695,861,834,2012,73061
25263,1435,716,719,2012,73062
25264,654,346,308,2012,73063
25265,20869,10241,10628,2012,73064
25266,6619,3211,3408,2012,73065
25267,344,122,222,2012,73066
25268,2068,1061,1007,2012,73067
25269,11061,5287,5774,2012,73068
25270,24109,12141,11968,2012,73069
25271,36741,18454,18287,2012,73071
25272,43536,21721,21815,2012,73072
25273,624,306,318,2012,73073
25274,1121,588,533,2012,73074
25275,9628,4705,4923,2012,73075
25276,7171,3414,3757,2012,73077
25277,7917,3828,4089,2012,73078
25278,667,332,335,2012,73079
25279,9522,4490,5032,2012,73080
25280,2464,1193,1271,2012,73082
25281,6726,3242,3484,2012,73084
25282,8227,4193,4034,2012,73086
25283,12281,6063,6218,2012,73089
25284,1663,1051,612,2012,73090
25285,986,503,483,2012,73092
25286,2804,1362,1442,2012,73093
25287,1865,926,939,2012,73095
25288,13100,6441,6659,2012,73096
25289,221,97,124,2012,73097
25290,4725,2312,2413,2012,73098
25291,58595,28107,30488,2012,73099
25292,2666,1799,867,2012,73102
25293,4350,2331,2019,2012,73103
25294,1732,812,920,2012,73104
25295,5708,2519,3189,2012,73105
25296,12672,6947,5725,2012,73106
25297,26099,13196,12903,2012,73107
25298,15465,8448,7017,2012,73108
25299,20515,10438,10077,2012,73109
25300,32904,15926,16978,2012,73110
25301,11386,5074,6312,2012,73111
25302,31396,15215,16181,2012,73112
25303,18482,8813,9669,2012,73114
25304,20843,9564,11279,2012,73115
25305,9644,4466,5178,2012,73116
25306,5157,2247,2910,2012,73117
25307,13485,6869,6616,2012,73118
25308,29958,15040,14918,2012,73119
25309,35981,17026,18955,2012,73120
25310,3369,1637,1732,2012,73121
25311,14429,7554,6875,2012,73122
25312,24183,12372,11811,2012,73127
25313,3814,1768,2046,2012,73128
25314,19820,9982,9838,2012,73129
25315,19303,9272,10031,2012,73130
25316,3099,1656,1443,2012,73131
25317,26977,12661,14316,2012,73132
25318,4315,1940,2375,2012,73134
25319,20187,9563,10624,2012,73135
25320,17543,8688,8855,2012,73139
25321,2835,1386,1449,2012,73141
25322,10141,4757,5384,2012,73142
25323,2362,1472,890,2012,73145
25324,4797,2432,2365,2012,73149
25325,4447,2364,2083,2012,73150
25326,1630,902,728,2012,73151
25327,29988,14933,15055,2012,73159
25328,53446,25774,27672,2012,73160
25329,29304,14024,15280,2012,73162
25330,6064,3234,2830,2012,73165
25331,1665,883,782,2012,73169
25332,35244,17023,18221,2012,73170
25333,1360,682,678,2012,73173
25334,3112,1481,1631,2012,73179
25335,35020,17058,17962,2012,73401
25336,116,92,24,2012,73425
25337,1278,625,653,2012,73430
25338,915,444,471,2012,73432
25339,2509,1204,1305,2012,73433
25340,557,282,275,2012,73434
25341,45,25,20,2012,73437
25342,3883,1879,2004,2012,73438
25343,7393,3681,3712,2012,73439
25344,232,141,91,2012,73440
25345,288,162,126,2012,73441
25346,679,336,343,2012,73442
25347,3384,1742,1642,2012,73443
25348,70,59,11,2012,73444
25349,8149,3948,4201,2012,73446
25350,1286,628,658,2012,73447
25351,5910,2886,3024,2012,73448
25352,3251,1590,1661,2012,73449
25353,1283,594,689,2012,73450
25354,477,209,268,2012,73453
25355,604,318,286,2012,73455
25356,2156,1020,1136,2012,73456
25357,1001,517,484,2012,73458
25358,1059,524,535,2012,73459
25359,4568,2161,2407,2012,73460
25360,1023,515,508,2012,73461
25361,3678,1711,1967,2012,73463
25362,910,482,428,2012,73481
25363,148,59,89,2012,73487
25364,966,496,470,2012,73491
25365,19794,11185,8609,2012,73501
25366,10468,7110,3358,2012,73503
25367,50015,23717,26298,2012,73505
25368,24220,12106,12114,2012,73507
25369,124,57,67,2012,73520
25370,21834,10812,11022,2012,73521
25371,2016,1010,1006,2012,73526
25372,4638,2341,2297,2012,73527
25373,558,259,299,2012,73528
25374,4968,2469,2499,2012,73529
25375,489,284,205,2012,73530
25376,392,197,195,2012,73531
25377,575,271,304,2012,73532
25378,28199,13532,14667,2012,73533
25379,571,303,268,2012,73537
25380,4494,2299,2195,2012,73538
25381,178,89,89,2012,73539
25382,478,240,238,2012,73540
25383,2937,1390,1547,2012,73541
25384,4485,2337,2148,2012,73542
25385,1865,900,965,2012,73543
25386,189,86,103,2012,73544
25387,1265,559,706,2012,73546
25388,2311,1615,696,2012,73547
25389,363,161,202,2012,73548
25390,426,235,191,2012,73549
25391,2541,1176,1365,2012,73550
25392,125,58,67,2012,73551
25393,1404,737,667,2012,73552
25394,33,17,16,2012,73553
25395,3515,1731,1784,2012,73554
25396,300,187,113,2012,73555
25397,149,59,90,2012,73556
25398,259,134,125,2012,73557
25399,631,320,311,2012,73559
25400,605,293,312,2012,73560
25401,660,337,323,2012,73562
25402,509,290,219,2012,73564
25403,939,473,466,2012,73565
25404,1759,809,950,2012,73566
25405,625,329,296,2012,73567
25406,1286,592,694,2012,73568
25407,716,412,304,2012,73569
25408,1083,510,573,2012,73570
25409,142,78,64,2012,73571
25410,3698,1816,1882,2012,73572
25411,2457,1168,1289,2012,73573
25412,9810,4821,4989,2012,73601
25413,1206,626,580,2012,73620
25414,234,148,86,2012,73622
25415,2472,1316,1156,2012,73624
25416,600,317,283,2012,73625
25417,825,419,406,2012,73626
25418,533,288,245,2012,73627
25419,1932,976,956,2012,73628
25420,3415,1541,1874,2012,73632
25421,133,70,63,2012,73638
25422,605,294,311,2012,73639
25423,898,416,482,2012,73641
25424,157,85,72,2012,73642
25425,13995,7371,6624,2012,73644
25426,1414,662,752,2012,73645
25427,316,168,148,2012,73646
25428,731,373,358,2012,73647
25429,983,480,503,2012,73650
25430,4283,2126,2157,2012,73651
25431,911,490,421,2012,73654
25432,708,381,327,2012,73655
25433,340,190,150,2012,73658
25434,233,124,109,2012,73659
25435,357,175,182,2012,73660
25436,467,242,225,2012,73661
25437,6790,4002,2788,2012,73662
25438,1215,590,625,2012,73663
25439,1095,533,562,2012,73664
25440,132,61,71,2012,73666
25441,562,292,270,2012,73667
25442,1825,907,918,2012,73669
25443,330,162,168,2012,73673
25444,25071,12523,12548,2012,73701
25445,27282,12927,14355,2012,73703
25446,267,220,47,2012,73705
25447,411,201,210,2012,73716
25448,6675,3568,3107,2012,73717
25449,622,300,322,2012,73718
25450,30,8,22,2012,73719
25451,278,167,111,2012,73720
25452,554,256,298,2012,73722
25453,1092,464,628,2012,73724
25454,527,262,265,2012,73726
25455,120,67,53,2012,73727
25456,1832,974,858,2012,73728
25457,590,314,276,2012,73729
25458,773,363,410,2012,73730
25459,167,111,56,2012,73731
25460,172,86,86,2012,73733
25461,912,474,438,2012,73734
25462,618,308,310,2012,73735
25463,327,180,147,2012,73736
25464,3258,1606,1652,2012,73737
25465,1202,639,563,2012,73738
25466,276,144,132,2012,73739
25467,1759,1385,374,2012,73741
25468,4387,2283,2104,2012,73742
25469,117,66,51,2012,73743
25470,247,96,151,2012,73744
25471,8,4,4,2012,73746
25472,291,149,142,2012,73747
25473,414,192,222,2012,73749
25474,6838,3210,3628,2012,73750
25475,552,284,268,2012,73753
25476,1184,636,548,2012,73754
25477,741,407,334,2012,73755
25478,238,124,114,2012,73756
25479,203,114,89,2012,73757
25480,199,103,96,2012,73758
25481,1428,776,652,2012,73759
25482,534,276,258,2012,73760
25483,436,182,254,2012,73761
25484,2096,1102,994,2012,73762
25485,1461,647,814,2012,73763
25486,166,95,71,2012,73764
25487,1228,561,667,2012,73766
25488,1485,753,732,2012,73768
25489,483,245,238,2012,73771
25490,5193,3299,1894,2012,73772
25491,1768,907,861,2012,73773
25492,15362,7866,7496,2012,73801
25493,963,521,442,2012,73832
25494,1808,810,998,2012,73834
25495,363,186,177,2012,73835
25496,537,259,278,2012,73838
25497,713,376,337,2012,73840
25498,1246,999,247,2012,73841
25499,443,160,283,2012,73842
25500,923,447,476,2012,73843
25501,195,99,96,2012,73844
25502,1941,1042,899,2012,73848
25503,35,17,18,2012,73851
25504,2129,1087,1042,2012,73852
25505,342,156,186,2012,73853
25506,102,49,53,2012,73855
25507,573,300,273,2012,73857
25508,1590,760,830,2012,73858
25509,1590,761,829,2012,73859
25510,1427,769,658,2012,73860
25511,101,66,35,2012,73901
25512,698,367,331,2012,73931
25513,1985,1032,953,2012,73932
25514,1650,829,821,2012,73933
25515,154,81,73,2012,73937
25516,808,397,411,2012,73938
25517,1578,858,720,2012,73939
25518,12582,6367,6215,2012,73942
25519,490,243,247,2012,73944
25520,3456,1764,1692,2012,73945
25521,63,37,26,2012,73946
25522,521,277,244,2012,73947
25523,1521,756,765,2012,73949
25524,1746,869,877,2012,73950
25525,1034,561,473,2012,73951
25526,347,186,161,2012,74001
25527,2437,1236,1201,2012,74002
25528,14677,7189,7488,2012,74003
25529,25577,12080,13497,2012,74006
25530,22875,11172,11703,2012,74008
25531,10870,5409,5461,2012,74010
25532,25233,12442,12791,2012,74011
25533,56789,28179,28610,2012,74012
25534,35588,17675,17913,2012,74014
25535,8722,4532,4190,2012,74015
25536,5798,2961,2837,2012,74016
25537,26960,12798,14162,2012,74017
25538,18715,9680,9035,2012,74019
25539,7313,3615,3698,2012,74020
25540,18108,9036,9072,2012,74021
25541,1920,1010,910,2012,74022
25542,11952,6255,5697,2012,74023
25543,1220,636,584,2012,74026
25544,878,443,435,2012,74027
25545,1676,791,885,2012,74028
25546,5173,2402,2771,2012,74029
25547,3705,1687,2018,2012,74030
25548,2135,1133,1002,2012,74032
25549,10052,4751,5301,2012,74033
25550,180,85,95,2012,74034
25551,4320,2734,1586,2012,74035
25552,5851,2855,2996,2012,74036
25553,15301,7554,7747,2012,74037
25554,2162,1091,1071,2012,74038
25555,3936,2193,1743,2012,74039
25556,2240,1085,1155,2012,74041
25557,736,418,318,2012,74042
25558,7089,3712,3377,2012,74044
25559,478,251,227,2012,74045
25560,145,81,64,2012,74046
25561,6300,3155,3145,2012,74047
25562,5846,2807,3039,2012,74048
25563,346,221,125,2012,74050
25564,2252,1036,1216,2012,74051
25565,1294,610,684,2012,74052
25566,4251,2210,2041,2012,74053
25567,813,438,375,2012,74054
25568,38410,19262,19148,2012,74055
25569,5171,2576,2595,2012,74056
25570,4184,1977,2207,2012,74058
25571,5023,2487,2536,2012,74059
25572,690,352,338,2012,74060
25573,1812,856,956,2012,74061
25574,1023,531,492,2012,74062
25575,30276,15090,15186,2012,74063
25576,30213,14694,15519,2012,74066
25577,60,23,37,2012,74068
25578,13961,6927,7034,2012,74070
25579,117,64,53,2012,74071
25580,1824,940,884,2012,74072
25581,5825,3028,2797,2012,74073
25582,29187,14729,14458,2012,74074
25583,23637,12097,11540,2012,74075
25584,2427,1112,1315,2012,74078
25585,4408,2076,2332,2012,74079
25586,2742,1363,1379,2012,74080
25587,1717,884,833,2012,74081
25588,113,38,75,2012,74082
25589,1132,534,598,2012,74083
25590,576,286,290,2012,74084
25591,2300,1112,1188,2012,74085
25592,1925,1663,262,2012,74103
25593,12608,6333,6275,2012,74104
25594,26844,12536,14308,2012,74105
25595,16698,7401,9297,2012,74106
25596,19867,9525,10342,2012,74107
25597,6720,3582,3138,2012,74108
25598,14111,7142,6969,2012,74110
25599,20870,10301,10569,2012,74112
25600,15890,7820,8070,2012,74114
25601,23746,11571,12175,2012,74115
25602,4366,2182,2184,2012,74116
25603,180,84,96,2012,74117
25604,3688,2016,1672,2012,74119
25605,5172,2664,2508,2012,74120
25606,10332,4471,5861,2012,74126
25607,16837,8265,8572,2012,74127
25608,12351,6356,5995,2012,74128
25609,18207,9010,9197,2012,74129
25610,2124,1051,1073,2012,74130
25611,3202,1799,1403,2012,74131
25612,7489,3502,3987,2012,74132
25613,43765,20107,23658,2012,74133
25614,16237,8518,7719,2012,74134
25615,21332,9859,11473,2012,74135
25616,30765,14230,16535,2012,74136
25617,26494,12806,13688,2012,74137
25618,18325,8777,9548,2012,74145
25619,13934,6936,6998,2012,74146
25620,12121,6030,6091,2012,74301
25621,2863,1413,1450,2012,74330
25622,6858,3513,3345,2012,74331
25623,1680,908,772,2012,74332
25624,1214,643,571,2012,74333
25625,5133,2579,2554,2012,74337
25626,5345,2779,2566,2012,74338
25627,2608,1245,1363,2012,74339
25628,190,105,85,2012,74340
25629,2532,1217,1315,2012,74342
25630,2921,1456,1465,2012,74343
25631,14166,6990,7176,2012,74344
25632,8381,4124,4257,2012,74346
25633,2855,1227,1628,2012,74347
25634,314,151,163,2012,74349
25635,807,347,460,2012,74350
25636,7430,3554,3876,2012,74352
25637,18189,8689,9500,2012,74354
25638,250,142,108,2012,74358
25639,730,387,343,2012,74359
25640,158,88,70,2012,74360
25641,16689,8534,8155,2012,74361
25642,2862,1428,1434,2012,74363
25643,1809,879,930,2012,74364
25644,4572,2169,2403,2012,74365
25645,1567,731,836,2012,74366
25646,488,280,208,2012,74367
25647,45,19,26,2012,74368
25648,1820,848,972,2012,74369
25649,3923,1986,1937,2012,74370
25650,17983,8561,9422,2012,74401
25651,30808,14708,16100,2012,74403
25652,4566,2226,2340,2012,74421
25653,612,342,270,2012,74422
25654,961,469,492,2012,74423
25655,891,396,495,2012,74425
25656,9764,4656,5108,2012,74426
25657,1036,570,466,2012,74427
25658,1046,534,512,2012,74428
25659,13857,6948,6909,2012,74429
25660,595,340,255,2012,74430
25661,1010,542,468,2012,74431
25662,9920,4957,4963,2012,74432
25663,9561,4782,4779,2012,74434
25664,2716,1419,1297,2012,74435
25665,4390,2172,2218,2012,74436
25666,10321,5141,5180,2012,74437
25667,290,156,134,2012,74438
25668,5435,2898,2537,2012,74441
25669,1001,522,479,2012,74442
25670,2862,1420,1442,2012,74445
25671,608,282,326,2012,74446
25672,17287,8655,8632,2012,74447
25673,1823,933,890,2012,74450
25674,4479,2173,2306,2012,74451
25675,391,175,216,2012,74452
25676,2826,1530,1296,2012,74454
25677,2555,1342,1213,2012,74455
25678,217,142,75,2012,74456
25679,575,272,303,2012,74457
25680,109,63,46,2012,74458
25681,79,35,44,2012,74459
25682,286,145,141,2012,74460
25683,7744,3863,3881,2012,74462
25684,2135,1251,884,2012,74463
25685,29809,14345,15464,2012,74464
25686,15713,7314,8399,2012,74467
25687,257,110,147,2012,74468
25688,2321,1128,1193,2012,74469
25689,1376,765,611,2012,74470
25690,1888,1005,883,2012,74471
25691,547,289,258,2012,74472
25692,0,0,0,2012,74477
25693,29528,15319,14209,2012,74501
25694,221,118,103,2012,74521
25695,220,125,95,2012,74522
25696,5818,2792,3026,2012,74523
25697,9678,4965,4713,2012,74525
25698,173,105,68,2012,74528
25699,171,82,89,2012,74530
25700,867,459,408,2012,74531
25701,814,396,418,2012,74533
25702,245,132,113,2012,74534
25703,230,92,138,2012,74535
25704,1877,918,959,2012,74536
25705,4036,1967,2069,2012,74538
25706,165,71,94,2012,74540
25707,452,243,209,2012,74543
25708,725,396,329,2012,74546
25709,3108,1574,1534,2012,74547
25710,99,50,49,2012,74549
25711,1001,496,505,2012,74552
25712,1100,545,555,2012,74553
25713,2198,1039,1159,2012,74554
25714,735,393,342,2012,74555
25715,461,254,207,2012,74556
25716,437,227,210,2012,74557
25717,517,251,266,2012,74558
25718,647,297,350,2012,74560
25719,2270,1151,1119,2012,74561
25720,727,361,366,2012,74562
25721,2204,1136,1068,2012,74563
25722,619,296,323,2012,74565
25723,168,95,73,2012,74567
25724,1035,736,299,2012,74569
25725,1123,605,518,2012,74570
25726,3643,1813,1830,2012,74571
25727,669,325,344,2012,74572
25728,1180,559,621,2012,74574
25729,153,67,86,2012,74576
25730,365,173,192,2012,74577
25731,6535,3286,3249,2012,74578
25732,20057,9890,10167,2012,74601
25733,12217,5931,6286,2012,74604
25734,684,342,342,2012,74630
25735,7593,3892,3701,2012,74631
25736,517,276,241,2012,74632
25737,582,303,279,2012,74633
25738,234,123,111,2012,74636
25739,2323,1016,1307,2012,74637
25740,373,191,182,2012,74640
25741,594,291,303,2012,74641
25742,535,271,264,2012,74643
25743,462,226,236,2012,74644
25744,279,152,127,2012,74646
25745,3768,1768,2000,2012,74647
25746,678,358,320,2012,74650
25747,689,373,316,2012,74651
25748,738,373,365,2012,74652
25749,3957,2051,1906,2012,74653
25750,22344,10714,11630,2012,74701
25751,699,366,333,2012,74720
25752,307,142,165,2012,74722
25753,1554,784,770,2012,74723
25754,456,240,216,2012,74724
25755,2142,1144,998,2012,74726
25756,2067,978,1089,2012,74727
25757,11269,5593,5676,2012,74728
25758,3182,1559,1623,2012,74729
25759,4269,2007,2262,2012,74730
25760,2128,1150,978,2012,74731
25761,2537,1221,1316,2012,74733
25762,1103,526,577,2012,74734
25763,1504,717,787,2012,74735
25764,1103,511,592,2012,74736
25765,645,335,310,2012,74738
25766,2365,1258,1107,2012,74740
25767,911,520,391,2012,74741
25768,8386,4003,4383,2012,74743
25769,9558,4385,5173,2012,74745
25770,129,67,62,2012,74747
25771,549,315,234,2012,74748
25772,457,243,214,2012,74750
25773,0,0,0,2012,74753
25774,162,92,70,2012,74754
25775,84,34,50,2012,74755
25776,987,481,506,2012,74756
25777,1374,702,672,2012,74759
25778,243,105,138,2012,74760
25779,72,31,41,2012,74761
25780,4024,2086,1938,2012,74764
25781,1357,651,706,2012,74766
25782,21857,10377,11480,2012,74801
25783,20069,9701,10368,2012,74804
25784,31144,14977,16167,2012,74820
25785,1449,794,655,2012,74824
25786,2023,1034,989,2012,74825
25787,1054,521,533,2012,74826
25788,472,237,235,2012,74827
25789,1427,1130,297,2012,74829
25790,236,103,133,2012,74830
25791,856,457,399,2012,74831
25792,1084,500,584,2012,74832
25793,615,339,276,2012,74833
25794,6839,3485,3354,2012,74834
25795,36,24,12,2012,74836
25796,510,265,245,2012,74837
25797,708,348,360,2012,74839
25798,1622,799,823,2012,74840
25799,94,46,48,2012,74842
25800,335,151,184,2012,74843
25801,261,136,125,2012,74844
25802,670,335,335,2012,74845
25803,8321,4756,3565,2012,74848
25804,3158,1610,1548,2012,74849
25805,436,233,203,2012,74850
25806,9785,4119,5666,2012,74851
25807,1479,852,627,2012,74852
25808,1724,776,948,2012,74854
25809,5354,2636,2718,2012,74855
25810,890,433,457,2012,74856
25811,8076,4056,4020,2012,74857
25812,6269,3117,3152,2012,74859
25813,2192,1102,1090,2012,74860
25814,5248,2563,2685,2012,74864
25815,1981,1013,968,2012,74865
25816,1150,488,662,2012,74867
25817,12771,6212,6559,2012,74868
25818,691,361,330,2012,74869
25819,2155,1115,1040,2012,74871
25820,3712,1822,1890,2012,74872
25821,12327,6322,6005,2012,74873
25822,1318,607,711,2012,74875
25823,1517,806,711,2012,74878
25824,1993,1002,991,2012,74880
25825,4064,2058,2006,2012,74881
25826,2448,1199,1249,2012,74883
25827,5900,2889,3011,2012,74884
25828,1984,927,1057,2012,74901
25829,4098,2056,2042,2012,74902
25830,1901,909,992,2012,74930
25831,1644,797,847,2012,74931
25832,2666,1321,1345,2012,74932
25833,148,74,74,2012,74935
25834,1608,833,775,2012,74936
25835,5662,2736,2926,2012,74937
25836,1499,1160,339,2012,74939
25837,2632,1276,1356,2012,74940
25838,2529,1176,1353,2012,74941
25839,219,130,89,2012,74942
25840,91,41,50,2012,74943
25841,1273,591,682,2012,74944
25842,560,258,302,2012,74945
25843,130,74,56,2012,74946
25844,12709,6425,6284,2012,74948
25845,332,163,169,2012,74949
25846,1581,726,855,2012,74951
25847,12020,6405,5615,2012,74953
25848,4838,2212,2626,2012,74954
25849,14688,7086,7602,2012,74955
25850,2198,1133,1065,2012,74956
25851,960,434,526,2012,74957
25852,6303,2923,3380,2012,74959
25853,12814,6421,6393,2012,74960
25854,5153,2621,2532,2012,74962
25855,763,413,350,2012,74963
25856,2444,1204,1240,2012,74964
25857,5737,2945,2792,2012,74965
25858,3720,1839,1881,2012,74966
25859,13033,6523,6510,2012,75001
25860,64067,30556,33511,2012,75002
25861,46557,22991,23566,2012,75006
25862,51735,26021,25714,2012,75007
25863,8342,4078,4264,2012,75009
25864,22848,11038,11810,2012,75010
25865,29971,14440,15531,2012,75013
25866,39212,18862,20350,2012,75019
25867,22525,11010,11515,2012,75020
25868,8004,3775,4229,2012,75021
25869,22449,10786,11663,2012,75022
25870,46339,23043,23296,2012,75023
25871,37708,18731,18977,2012,75024
25872,51202,25088,26114,2012,75025
25873,42878,20856,22022,2012,75028
25874,29088,14694,14394,2012,75032
25875,71123,35100,36023,2012,75034
25876,48691,24260,24431,2012,75035
25877,27393,13771,13622,2012,75038
25878,10932,5519,5413,2012,75039
25879,59244,29908,29336,2012,75040
25880,29793,15259,14534,2012,75041
25881,39193,20123,19070,2012,75042
25882,57596,28106,29490,2012,75043
25883,42012,20010,22002,2012,75044
25884,20215,9652,10563,2012,75048
25885,39994,19871,20123,2012,75050
25886,40023,19790,20233,2012,75051
25887,89829,44516,45313,2012,75052
25888,4769,2568,2201,2012,75054
25889,48266,23501,24765,2012,75056
25890,13194,6786,6408,2012,75057
25891,3145,1554,1591,2012,75058
25892,46617,22595,24022,2012,75060
25893,52243,26141,26102,2012,75061
25894,46027,22396,23631,2012,75062
25895,35443,17224,18219,2012,75063
25896,11029,5774,5255,2012,75065
25897,60477,29693,30784,2012,75067
25898,36021,17941,18080,2012,75068
25899,34635,16839,17796,2012,75069
25900,74753,36338,38415,2012,75070
25901,36928,18837,18091,2012,75071
25902,45573,23532,22041,2012,75074
25903,33529,16389,17140,2012,75075
25904,7666,3813,3853,2012,75076
25905,36773,17771,19002,2012,75077
25906,10823,5101,5722,2012,75078
25907,44601,22702,21899,2012,75080
25908,34138,16731,17407,2012,75081
25909,21336,11356,9980,2012,75082
25910,29292,13821,15471,2012,75087
25911,25394,12516,12878,2012,75088
25912,29539,14741,14798,2012,75089
25913,23298,11297,12001,2012,75090
25914,22803,10533,12270,2012,75092
25915,46690,22826,23864,2012,75093
25916,20029,9313,10716,2012,75094
25917,46887,22590,24297,2012,75098
25918,589,287,302,2012,75101
25919,1118,555,563,2012,75102
25920,13526,6968,6558,2012,75103
25921,45349,21272,24077,2012,75104
25922,283,180,103,2012,75105
25923,4330,2075,2255,2012,75109
25924,27458,13616,13842,2012,75110
25925,4467,2302,2165,2012,75114
25926,48860,22357,26503,2012,75115
25927,19635,9605,10030,2012,75116
25928,3205,1575,1630,2012,75117
25929,25687,12407,13280,2012,75119
25930,4160,2098,2062,2012,75124
25931,6904,3417,3487,2012,75125
25932,31825,15754,16071,2012,75126
25933,1629,803,826,2012,75127
25934,391,189,202,2012,75132
25935,20153,9527,10626,2012,75134
25936,4944,2475,2469,2012,75135
25937,18955,8684,10271,2012,75137
25938,6811,3244,3567,2012,75140
25939,5258,3299,1959,2012,75141
25940,18920,9365,9555,2012,75142
25941,16073,8157,7916,2012,75143
25942,3394,1600,1794,2012,75144
25943,17432,8074,9358,2012,75146
25944,7897,3916,3981,2012,75147
25945,6706,3253,3453,2012,75148
25946,56253,27028,29225,2012,75149
25947,58538,27476,31062,2012,75150
25948,5577,2934,2643,2012,75152
25949,665,343,322,2012,75153
25950,35067,17102,17965,2012,75154
25951,2673,1358,1315,2012,75155
25952,14538,7157,7381,2012,75156
25953,382,177,205,2012,75157
25954,4359,2240,2119,2012,75158
25955,18322,10070,8252,2012,75159
25956,23102,11030,12072,2012,75160
25957,6859,3417,3442,2012,75161
25958,1899,982,917,2012,75163
25959,457,249,208,2012,75164
25960,38251,18404,19847,2012,75165
25961,3381,1536,1845,2012,75166
25962,9842,5050,4792,2012,75167
25963,14813,6960,7853,2012,75169
25964,3965,2202,1763,2012,75172
25965,5175,2581,2594,2012,75173
25966,22861,11006,11855,2012,75180
25967,26498,12581,13917,2012,75181
25968,5085,2523,2562,2012,75182
25969,20634,10356,10278,2012,75189
25970,9331,5142,4189,2012,75201
25971,2005,1157,848,2012,75202
25972,16232,9005,7227,2012,75203
25973,26207,14291,11916,2012,75204
25974,24116,11359,12757,2012,75205
25975,36320,18806,17514,2012,75206
25976,9738,7018,2720,2012,75207
25977,32077,17109,14968,2012,75208
25978,14971,6880,8091,2012,75209
25979,5927,2886,3041,2012,75210
25980,73775,37210,36565,2012,75211
25981,24997,12850,12147,2012,75212
25982,32293,15849,16444,2012,75214
25983,14430,7040,7390,2012,75215
25984,47558,23077,24481,2012,75216
25985,82842,41240,41602,2012,75217
25986,22103,10603,11500,2012,75218
25987,20965,11824,9141,2012,75219
25988,43459,23998,19461,2012,75220
25989,13191,6701,6490,2012,75223
25990,33942,16414,17528,2012,75224
25991,20047,9249,10798,2012,75225
25992,2811,1655,1156,2012,75226
25993,56150,27582,28568,2012,75227
25994,68605,33495,35110,2012,75228
25995,32820,16803,16017,2012,75229
25996,26717,12361,14356,2012,75230
25997,34306,17842,16464,2012,75231
25998,26426,12488,13938,2012,75232
25999,14633,6998,7635,2012,75233
26000,28726,14387,14339,2012,75234
26001,19334,10070,9264,2012,75235
26002,15081,7557,7524,2012,75236
26003,17952,7431,10521,2012,75237
26004,29853,14846,15007,2012,75238
26005,25813,13083,12730,2012,75240
26006,28162,13159,15003,2012,75241
26007,55747,26232,29515,2012,75243
26008,13247,6837,6410,2012,75244
26009,3022,1795,1227,2012,75246
26010,509,390,119,2012,75247
26011,34911,16831,18080,2012,75248
26012,13684,6801,6883,2012,75249
26013,2910,1424,1486,2012,75251
26014,25129,12590,12539,2012,75252
26015,16873,8164,8709,2012,75253
26016,24097,11818,12279,2012,75254
26017,0,0,0,2012,75270
26018,49403,23983,25420,2012,75287
26019,0,0,0,2012,75390
26020,18743,9068,9675,2012,75401
26021,15846,7915,7931,2012,75402
26022,14085,6715,7370,2012,75407
26023,11766,5548,6218,2012,75409
26024,4018,2016,2002,2012,75410
26025,1165,611,554,2012,75411
26026,916,398,518,2012,75412
26027,243,124,119,2012,75413
26028,3265,1841,1424,2012,75414
26029,168,87,81,2012,75415
26030,3178,1528,1650,2012,75416
26031,2502,1224,1278,2012,75417
26032,13918,7832,6086,2012,75418
26033,873,488,385,2012,75420
26034,941,491,450,2012,75421
26035,2783,1381,1402,2012,75422
26036,3238,1674,1564,2012,75423
26037,3113,1624,1489,2012,75424
26038,4576,2111,2465,2012,75426
26039,10183,4834,5349,2012,75428
26040,1862,930,932,2012,75431
26041,3372,1611,1761,2012,75432
26042,2917,1404,1513,2012,75433
26043,1482,762,720,2012,75435
26044,2041,999,1042,2012,75436
26045,1264,594,670,2012,75437
26046,970,516,454,2012,75438
26047,957,478,479,2012,75439
26048,6759,3452,3307,2012,75440
26049,118,57,61,2012,75441
26050,9379,4612,4767,2012,75442
26051,3048,1577,1471,2012,75446
26052,1072,506,566,2012,75447
26053,530,291,239,2012,75448
26054,1094,581,513,2012,75449
26055,347,211,136,2012,75450
26056,823,469,354,2012,75451
26057,4634,2311,2323,2012,75452
26058,3112,1455,1657,2012,75453
26059,5288,2796,2492,2012,75454
26060,27801,14024,13777,2012,75455
26061,5883,2917,2966,2012,75457
26062,4104,2071,2033,2012,75459
26063,23183,10637,12546,2012,75460
26064,11313,5670,5643,2012,75462
26065,676,334,342,2012,75468
26066,545,221,324,2012,75469
26067,179,86,93,2012,75470
26068,1185,582,603,2012,75471
26069,3679,1922,1757,2012,75472
26070,4303,2219,2084,2012,75473
26071,14438,7206,7232,2012,75474
26072,141,79,62,2012,75475
26073,1433,691,742,2012,75476
26074,816,409,407,2012,75477
26075,1232,604,628,2012,75478
26076,1876,876,1000,2012,75479
26077,2123,1078,1045,2012,75480
26078,534,313,221,2012,75481
26079,24593,12197,12396,2012,75482
26080,2365,1120,1245,2012,75486
26081,1560,731,829,2012,75487
26082,1068,577,491,2012,75488
26083,1082,505,577,2012,75489
26084,2263,1037,1226,2012,75490
26085,4884,2381,2503,2012,75491
26086,518,318,200,2012,75492
26087,712,349,363,2012,75493
26088,10106,5052,5054,2012,75494
26089,6906,3578,3328,2012,75495
26090,3401,1635,1766,2012,75496
26091,3253,1646,1607,2012,75497
26092,36888,19037,17851,2012,75501
26093,24032,11833,12199,2012,75503
26094,950,535,415,2012,75550
26095,10738,4697,6041,2012,75551
26096,1970,913,1057,2012,75554
26097,1559,770,789,2012,75555
26098,1084,582,502,2012,75556
26099,1545,572,973,2012,75558
26100,6141,3132,3009,2012,75559
26101,998,538,460,2012,75560
26102,5463,2683,2780,2012,75561
26103,71,36,35,2012,75562
26104,5089,2848,2241,2012,75563
26105,371,165,206,2012,75565
26106,951,542,409,2012,75566
26107,4543,2212,2331,2012,75567
26108,2826,1399,1427,2012,75568
26109,2951,1363,1588,2012,75569
26110,9953,5310,4643,2012,75570
26111,2911,1340,1571,2012,75571
26112,3558,1572,1986,2012,75572
26113,57,31,26,2012,75573
26114,2169,1071,1098,2012,75574
26115,16353,7720,8633,2012,75601
26116,22369,11746,10623,2012,75602
26117,5833,3037,2796,2012,75603
26118,31398,15431,15967,2012,75604
26119,27400,13540,13860,2012,75605
26120,2546,1195,1351,2012,75630
26121,2290,1006,1284,2012,75631
26122,15197,7300,7897,2012,75633
26123,5790,2941,2849,2012,75638
26124,2795,1451,1344,2012,75639
26125,3528,1886,1642,2012,75640
26126,264,137,127,2012,75641
26127,217,103,114,2012,75642
26128,2145,1190,955,2012,75643
26129,11325,5344,5981,2012,75644
26130,10306,5289,5017,2012,75645
26131,13418,6618,6800,2012,75647
26132,8508,4409,4099,2012,75650
26133,2395,1127,1268,2012,75651
26134,16335,10055,6280,2012,75652
26135,12139,5922,6217,2012,75654
26136,4523,2185,2338,2012,75656
26137,8013,3920,4093,2012,75657
26138,2131,1187,944,2012,75661
26139,24080,10952,13128,2012,75662
26140,1016,498,518,2012,75667
26141,2233,952,1281,2012,75668
26142,785,368,417,2012,75669
26143,18981,9138,9843,2012,75670
26144,16710,8108,8602,2012,75672
26145,2321,1113,1208,2012,75681
26146,610,263,347,2012,75682
26147,4003,2109,1894,2012,75683
26148,7614,3726,3888,2012,75684
26149,12981,6278,6703,2012,75686
26150,4319,2200,2119,2012,75691
26151,4929,2322,2607,2012,75692
26152,6819,3441,3378,2012,75693
26153,35443,16279,19164,2012,75701
26154,26345,12755,13590,2012,75702
26155,36854,17786,19068,2012,75703
26156,7941,3805,4136,2012,75704
26157,2404,1225,1179,2012,75705
26158,10165,5333,4832,2012,75706
26159,14536,6798,7738,2012,75707
26160,6242,3549,2693,2012,75708
26161,5280,2663,2617,2012,75709
26162,3363,1512,1851,2012,75750
26163,17098,8286,8812,2012,75751
26164,6713,3407,3306,2012,75752
26165,5623,2816,2807,2012,75754
26166,5978,2765,3213,2012,75755
26167,3672,1753,1919,2012,75756
26168,10495,5070,5425,2012,75757
26169,8489,3949,4540,2012,75758
26170,170,94,76,2012,75759
26171,2224,1020,1204,2012,75760
26172,12686,6265,6421,2012,75762
26173,6866,3579,3287,2012,75763
26174,61,22,39,2012,75764
26175,8125,3712,4413,2012,75765
26176,25611,12999,12612,2012,75766
26177,2962,1471,1491,2012,75770
26178,18104,8629,9475,2012,75771
26179,12443,5995,6448,2012,75773
26180,3695,1932,1763,2012,75778
26181,144,82,62,2012,75779
26182,205,125,80,2012,75780
26183,7527,3901,3626,2012,75783
26184,654,276,378,2012,75784
26185,11917,6540,5377,2012,75785
26186,167,65,102,2012,75788
26187,6861,3271,3590,2012,75789
26188,3630,1750,1880,2012,75790
26189,13014,6407,6607,2012,75791
26190,3429,1570,1859,2012,75792
26191,16841,8357,8484,2012,75801
26192,24637,16096,8541,2012,75803
26193,5850,2833,3017,2012,75831
26194,39,21,18,2012,75832
26195,3291,1576,1715,2012,75833
26196,12216,6452,5764,2012,75835
26197,690,418,272,2012,75838
26198,5615,2745,2870,2012,75839
26199,7053,3553,3500,2012,75840
26200,5987,3109,2878,2012,75844
26201,4548,2017,2531,2012,75845
26202,2940,1442,1498,2012,75846
26203,1993,991,1002,2012,75847
26204,121,59,62,2012,75848
26205,196,104,92,2012,75849
26206,507,265,242,2012,75850
26207,4073,2642,1431,2012,75851
26208,4386,3623,763,2012,75852
26209,1086,550,536,2012,75853
26210,2490,1346,1144,2012,75855
26211,209,120,89,2012,75856
26212,38,20,18,2012,75858
26213,2324,1049,1275,2012,75859
26214,6205,3635,2570,2012,75860
26215,5166,4121,1045,2012,75861
26216,8412,4015,4397,2012,75862
26217,28785,14002,14783,2012,75901
26218,34585,16575,18010,2012,75904
26219,4609,2207,2402,2012,75925
26220,1219,578,641,2012,75926
26221,1134,541,593,2012,75928
26222,1553,654,899,2012,75929
26223,1545,676,869,2012,75930
26224,2323,1131,1192,2012,75931
26225,1546,746,800,2012,75932
26226,1193,552,641,2012,75933
26227,156,55,101,2012,75934
26228,13976,6848,7128,2012,75935
26229,988,536,452,2012,75936
26230,723,336,387,2012,75937
26231,2392,1161,1231,2012,75938
26232,3739,1833,1906,2012,75939
26233,9759,5268,4491,2012,75941
26234,147,46,101,2012,75942
26235,1170,654,516,2012,75943
26236,1250,586,664,2012,75944
26237,3446,1739,1707,2012,75946
26238,6068,2950,3118,2012,75948
26239,7480,3661,3819,2012,75949
26240,16120,8245,7875,2012,75951
26241,3098,1390,1708,2012,75954
26242,8201,3760,4441,2012,75956
26243,981,543,438,2012,75959
26244,908,471,437,2012,75960
26245,14883,6864,8019,2012,75961
26246,3526,1353,2173,2012,75962
26247,19780,9703,10077,2012,75964
26248,18454,9062,9392,2012,75965
26249,4425,2476,1949,2012,75966
26250,2012,1067,945,2012,75968
26251,3281,1569,1712,2012,75969
26252,6996,3319,3677,2012,75972
26253,2740,1449,1291,2012,75973
26254,3056,1480,1576,2012,75974
26255,3309,1738,1571,2012,75975
26256,855,393,462,2012,75976
26257,1266,572,694,2012,75977
26258,108,42,66,2012,75978
26259,11269,6537,4732,2012,75979
26260,2837,1430,1407,2012,75980
26261,31533,15441,16092,2012,76001
26262,30600,15013,15587,2012,76002
26263,23771,12799,10972,2012,76006
26264,13943,6806,7137,2012,76008
26265,19964,10490,9474,2012,76009
26266,54169,27798,26371,2012,76010
26267,22590,11680,10910,2012,76011
26268,24962,12118,12844,2012,76012
26269,31753,15858,15895,2012,76013
26270,34736,16533,18203,2012,76014
26271,15662,7247,8415,2012,76015
26272,31559,15311,16248,2012,76016
26273,43245,20902,22343,2012,76017
26274,27253,13309,13944,2012,76018
26275,27284,13798,13486,2012,76020
26276,33615,16200,17415,2012,76021
26277,13737,6768,6969,2012,76022
26278,6247,3235,3012,2012,76023
26279,60235,29668,30567,2012,76028
26280,16360,8373,7987,2012,76031
26281,24303,11583,12720,2012,76033
26282,23040,11167,11873,2012,76034
26283,1403,751,652,2012,76035
26284,21682,10812,10870,2012,76036
26285,32396,15723,16673,2012,76039
26286,28914,14670,14244,2012,76040
26287,280,134,146,2012,76041
26288,7377,3608,3769,2012,76043
26289,3908,2130,1778,2012,76044
26290,21471,10920,10551,2012,76048
26291,25069,11974,13095,2012,76049
26292,5912,2910,3002,2012,76050
26293,46496,22270,24226,2012,76051
26294,15990,7967,8023,2012,76052
26295,28663,14402,14261,2012,76053
26296,11222,5250,5972,2012,76054
26297,3224,1564,1660,2012,76055
26298,18491,8938,9553,2012,76058
26299,5187,2265,2922,2012,76059
26300,6993,3578,3415,2012,76060
26301,137,69,68,2012,76061
26302,60686,30119,30567,2012,76063
26303,1558,843,715,2012,76064
26304,28110,14274,13836,2012,76065
26305,3658,2012,1646,2012,76066
26306,21741,11824,9917,2012,76067
26307,628,292,336,2012,76070
26308,3450,1661,1789,2012,76071
26309,5004,2658,2346,2012,76073
26310,393,226,167,2012,76077
26311,8822,4507,4315,2012,76078
26312,18253,8952,9301,2012,76082
26313,8398,4730,3668,2012,76084
26314,8351,4314,4037,2012,76085
26315,20448,9374,11074,2012,76086
26316,24364,12218,12146,2012,76087
26317,11762,5984,5778,2012,76088
26318,26778,13601,13177,2012,76092
26319,2517,1278,1239,2012,76093
26320,8438,4603,3835,2012,76102
26321,14863,7775,7088,2012,76103
26322,15869,7888,7981,2012,76104
26323,21607,10206,11401,2012,76105
26324,36950,19127,17823,2012,76106
26325,25642,12738,12904,2012,76107
26326,37836,18534,19302,2012,76108
26327,21488,10070,11418,2012,76109
26328,31957,16425,15532,2012,76110
26329,20891,10684,10207,2012,76111
26330,38016,18067,19949,2012,76112
26331,24302,11876,12426,2012,76114
26332,20902,10286,10616,2012,76115
26333,47726,23351,24375,2012,76116
26334,31203,15825,15378,2012,76117
26335,14184,7110,7074,2012,76118
26336,41877,21621,20256,2012,76119
26337,16463,7175,9288,2012,76120
26338,30175,13953,16222,2012,76123
26339,19646,9306,10340,2012,76126
26340,1968,296,1672,2012,76127
26341,2735,1180,1555,2012,76129
26342,29512,13918,15594,2012,76131
26343,24978,11441,13537,2012,76132
26344,48069,22626,25443,2012,76133
26345,23985,11276,12709,2012,76134
26346,20209,9523,10686,2012,76135
26347,53252,26230,27022,2012,76137
26348,26381,12409,13972,2012,76140
26349,23919,11900,12019,2012,76148
26350,3136,1409,1727,2012,76155
26351,18541,9949,8592,2012,76164
26352,4542,2157,2385,2012,76177
26353,47335,23334,24001,2012,76179
26354,33325,16286,17039,2012,76180
26355,28996,13596,15400,2012,76182
26356,27210,12725,14485,2012,76201
26357,17732,9234,8498,2012,76205
26358,10384,4957,5427,2012,76207
26359,19233,9397,9836,2012,76208
26360,25487,12560,12927,2012,76209
26361,40132,20113,20019,2012,76210
26362,3348,1857,1491,2012,76225
26363,18909,9698,9211,2012,76226
26364,22013,10707,11306,2012,76227
26365,1089,572,517,2012,76228
26366,9898,4689,5209,2012,76230
26367,3471,1772,1699,2012,76233
26368,14949,7276,7673,2012,76234
26369,428,237,191,2012,76238
26370,1214,648,566,2012,76239
26371,26257,12894,13363,2012,76240
26372,59597,28580,31017,2012,76244
26373,1714,855,859,2012,76245
26374,12566,6259,6307,2012,76247
26375,35003,17564,17439,2012,76248
26376,6537,3059,3478,2012,76249
26377,912,432,480,2012,76250
26378,787,490,297,2012,76251
26379,3368,1805,1563,2012,76252
26380,194,93,101,2012,76253
26381,5336,2575,2761,2012,76255
26382,6093,3231,2862,2012,76258
26383,4847,2250,2597,2012,76259
26384,352,146,206,2012,76261
26385,29880,15275,14605,2012,76262
26386,43,24,19,2012,76263
26387,1084,548,536,2012,76264
26388,1638,783,855,2012,76265
26389,13477,6619,6858,2012,76266
26390,156,86,70,2012,76268
26391,1736,1018,718,2012,76270
26392,1217,585,632,2012,76271
26393,5007,2481,2526,2012,76272
26394,8570,4135,4435,2012,76273
26395,17137,8320,8817,2012,76301
26396,13216,6450,6766,2012,76302
26397,4659,2362,2297,2012,76305
26398,15103,7128,7975,2012,76306
26399,19586,9244,10342,2012,76308
26400,13099,6297,6802,2012,76309
26401,18369,9026,9343,2012,76310
26402,6073,4767,1306,2012,76311
26403,1682,815,867,2012,76351
26404,11090,5431,5659,2012,76354
26405,704,312,392,2012,76357
26406,3537,1623,1914,2012,76360
26407,278,172,106,2012,76363
26408,188,109,79,2012,76364
26409,5024,2518,2506,2012,76365
26410,2382,1179,1203,2012,76366
26411,14227,9243,4984,2012,76367
26412,312,148,164,2012,76370
26413,1531,745,786,2012,76371
26414,945,448,497,2012,76372
26415,231,105,126,2012,76373
26416,3883,1816,2067,2012,76374
26417,716,333,383,2012,76377
26418,755,402,353,2012,76379
26419,3805,1831,1974,2012,76380
26420,12815,6465,6350,2012,76384
26421,294,178,116,2012,76388
26422,1277,642,635,2012,76389
26423,25657,12163,13494,2012,76401
26424,947,482,465,2012,76402
26425,9016,4732,4284,2012,76424
26426,10625,5292,5333,2012,76426
26427,1040,582,458,2012,76427
26428,101,56,45,2012,76429
26429,2683,1319,1364,2012,76430
26430,3573,1721,1852,2012,76431
26431,1348,754,594,2012,76432
26432,1933,850,1083,2012,76433
26433,555,278,277,2012,76435
26434,151,74,77,2012,76436
26435,5614,2759,2855,2012,76437
26436,7804,3813,3991,2012,76442
26437,1930,997,933,2012,76443
26438,3355,1638,1717,2012,76444
26439,349,170,179,2012,76445
26440,8573,4646,3927,2012,76446
26441,5622,2786,2836,2012,76448
26442,2457,1133,1324,2012,76449
26443,13567,6712,6855,2012,76450
26444,70,39,31,2012,76452
26445,936,476,460,2012,76453
26446,1524,666,858,2012,76454
26447,905,453,452,2012,76455
26448,4106,2068,2038,2012,76457
26449,6220,3595,2625,2012,76458
26450,206,104,102,2012,76459
26451,376,238,138,2012,76460
26452,3256,1674,1582,2012,76462
26453,608,305,303,2012,76463
26454,355,189,166,2012,76464
26455,251,116,135,2012,76466
26456,55,34,21,2012,76469
26457,3569,1765,1804,2012,76470
26458,1703,870,833,2012,76471
26459,1532,728,804,2012,76472
26460,318,166,152,2012,76474
26461,961,456,505,2012,76475
26462,2899,1437,1462,2012,76476
26463,224,136,88,2012,76481
26464,885,447,438,2012,76483
26465,1044,568,476,2012,76484
26466,1406,761,645,2012,76486
26467,1835,965,870,2012,76487
26468,94,45,49,2012,76490
26469,597,334,263,2012,76491
26470,16109,7609,8500,2012,76501
26471,33426,16589,16837,2012,76502
26472,22583,11357,11226,2012,76504
26473,5,3,2,2012,76508
26474,2062,1124,938,2012,76511
26475,33555,16285,17270,2012,76513
26476,1481,651,830,2012,76518
26477,803,379,424,2012,76519
26478,7808,4000,3808,2012,76520
26479,36085,17243,18842,2012,76522
26480,0,0,0,2012,76523
26481,3014,1461,1553,2012,76524
26482,1114,552,562,2012,76525
26483,3633,1729,1904,2012,76527
26484,18619,8223,10396,2012,76528
26485,2345,1190,1155,2012,76530
26486,4938,2403,2535,2012,76531
26487,2055,1020,1035,2012,76534
26488,3803,1923,1880,2012,76537
26489,884,429,455,2012,76538
26490,7248,3495,3753,2012,76539
26491,18932,10042,8890,2012,76541
26492,39631,19405,20226,2012,76542
26493,29806,13843,15963,2012,76543
26494,35268,20785,14483,2012,76544
26495,26407,12941,13466,2012,76548
26496,45638,22264,23374,2012,76549
26497,12168,6126,6042,2012,76550
26498,1913,997,916,2012,76554
26499,1577,696,881,2012,76556
26500,4816,2388,2428,2012,76557
26501,4818,2160,2658,2012,76559
26502,859,373,486,2012,76561
26503,27,6,21,2012,76565
26504,195,70,125,2012,76566
26505,9198,4469,4729,2012,76567
26506,1992,962,1030,2012,76569
26507,2652,1401,1251,2012,76570
26508,5771,3011,2760,2012,76571
26509,45,21,24,2012,76573
26510,17775,8788,8987,2012,76574
26511,3468,1728,1740,2012,76577
26512,1714,929,785,2012,76578
26513,4693,2371,2322,2012,76579
26514,956,149,807,2012,76596
26515,1430,1289,141,2012,76597
26516,390,89,301,2012,76598
26517,1239,312,927,2012,76599
26518,1130,639,491,2012,76621
26519,1083,475,608,2012,76622
26520,165,74,91,2012,76623
26521,2151,1061,1090,2012,76624
26522,1922,873,1049,2012,76626
26523,1771,825,946,2012,76627
26524,93,37,56,2012,76628
26525,1816,831,985,2012,76629
26526,1925,1069,856,2012,76630
26527,478,240,238,2012,76631
26528,1506,771,735,2012,76632
26529,5570,2880,2690,2012,76633
26530,7054,3272,3782,2012,76634
26531,1493,867,626,2012,76635
26532,1515,764,751,2012,76636
26533,445,223,222,2012,76637
26534,2960,1519,1441,2012,76638
26535,1588,780,808,2012,76639
26536,3279,1786,1493,2012,76640
26537,1809,838,971,2012,76641
26538,7268,4337,2931,2012,76642
26539,13494,6543,6951,2012,76643
26540,11357,5656,5701,2012,76645
26541,2669,1209,1460,2012,76648
26542,705,374,331,2012,76649
26543,48,20,28,2012,76650
26544,3011,1473,1538,2012,76651
26545,895,463,432,2012,76652
26546,1034,550,484,2012,76653
26547,166,91,75,2012,76654
26548,9183,4670,4513,2012,76655
26549,2711,1313,1398,2012,76656
26550,8830,4160,4670,2012,76657
26551,405,192,213,2012,76660
26552,8419,3581,4838,2012,76661
26553,3374,1772,1602,2012,76664
26554,2545,1307,1238,2012,76665
26555,190,105,85,2012,76666
26556,11360,5427,5933,2012,76667
26557,1230,619,611,2012,76670
26558,2110,1085,1025,2012,76671
26559,1191,638,553,2012,76673
26560,504,284,220,2012,76676
26561,196,99,97,2012,76678
26562,1277,754,523,2012,76679
26563,399,193,206,2012,76680
26564,616,354,262,2012,76681
26565,2365,1158,1207,2012,76682
26566,42,19,23,2012,76685
26567,239,111,128,2012,76686
26568,1522,753,769,2012,76687
26569,3415,1738,1677,2012,76689
26570,1055,544,511,2012,76690
26571,6093,3041,3052,2012,76691
26572,9318,4405,4913,2012,76692
26573,1414,671,743,2012,76693
26574,1412,833,579,2012,76701
26575,8135,3721,4414,2012,76704
26576,28312,14419,13893,2012,76705
26577,35500,16994,18506,2012,76706
26578,15812,7938,7874,2012,76707
26579,25038,12068,12970,2012,76708
26580,23155,10699,12456,2012,76710
26581,8190,4182,4008,2012,76711
26582,23492,10983,12509,2012,76712
26583,1922,398,1524,2012,76798
26584,25035,12505,12530,2012,76801
26585,5342,2680,2662,2012,76802
26586,114,63,51,2012,76820
26587,4910,2374,2536,2012,76821
26588,3332,1501,1831,2012,76823
26589,0,0,0,2012,76824
26590,7227,3591,3636,2012,76825
26591,258,138,120,2012,76827
26592,184,90,94,2012,76828
26593,83,35,48,2012,76831
26594,571,349,222,2012,76832
26595,5744,2792,2952,2012,76834
26596,12,6,6,2012,76836
26597,3233,2317,916,2012,76837
26598,58,33,25,2012,76841
26599,87,50,37,2012,76842
26600,3730,1800,1930,2012,76844
26601,162,84,78,2012,76845
26602,82,39,43,2012,76848
26603,4153,2089,2064,2012,76849
26604,247,138,109,2012,76852
26605,1394,667,727,2012,76853
26606,189,85,104,2012,76854
26607,3678,1853,1825,2012,76856
26608,2010,900,1110,2012,76857
26609,203,112,91,2012,76858
26610,2064,1036,1028,2012,76859
26611,2076,1105,971,2012,76861
26612,309,157,152,2012,76862
26613,677,327,350,2012,76864
26614,153,75,78,2012,76865
26615,465,261,204,2012,76866
26616,20,12,8,2012,76869
26617,190,96,94,2012,76870
26618,799,393,406,2012,76871
26619,683,273,410,2012,76872
26620,81,47,34,2012,76873
26621,37,37,0,2012,76874
26622,714,328,386,2012,76875
26623,4515,2482,2033,2012,76877
26624,1804,950,854,2012,76878
26625,189,113,76,2012,76882
26626,212,129,83,2012,76884
26627,126,45,81,2012,76885
26628,119,73,46,2012,76887
26629,57,36,21,2012,76888
26630,940,462,478,2012,76890
26631,28149,13628,14521,2012,76901
26632,31457,15144,16313,2012,76903
26633,32199,15690,16509,2012,76904
26634,12434,5861,6573,2012,76905
26635,2381,1952,429,2012,76908
26636,160,73,87,2012,76930
26637,3504,1871,1633,2012,76932
26638,1405,674,731,2012,76933
26639,1122,675,447,2012,76934
26640,1587,775,812,2012,76935
26641,3253,1569,1684,2012,76936
26642,18,9,9,2012,76937
26643,90,56,34,2012,76939
26644,18,5,13,2012,76940
26645,1361,672,689,2012,76941
26646,3560,1812,1748,2012,76943
26647,1536,752,784,2012,76945
26648,6,6,0,2012,76949
26649,4142,1999,2143,2012,76950
26650,1223,658,565,2012,76951
26651,40,33,7,2012,76953
26652,0,0,0,2012,76955
26653,0,0,0,2012,76957
26654,267,150,117,2012,76958
26655,11473,9421,2052,2012,77002
26656,10215,5061,5154,2012,77003
26657,29853,14695,15158,2012,77004
26658,25740,13000,12740,2012,77005
26659,19856,11040,8816,2012,77006
26660,29545,15539,14006,2012,77007
26661,29424,14889,14535,2012,77008
26662,39050,19681,19369,2012,77009
26663,342,185,157,2012,77010
26664,19396,9855,9541,2012,77011
26665,21619,11537,10082,2012,77012
26666,19448,10846,8602,2012,77013
26667,29673,13859,15814,2012,77014
26668,54386,27622,26764,2012,77015
26669,27634,13066,14568,2012,77016
26670,33470,17770,15700,2012,77017
26671,27627,14155,13472,2012,77018
26672,19450,9784,9666,2012,77019
26673,26381,13417,12964,2012,77020
26674,25640,11890,13750,2012,77021
26675,29821,14806,15015,2012,77022
26676,30696,15874,14822,2012,77023
26677,34622,16490,18132,2012,77024
26678,25935,12492,13443,2012,77025
26679,23963,11469,12494,2012,77026
26680,14745,7142,7603,2012,77027
26681,16551,8335,8216,2012,77028
26682,17570,8560,9010,2012,77029
26683,11184,5413,5771,2012,77030
26684,17822,9254,8568,2012,77031
26685,13517,6200,7317,2012,77032
26686,28001,13119,14882,2012,77033
26687,34856,17349,17507,2012,77034
26688,35481,17159,18322,2012,77035
26689,67788,36099,31689,2012,77036
26690,20191,10240,9951,2012,77037
26691,27529,13598,13931,2012,77038
26692,27339,14295,13044,2012,77039
26693,43182,21428,21754,2012,77040
26694,36537,18840,17697,2012,77041
26695,34456,17384,17072,2012,77042
26696,22940,11256,11684,2012,77043
26697,31067,15209,15858,2012,77044
26698,32155,14763,17392,2012,77045
26699,1106,446,660,2012,77046
26700,21316,9711,11605,2012,77047
26701,15397,7459,7938,2012,77048
26702,29100,14622,14478,2012,77049
26703,4226,2350,1876,2012,77050
26704,14219,6497,7722,2012,77051
26705,30478,15144,15334,2012,77053
26706,21766,10921,10845,2012,77054
26707,43603,21163,22440,2012,77055
26708,16356,8295,8061,2012,77056
26709,39463,20016,19447,2012,77057
26710,16349,8511,7838,2012,77058
26711,18904,9242,9662,2012,77059
26712,44625,22524,22101,2012,77060
26713,24115,12613,11502,2012,77061
26714,25337,12225,13112,2012,77062
26715,36204,18198,18006,2012,77063
26716,43907,21462,22445,2012,77064
26717,35703,17666,18037,2012,77065
26718,31486,15704,15782,2012,77066
26719,29719,14044,15675,2012,77067
26720,10271,5040,5231,2012,77068
26721,15323,7848,7475,2012,77069
26722,45349,22502,22847,2012,77070
26723,26180,12585,13595,2012,77071
26724,54901,28176,26725,2012,77072
26725,36910,18788,18122,2012,77073
26726,35210,17120,18090,2012,77074
26727,38421,18722,19699,2012,77075
26728,33049,16403,16646,2012,77076
26729,53081,25325,27756,2012,77077
26730,15811,7396,8415,2012,77078
26731,30626,14619,16007,2012,77079
26732,48137,25563,22574,2012,77080
26733,42801,23625,19176,2012,77081
26734,49228,23678,25550,2012,77082
26735,71032,33145,37887,2012,77083
26736,98697,48737,49960,2012,77084
26737,16792,8328,8464,2012,77085
26738,27705,13305,14400,2012,77086
26739,38747,20240,18507,2012,77087
26740,51809,25270,26539,2012,77088
26741,50894,25202,25692,2012,77089
26742,33747,15738,18009,2012,77090
26743,23791,10802,12989,2012,77091
26744,34390,17143,17247,2012,77092
26745,42808,21828,20980,2012,77093
26746,8143,3868,4275,2012,77094
26747,65603,32133,33470,2012,77095
26748,33892,16252,17640,2012,77096
26749,12524,6722,5802,2012,77098
26750,46114,22694,23420,2012,77099
26751,0,0,0,2012,77201
26752,31298,16240,15058,2012,77301
26753,17637,8762,8875,2012,77302
26754,16629,7851,8778,2012,77303
26755,21155,10354,10801,2012,77304
26756,11973,5895,6078,2012,77306
26757,15082,8080,7002,2012,77316
26758,13446,6335,7111,2012,77318
26759,36204,24067,12137,2012,77320
26760,0,0,0,2012,77326
26761,19844,9955,9889,2012,77327
26762,15823,8077,7746,2012,77328
26763,6060,2949,3111,2012,77331
26764,143,95,48,2012,77334
26765,2860,1283,1577,2012,77335
26766,12116,5748,6368,2012,77336
26767,33298,16540,16758,2012,77338
26768,38532,19045,19487,2012,77339
26769,26017,13436,12581,2012,77340
26770,456,456,0,2012,77342
26771,28029,14102,13927,2012,77345
26772,53077,26476,26601,2012,77346
26773,96,46,50,2012,77350
26774,32780,18001,14779,2012,77351
26775,30449,15062,15387,2012,77354
26776,24317,11658,12659,2012,77355
26777,24116,11649,12467,2012,77356
26778,18831,9849,8982,2012,77357
26779,4763,2374,2389,2012,77358
26780,864,432,432,2012,77359
26781,4771,2411,2360,2012,77360
26782,5225,2610,2615,2012,77362
26783,3202,1636,1566,2012,77363
26784,2526,1377,1149,2012,77364
26785,26967,13602,13365,2012,77365
26786,210,83,127,2012,77367
26787,118,42,76,2012,77368
26788,1023,524,499,2012,77369
26789,8025,3519,4506,2012,77371
26790,12339,5959,6380,2012,77372
26791,55351,27795,27556,2012,77373
26792,418,194,224,2012,77374
26793,40815,20345,20470,2012,77375
26794,478,313,165,2012,77376
26795,29269,14838,14431,2012,77377
26796,14590,7675,6915,2012,77378
26797,71184,35943,35241,2012,77379
26798,23584,11632,11952,2012,77380
26799,36405,17629,18776,2012,77381
26800,35585,17504,18081,2012,77382
26801,11768,5617,6151,2012,77384
26802,19572,9978,9594,2012,77385
26803,38004,18534,19470,2012,77386
26804,40457,20322,20135,2012,77388
26805,22627,11360,11267,2012,77389
26806,43861,23016,20845,2012,77396
26807,17522,8840,8682,2012,77401
26808,34513,18480,16033,2012,77406
26809,29180,14133,15047,2012,77407
26810,96,22,74,2012,77412
26811,23618,11712,11906,2012,77414
26812,166,76,90,2012,77415
26813,2451,1147,1304,2012,77417
26814,9120,4441,4679,2012,77418
26815,1218,710,508,2012,77419
26816,1780,750,1030,2012,77420
26817,12919,7271,5648,2012,77422
26818,9342,4637,4705,2012,77423
26819,1864,1026,838,2012,77426
26820,0,0,0,2012,77428
26821,71439,34848,36591,2012,77429
26822,2287,1136,1151,2012,77430
26823,66,51,15,2012,77432
26824,51200,25052,26148,2012,77433
26825,4910,2125,2785,2012,77434
26826,4465,2231,2234,2012,77435
26827,0,0,0,2012,77436
26828,16975,8654,8321,2012,77437
26829,0,0,0,2012,77440
26830,5217,2501,2716,2012,77441
26831,774,390,384,2012,77442
26832,134,100,34,2012,77443
26833,944,414,530,2012,77444
26834,12165,6123,6042,2012,77445
26835,5156,2156,3000,2012,77446
26836,12555,6324,6231,2012,77447
26837,144,52,92,2012,77448
26838,90599,44703,45896,2012,77449
26839,69622,33593,36029,2012,77450
26840,63,35,28,2012,77451
26841,370,174,196,2012,77453
26842,356,214,142,2012,77454
26843,1936,1024,912,2012,77455
26844,1179,555,624,2012,77456
26845,527,293,234,2012,77457
26846,432,282,150,2012,77458
26847,55975,27203,28772,2012,77459
26848,91,62,29,2012,77460
26849,9294,4421,4873,2012,77461
26850,195,101,94,2012,77464
26851,6884,3510,3374,2012,77465
26852,1017,629,388,2012,77466
26853,85,56,29,2012,77467
26854,217,148,69,2012,77468
26855,34697,17510,17187,2012,77469
26856,250,150,100,2012,77470
26857,35604,16834,18770,2012,77471
26858,72,33,39,2012,77473
26859,12956,6581,6375,2012,77474
26860,767,348,419,2012,77475
26861,265,127,138,2012,77476
26862,35342,17415,17927,2012,77477
26863,23541,11582,11959,2012,77478
26864,74399,37129,37270,2012,77479
26865,8069,3930,4139,2012,77480
26866,2,0,2,2012,77481
26867,2125,920,1205,2012,77482
26868,368,105,263,2012,77483
26869,10921,5914,5007,2012,77484
26870,3637,1721,1916,2012,77485
26871,6538,3105,3433,2012,77486
26872,14659,6835,7824,2012,77488
26873,35577,16281,19296,2012,77489
26874,22695,11279,11416,2012,77493
26875,64378,31982,32396,2012,77494
26876,52084,25838,26246,2012,77498
26877,36263,17657,18606,2012,77502
26878,23914,11945,11969,2012,77503
26879,24514,12175,12339,2012,77504
26880,23243,11106,12137,2012,77505
26881,36710,18720,17990,2012,77506
26882,0,0,0,2012,77507
26883,14482,7353,7129,2012,77510
26884,46850,23702,23148,2012,77511
26885,4044,2105,1939,2012,77514
26886,29133,15038,14095,2012,77515
26887,5840,2917,2923,2012,77517
26888,7692,3877,3815,2012,77518
26889,1235,595,640,2012,77519
26890,37165,18225,18940,2012,77520
26891,49294,24129,25165,2012,77521
26892,18047,9015,9032,2012,77523
26893,30853,15138,15715,2012,77530
26894,15502,7861,7641,2012,77531
26895,26356,12913,13443,2012,77532
26896,866,423,443,2012,77533
26897,2932,1395,1537,2012,77534
26898,30816,14956,15860,2012,77535
26899,30891,14744,16147,2012,77536
26900,1185,598,587,2012,77538
26901,39360,19429,19931,2012,77539
26902,17486,9213,8273,2012,77541
26903,19440,8848,10592,2012,77545
26904,47815,23574,24241,2012,77546
26905,9975,4855,5120,2012,77547
26906,22252,10595,11657,2012,77550
26907,18629,8917,9712,2012,77551
26908,9309,4732,4577,2012,77554
26909,968,467,501,2012,77560
26910,86,24,62,2012,77561
26911,10861,5607,5254,2012,77562
26912,9488,4868,4620,2012,77563
26913,1911,987,924,2012,77564
26914,5683,2937,2746,2012,77565
26915,28291,13480,14811,2012,77566
26916,14556,7067,7489,2012,77568
26917,35787,18504,17283,2012,77571
26918,71418,36340,35078,2012,77573
26919,15878,7957,7921,2012,77575
26920,1377,663,714,2012,77577
26921,13113,6564,6549,2012,77578
26922,383,183,200,2012,77580
26923,41981,21007,20974,2012,77581
26924,29698,18037,11661,2012,77583
26925,71277,33784,37493,2012,77584
26926,1412,711,701,2012,77585
26927,21563,10659,10904,2012,77586
26928,16648,8590,8058,2012,77587
26929,30607,14692,15915,2012,77590
26930,13123,5944,7179,2012,77591
26931,400,195,205,2012,77597
26932,24074,12016,12058,2012,77598
26933,8481,4101,4380,2012,77611
26934,8376,3929,4447,2012,77612
26935,740,324,416,2012,77613
26936,502,263,239,2012,77614
26937,853,433,420,2012,77615
26938,1035,505,530,2012,77616
26939,155,103,52,2012,77617
26940,16001,7983,8018,2012,77619
26941,1519,796,723,2012,77622
26942,809,440,369,2012,77623
26943,1314,719,595,2012,77624
26944,8030,4045,3985,2012,77625
26945,21746,10869,10877,2012,77627
26946,803,454,349,2012,77629
26947,26984,13503,13481,2012,77630
26948,24410,11898,12512,2012,77632
26949,16447,7813,8634,2012,77640
26950,37560,18561,18999,2012,77642
26951,1477,859,618,2012,77650
26952,12971,6376,6595,2012,77651
26953,319,175,144,2012,77655
26954,17353,8356,8997,2012,77656
26955,20317,10101,10216,2012,77657
26956,4677,2265,2412,2012,77659
26957,1222,557,665,2012,77660
26958,871,538,333,2012,77661
26959,26756,13599,13157,2012,77662
26960,881,418,463,2012,77663
26961,3228,1682,1546,2012,77664
26962,5424,2512,2912,2012,77665
26963,15453,7730,7723,2012,77701
26964,2583,1253,1330,2012,77702
26965,16240,7095,9145,2012,77703
26966,40192,26437,13755,2012,77705
26967,28379,13517,14862,2012,77706
26968,17055,7486,9569,2012,77707
26969,10889,5335,5554,2012,77708
26970,11736,5925,5811,2012,77713
26971,13826,7702,6124,2012,77801
26972,23804,11329,12475,2012,77802
26973,30378,14651,15727,2012,77803
26974,10895,6036,4859,2012,77807
26975,11008,5114,5894,2012,77808
26976,2646,1300,1346,2012,77830
26977,4139,2241,1898,2012,77831
26978,28399,14106,14293,2012,77833
26979,2059,997,1062,2012,77835
26980,11722,5874,5848,2012,77836
26981,1697,740,957,2012,77837
26982,55364,29179,26185,2012,77840
26983,49208,24405,24803,2012,77845
26984,1027,538,489,2012,77853
26985,86,54,32,2012,77855
26986,4566,2379,2187,2012,77856
26987,1019,534,485,2012,77857
26988,6720,3430,3290,2012,77859
26989,2861,1361,1500,2012,77861
26990,6875,3180,3695,2012,77864
26991,1473,892,581,2012,77865
26992,83,41,42,2012,77867
26993,14398,8352,6046,2012,77868
26994,3373,1650,1723,2012,77871
26995,1607,702,905,2012,77872
26996,1504,713,791,2012,77873
26997,67,18,49,2012,77876
26998,657,318,339,2012,77878
26999,4399,2131,2268,2012,77879
27000,1596,674,922,2012,77880
27001,42032,20160,21872,2012,77901
27002,24884,12641,12243,2012,77904
27003,14365,7004,7361,2012,77905
27004,174,91,83,2012,77950
27005,2256,1097,1159,2012,77951
27006,11159,6119,5040,2012,77954
27007,8263,3920,4343,2012,77957
27008,0,0,0,2012,77960
27009,103,18,85,2012,77961
27010,3784,1952,1832,2012,77962
27011,5692,2863,2829,2012,77963
27012,8059,3906,4153,2012,77964
27013,2553,1125,1428,2012,77968
27014,200,84,116,2012,77969
27015,265,112,153,2012,77970
27016,548,263,285,2012,77971
27017,54,37,17,2012,77973
27018,490,220,270,2012,77974
27019,1918,948,970,2012,77975
27020,156,81,75,2012,77976
27021,463,227,236,2012,77977
27022,716,396,320,2012,77978
27023,17577,8724,8853,2012,77979
27024,1195,658,537,2012,77982
27025,1868,978,890,2012,77983
27026,4247,2149,2098,2012,77984
27027,139,79,60,2012,77987
27028,570,295,275,2012,77988
27029,703,307,396,2012,77990
27030,332,196,136,2012,77991
27031,268,169,99,2012,77993
27032,400,183,217,2012,77994
27033,9222,4385,4837,2012,77995
27034,0,0,0,2012,78001
27035,8556,4235,4321,2012,78002
27036,8316,4132,4184,2012,78003
27037,1288,717,571,2012,78004
27038,289,166,123,2012,78005
27039,27475,13578,13897,2012,78006
27040,74,62,12,2012,78007
27041,357,150,207,2012,78008
27042,7958,3698,4260,2012,78009
27043,2663,1174,1489,2012,78010
27044,1652,788,864,2012,78011
27045,454,249,205,2012,78012
27046,5316,2612,2704,2012,78013
27047,5391,2979,2412,2012,78014
27048,9762,4912,4850,2012,78015
27049,9825,4870,4955,2012,78016
27050,4452,3066,1386,2012,78017
27051,1436,792,644,2012,78019
27052,268,129,139,2012,78021
27053,4631,2243,2388,2012,78022
27054,26128,12798,13330,2012,78023
27055,1125,528,597,2012,78024
27056,4936,2496,2440,2012,78025
27057,5731,2891,2840,2012,78026
27058,267,141,126,2012,78027
27059,39183,19159,20024,2012,78028
27060,0,0,0,2012,78029
27061,1618,755,863,2012,78039
27062,41281,18667,22614,2012,78040
27063,45082,21845,23237,2012,78041
27064,43155,20507,22648,2012,78043
27065,93,82,11,2012,78044
27066,56056,27720,28336,2012,78045
27067,63268,31912,31356,2012,78046
27068,655,332,323,2012,78050
27069,6525,2923,3602,2012,78052
27070,1863,826,1037,2012,78055
27071,1784,859,925,2012,78056
27072,962,489,473,2012,78057
27073,1027,402,625,2012,78058
27074,5192,2709,2483,2012,78059
27075,0,0,0,2012,78060
27076,11679,6384,5295,2012,78061
27077,9329,4589,4740,2012,78063
27078,13391,6824,6567,2012,78064
27079,12306,5993,6313,2012,78065
27080,873,386,487,2012,78066
27081,483,181,302,2012,78067
27082,5462,2772,2690,2012,78069
27083,14151,7012,7139,2012,78070
27084,4506,2871,1635,2012,78071
27085,604,337,267,2012,78072
27086,7434,3583,3851,2012,78073
27087,98,61,37,2012,78075
27088,13400,6780,6620,2012,78076
27089,8216,4078,4138,2012,78101
27090,27462,17000,10462,2012,78102
27091,199,110,89,2012,78104
27092,271,105,166,2012,78107
27093,28572,14038,14534,2012,78108
27094,36406,17722,18684,2012,78109
27095,7724,3576,4148,2012,78112
27096,2548,1238,1310,2012,78113
27097,20411,10182,10229,2012,78114
27098,330,199,131,2012,78116
27099,743,336,407,2012,78117
27100,3994,2435,1559,2012,78118
27101,7625,5013,2612,2012,78119
27102,10847,5136,5711,2012,78121
27103,345,200,145,2012,78122
27104,2362,1203,1159,2012,78123
27105,5199,2574,2625,2012,78124
27106,117,85,32,2012,78125
27107,59519,29031,30488,2012,78130
27108,20047,10225,9822,2012,78132
27109,15635,7453,8182,2012,78133
27110,3270,1557,1713,2012,78140
27111,797,407,390,2012,78141
27112,233,121,112,2012,78142
27113,80,32,48,2012,78143
27114,10,5,5,2012,78144
27115,102,42,60,2012,78145
27116,1003,513,490,2012,78146
27117,1867,973,894,2012,78147
27118,19855,9810,10045,2012,78148
27119,64,64,0,2012,78150
27120,1284,620,664,2012,78151
27121,2410,1133,1277,2012,78152
27122,30263,14355,15908,2012,78154
27123,46248,22693,23555,2012,78155
27124,910,439,471,2012,78159
27125,4486,2161,2325,2012,78160
27126,848,443,405,2012,78161
27127,353,207,146,2012,78162
27128,10348,5210,5138,2012,78163
27129,4059,2060,1999,2012,78164
27130,43310,21941,21369,2012,78201
27131,12837,6141,6696,2012,78202
27132,5639,2920,2719,2012,78203
27133,11326,5912,5414,2012,78204
27134,910,579,331,2012,78205
27135,54100,28375,25725,2012,78207
27136,3384,1751,1633,2012,78208
27137,39744,18827,20917,2012,78209
27138,37215,17941,19274,2012,78210
27139,33239,16888,16351,2012,78211
27140,28318,13771,14547,2012,78212
27141,41789,19342,22447,2012,78213
27142,23641,11575,12066,2012,78214
27143,1216,816,400,2012,78215
27144,37759,18408,19351,2012,78216
27145,32145,15932,16213,2012,78217
27146,31813,14931,16882,2012,78218
27147,14620,6725,7895,2012,78219
27148,17109,7181,9928,2012,78220
27149,36057,17365,18692,2012,78221
27150,21321,9837,11484,2012,78222
27151,50158,24683,25475,2012,78223
27152,17728,8683,9045,2012,78224
27153,13917,6483,7434,2012,78225
27154,6603,3236,3367,2012,78226
27155,45046,21561,23485,2012,78227
27156,55936,27223,28713,2012,78228
27157,28647,13734,14913,2012,78229
27158,39047,18819,20228,2012,78230
27159,7843,3969,3874,2012,78231
27160,36367,17425,18942,2012,78232
27161,45726,22268,23458,2012,78233
27162,7146,4232,2914,2012,78234
27163,681,389,292,2012,78235
27164,8609,6577,2032,2012,78236
27165,36131,17641,18490,2012,78237
27166,25054,11857,13197,2012,78238
27167,27870,13623,14247,2012,78239
27168,51367,24950,26417,2012,78240
27169,32900,15940,16960,2012,78242
27170,253,156,97,2012,78243
27171,31353,14550,16803,2012,78244
27172,57534,28833,28701,2012,78245
27173,49568,24461,25107,2012,78247
27174,14490,6942,7548,2012,78248
27175,48874,23607,25267,2012,78249
27176,55461,26786,28675,2012,78250
27177,51095,25549,25546,2012,78251
27178,7562,5264,2298,2012,78252
27179,28410,14096,14314,2012,78253
27180,44109,21873,22236,2012,78254
27181,10721,5069,5652,2012,78255
27182,6878,3849,3029,2012,78256
27183,3779,1977,1802,2012,78257
27184,40949,18990,21959,2012,78258
27185,21791,10537,11254,2012,78259
27186,24087,11607,12480,2012,78260
27187,13121,6965,6156,2012,78261
27188,4358,2285,2073,2012,78263
27189,13425,6932,6493,2012,78264
27190,5497,2767,2730,2012,78266
27191,672,334,338,2012,78330
27192,28841,14525,14316,2012,78332
27193,0,0,0,2012,78335
27194,11683,5681,6002,2012,78336
27195,0,0,0,2012,78338
27196,792,323,469,2012,78339
27197,432,246,186,2012,78340
27198,2711,1337,1374,2012,78341
27199,469,268,201,2012,78342
27200,4561,2257,2304,2012,78343
27201,501,231,270,2012,78344
27202,491,245,246,2012,78349
27203,494,240,254,2012,78351
27204,237,140,97,2012,78352
27205,553,327,226,2012,78353
27206,6954,3377,3577,2012,78355
27207,2989,1500,1489,2012,78357
27208,652,312,340,2012,78358
27209,1877,935,942,2012,78359
27210,5314,2923,2391,2012,78361
27211,9642,4946,4696,2012,78362
27212,30318,15485,14833,2012,78363
27213,9297,4474,4823,2012,78368
27214,373,196,177,2012,78369
27215,4355,2259,2096,2012,78370
27216,426,218,208,2012,78371
27217,5618,2492,3126,2012,78372
27218,3685,1836,1849,2012,78373
27219,16609,8234,8375,2012,78374
27220,3158,1728,1430,2012,78375
27221,589,362,227,2012,78376
27222,3626,1812,1814,2012,78377
27223,1469,694,775,2012,78379
27224,23351,11573,11778,2012,78380
27225,20213,9882,10331,2012,78382
27226,3152,1555,1597,2012,78383
27227,6131,3222,2909,2012,78384
27228,366,154,212,2012,78385
27229,9521,5114,4407,2012,78387
27230,1542,752,790,2012,78389
27231,6100,2854,3246,2012,78390
27232,409,193,216,2012,78391
27233,2521,1222,1299,2012,78393
27234,5022,2860,2162,2012,78401
27235,597,375,222,2012,78402
27236,14779,7233,7546,2012,78404
27237,14777,7509,7268,2012,78405
27238,1185,764,421,2012,78406
27239,2725,1361,1364,2012,78407
27240,11639,5393,6246,2012,78408
27241,3036,1512,1524,2012,78409
27242,27088,13748,13340,2012,78410
27243,28204,13085,15119,2012,78411
27244,38632,18848,19784,2012,78412
27245,36439,17517,18922,2012,78413
27246,32473,16711,15762,2012,78414
27247,39738,19302,20436,2012,78415
27248,14539,6448,8091,2012,78416
27249,4280,2276,2004,2012,78417
27250,30893,15061,15832,2012,78418
27251,689,323,366,2012,78419
27252,62071,30003,32068,2012,78501
27253,20691,9793,10898,2012,78503
27254,49605,24744,24861,2012,78504
27255,36724,18684,18040,2012,78516
27256,59742,28390,31352,2012,78520
27257,90752,42806,47946,2012,78521
27258,44808,21866,22942,2012,78526
27259,700,351,349,2012,78535
27260,415,243,172,2012,78536
27261,36096,17290,18806,2012,78537
27262,11260,5483,5777,2012,78538
27263,31827,15519,16308,2012,78539
27264,42904,21486,21418,2012,78541
27265,64876,32986,31890,2012,78542
27266,8087,4170,3917,2012,78543
27267,276,137,139,2012,78545
27268,512,253,259,2012,78548
27269,531,177,354,2012,78549
27270,51229,24625,26604,2012,78550
27271,36600,17610,18990,2012,78552
27272,12520,5570,6950,2012,78557
27273,823,348,475,2012,78558
27274,12238,5907,6331,2012,78559
27275,4180,2018,2162,2012,78560
27276,436,231,205,2012,78561
27277,2005,1137,868,2012,78562
27278,152,111,41,2012,78563
27279,22,10,12,2012,78564
27280,322,165,157,2012,78565
27281,17151,8538,8613,2012,78566
27282,623,289,334,2012,78567
27283,3583,1902,1681,2012,78569
27284,29612,13727,15885,2012,78570
27285,73032,35184,37848,2012,78572
27286,35169,17313,17856,2012,78573
27287,59525,29080,30445,2012,78574
27288,9255,4132,5123,2012,78575
27289,9541,4830,4711,2012,78576
27290,70528,33688,36840,2012,78577
27291,11245,5401,5844,2012,78578
27292,4576,2066,2510,2012,78579
27293,15469,8428,7041,2012,78580
27294,40729,20232,20497,2012,78582
27295,5779,3086,2693,2012,78583
27296,18225,8278,9947,2012,78584
27297,415,172,243,2012,78585
27298,56581,27765,28816,2012,78586
27299,219,115,104,2012,78588
27300,37441,18441,19000,2012,78589
27301,308,151,157,2012,78590
27302,148,68,80,2012,78591
27303,1069,467,602,2012,78592
27304,5090,2550,2540,2012,78593
27305,1955,999,956,2012,78594
27306,5696,2813,2883,2012,78595
27307,64987,30825,34162,2012,78596
27308,2957,1624,1333,2012,78597
27309,297,138,159,2012,78598
27310,25594,13455,12139,2012,78602
27311,4925,2322,2603,2012,78605
27312,5117,2591,2526,2012,78606
27313,85,45,40,2012,78607
27314,268,96,172,2012,78608
27315,1541,766,775,2012,78609
27316,24313,12788,11525,2012,78610
27317,13137,6502,6635,2012,78611
27318,11564,5859,5705,2012,78612
27319,65178,31955,33223,2012,78613
27320,708,374,334,2012,78614
27321,814,429,385,2012,78615
27322,6289,3246,3043,2012,78616
27323,19553,10377,9176,2012,78617
27324,255,129,126,2012,78618
27325,3504,1853,1651,2012,78619
27326,14483,7620,6863,2012,78620
27327,21352,10797,10555,2012,78621
27328,241,153,88,2012,78622
27329,742,376,366,2012,78623
27330,21472,10351,11121,2012,78624
27331,27412,14287,13125,2012,78626
27332,23288,11412,11876,2012,78628
27333,11565,5786,5779,2012,78629
27334,2114,1086,1028,2012,78631
27335,864,456,408,2012,78632
27336,17556,8352,9204,2012,78633
27337,22731,10704,12027,2012,78634
27338,107,37,70,2012,78635
27339,4103,2151,1952,2012,78636
27340,2060,1137,923,2012,78638
27341,7142,3537,3605,2012,78639
27342,42080,20612,21468,2012,78640
27343,47490,23672,23818,2012,78641
27344,9175,4483,4692,2012,78642
27345,6484,2979,3505,2012,78643
27346,16820,8646,8174,2012,78644
27347,10012,5183,4829,2012,78645
27348,7971,3601,4370,2012,78648
27349,1622,837,785,2012,78650
27350,4687,2147,2540,2012,78652
27351,15783,8028,7755,2012,78653
27352,16771,8294,8477,2012,78654
27353,3684,1797,1887,2012,78655
27354,2445,1275,1170,2012,78656
27355,5959,2853,3106,2012,78657
27356,2799,1557,1242,2012,78659
27357,70407,34445,35962,2012,78660
27358,260,146,114,2012,78661
27359,2818,1538,1280,2012,78662
27360,783,352,431,2012,78663
27361,54864,26549,28315,2012,78664
27362,33133,16104,17029,2012,78665
27363,63255,31719,31536,2012,78666
27364,8737,4490,4247,2012,78669
27365,420,279,141,2012,78670
27366,865,432,433,2012,78671
27367,935,555,380,2012,78672
27368,247,161,86,2012,78675
27369,12177,5517,6660,2012,78676
27370,112,68,44,2012,78677
27371,53229,26575,26654,2012,78681
27372,5642,3183,2459,2012,78701
27373,21032,10748,10284,2012,78702
27374,19873,10095,9778,2012,78703
27375,41709,21537,20172,2012,78704
27376,30532,15539,14993,2012,78705
27377,554,258,296,2012,78712
27378,23514,11934,11580,2012,78717
27379,1717,985,732,2012,78719
27380,11178,5220,5958,2012,78721
27381,5973,3283,2690,2012,78722
27382,30999,15459,15540,2012,78723
27383,21677,11541,10136,2012,78724
27384,6477,3424,3053,2012,78725
27385,12482,5967,6515,2012,78726
27386,28461,14020,14441,2012,78727
27387,20939,10457,10482,2012,78728
27388,28228,13337,14891,2012,78729
27389,8312,4377,3935,2012,78730
27390,24716,11609,13107,2012,78731
27391,14307,7174,7133,2012,78732
27392,9486,4584,4902,2012,78733
27393,17824,9059,8765,2012,78734
27394,16882,7754,9128,2012,78735
27395,6841,3478,3363,2012,78736
27396,12882,6249,6633,2012,78737
27397,12457,6227,6230,2012,78738
27398,16911,8032,8879,2012,78739
27399,48246,25965,22281,2012,78741
27400,901,420,481,2012,78742
27401,43452,22027,21425,2012,78744
27402,54917,27274,27643,2012,78745
27403,26939,13094,13845,2012,78746
27404,14158,7443,6715,2012,78747
27405,40290,20138,20152,2012,78748
27406,34391,16615,17776,2012,78749
27407,27119,13892,13227,2012,78750
27408,14340,7517,6823,2012,78751
27409,17170,9445,7725,2012,78752
27410,52384,26962,25422,2012,78753
27411,13570,6996,6574,2012,78754
27412,8060,4387,3673,2012,78756
27413,22718,11294,11424,2012,78757
27414,45105,23239,21866,2012,78758
27415,39850,19602,20248,2012,78759
27416,22124,10655,11469,2012,78801
27417,614,348,266,2012,78802
27418,1714,813,901,2012,78827
27419,168,54,114,2012,78828
27420,1108,468,640,2012,78829
27421,698,364,334,2012,78830
27422,3574,1869,1705,2012,78832
27423,1434,762,672,2012,78833
27424,7426,3611,3815,2012,78834
27425,31,14,17,2012,78836
27426,223,105,118,2012,78837
27427,175,84,91,2012,78838
27428,8598,4378,4220,2012,78839
27429,48064,24031,24033,2012,78840
27430,204,204,0,2012,78843
27431,1240,544,696,2012,78850
27432,30,20,10,2012,78851
27433,53307,25945,27362,2012,78852
27434,158,64,94,2012,78860
27435,13545,8011,5534,2012,78861
27436,897,483,414,2012,78870
27437,76,39,37,2012,78871
27438,2072,991,1081,2012,78872
27439,1767,913,854,2012,78873
27440,642,379,263,2012,78877
27441,179,89,90,2012,78879
27442,1870,909,961,2012,78880
27443,2048,993,1055,2012,78881
27444,232,94,138,2012,78883
27445,873,432,441,2012,78884
27446,89,56,33,2012,78885
27447,607,300,307,2012,78886
27448,130,54,76,2012,78931
27449,475,254,221,2012,78932
27450,1325,733,592,2012,78933
27451,6535,3245,3290,2012,78934
27452,1206,637,569,2012,78935
27453,646,379,267,2012,78938
27454,2009,1020,989,2012,78940
27455,2877,1361,1516,2012,78941
27456,8522,4204,4318,2012,78942
27457,330,179,151,2012,78943
27458,716,386,330,2012,78944
27459,10762,5062,5700,2012,78945
27460,923,471,452,2012,78946
27461,5030,2533,2497,2012,78947
27462,802,400,402,2012,78948
27463,284,137,147,2012,78949
27464,2465,1302,1163,2012,78950
27465,38,22,16,2012,78951
27466,861,396,465,2012,78953
27467,1290,612,678,2012,78954
27468,5292,2672,2620,2012,78956
27469,8487,4091,4396,2012,78957
27470,1910,970,940,2012,78959
27471,4641,2464,2177,2012,78962
27472,791,415,376,2012,78963
27473,224,104,120,2012,79001
27474,224,119,105,2012,79003
27475,1627,847,780,2012,79005
27476,14381,7260,7121,2012,79007
27477,2117,1088,1029,2012,79009
27478,760,341,419,2012,79010
27479,268,134,134,2012,79011
27480,1053,641,412,2012,79012
27481,3158,1700,1458,2012,79013
27482,3836,1921,1915,2012,79014
27483,19935,9480,10455,2012,79015
27484,91,0,91,2012,79016
27485,535,267,268,2012,79018
27486,1607,767,840,2012,79019
27487,132,56,76,2012,79021
27488,10744,6123,4621,2012,79022
27489,407,235,172,2012,79024
27490,44,10,34,2012,79025
27491,5049,2494,2555,2012,79027
27492,16191,8237,7954,2012,79029
27493,1362,729,633,2012,79031
27494,69,40,29,2012,79032
27495,30,16,14,2012,79033
27496,741,369,372,2012,79034
27497,5352,2668,2684,2012,79035
27498,5246,2481,2765,2012,79036
27499,733,409,324,2012,79039
27500,1746,963,783,2012,79040
27501,3310,1569,1741,2012,79041
27502,1124,590,534,2012,79042
27503,1587,813,774,2012,79043
27504,619,353,266,2012,79044
27505,19628,9769,9859,2012,79045
27506,458,217,241,2012,79046
27507,25,17,8,2012,79051
27508,1113,560,553,2012,79052
27509,107,67,40,2012,79053
27510,350,200,150,2012,79054
27511,48,20,28,2012,79056
27512,1167,583,584,2012,79057
27513,0,0,0,2012,79058
27514,926,449,477,2012,79059
27515,472,254,218,2012,79061
27516,332,151,181,2012,79062
27517,625,282,343,2012,79063
27518,2609,1297,1312,2012,79064
27519,21324,11174,10150,2012,79065
27520,3054,1480,1574,2012,79068
27521,10193,5192,5001,2012,79070
27522,28706,15267,13439,2012,79072
27523,392,260,132,2012,79078
27524,2483,1204,1279,2012,79079
27525,673,342,331,2012,79080
27526,3856,1909,1947,2012,79081
27527,423,200,223,2012,79082
27528,2321,1128,1193,2012,79083
27529,2486,1234,1252,2012,79084
27530,69,46,23,2012,79085
27531,2336,1145,1191,2012,79086
27532,855,464,391,2012,79087
27533,5881,3270,2611,2012,79088
27534,97,32,65,2012,79091
27535,1076,535,541,2012,79092
27536,24,7,17,2012,79093
27537,109,71,38,2012,79094
27538,2645,1290,1355,2012,79095
27539,2097,1035,1062,2012,79096
27540,1279,620,659,2012,79097
27541,423,198,225,2012,79098
27542,2345,1170,1175,2012,79101
27543,9449,4866,4583,2012,79102
27544,11831,5714,6117,2012,79103
27545,7498,3959,3539,2012,79104
27546,0,0,0,2012,79105
27547,28325,13825,14500,2012,79106
27548,34568,17299,17269,2012,79107
27549,16698,9615,7083,2012,79108
27550,43583,21100,22483,2012,79109
27551,18314,8954,9360,2012,79110
27552,1559,824,735,2012,79111
27553,19322,10010,9312,2012,79118
27554,11054,5357,5697,2012,79119
27555,6724,3156,3568,2012,79121
27556,9019,4616,4403,2012,79124
27557,7097,4240,2857,2012,79201
27558,174,88,86,2012,79220
27559,876,472,404,2012,79225
27560,3074,1520,1554,2012,79226
27561,1317,619,698,2012,79227
27562,391,193,198,2012,79229
27563,220,140,80,2012,79230
27564,10,3,7,2012,79231
27565,175,66,109,2012,79233
27566,81,48,33,2012,79234
27567,3758,1744,2014,2012,79235
27568,188,99,89,2012,79236
27569,554,296,258,2012,79237
27570,196,100,96,2012,79239
27571,82,46,36,2012,79240
27572,2556,1338,1218,2012,79241
27573,93,39,54,2012,79243
27574,548,299,249,2012,79244
27575,2153,1087,1066,2012,79245
27576,43,27,16,2012,79247
27577,1577,727,850,2012,79248
27578,1374,640,734,2012,79250
27579,72,48,24,2012,79251
27580,3288,1553,1735,2012,79252
27581,489,219,270,2012,79255
27582,395,223,172,2012,79256
27583,1248,685,563,2012,79257
27584,36,27,9,2012,79258
27585,186,84,102,2012,79259
27586,659,331,328,2012,79261
27587,3595,1737,1858,2012,79311
27588,1081,451,630,2012,79312
27589,1495,751,744,2012,79313
27590,73,37,36,2012,79314
27591,11226,6157,5069,2012,79316
27592,2116,1057,1059,2012,79322
27593,6002,2853,3149,2012,79323
27594,3,1,2,2012,79324
27595,2307,1234,1073,2012,79325
27596,0,0,0,2012,79326
27597,3635,1827,1808,2012,79329
27598,64,31,33,2012,79330
27599,13163,7809,5354,2012,79331
27600,17183,8466,8717,2012,79336
27601,7158,3596,3562,2012,79339
27602,593,324,269,2012,79342
27603,1445,724,721,2012,79343
27604,40,19,21,2012,79344
27605,967,536,431,2012,79345
27606,2426,1217,1209,2012,79346
27607,7304,3876,3428,2012,79347
27608,311,182,129,2012,79350
27609,1479,687,792,2012,79351
27610,6,3,3,2012,79353
27611,2267,1169,1098,2012,79355
27612,6205,3973,2232,2012,79356
27613,2376,1091,1285,2012,79357
27614,1120,593,527,2012,79358
27615,2902,1477,1425,2012,79359
27616,13582,6908,6674,2012,79360
27617,5104,2466,2638,2012,79363
27618,8188,3984,4204,2012,79364
27619,1218,604,614,2012,79366
27620,678,349,329,2012,79367
27621,120,60,60,2012,79369
27622,1891,1077,814,2012,79370
27623,1301,645,656,2012,79371
27624,1232,620,612,2012,79372
27625,3371,1753,1618,2012,79373
27626,76,35,41,2012,79376
27627,208,102,106,2012,79377
27628,300,129,171,2012,79378
27629,613,291,322,2012,79379
27630,283,145,138,2012,79380
27631,1223,613,610,2012,79381
27632,6047,2942,3105,2012,79382
27633,6398,3668,2730,2012,79401
27634,18083,9158,8925,2012,79403
27635,10833,5674,5159,2012,79404
27636,7282,3875,3407,2012,79406
27637,17612,8600,9012,2012,79407
27638,9078,4647,4431,2012,79410
27639,8326,3941,4385,2012,79411
27640,15800,7550,8250,2012,79412
27641,20008,9430,10578,2012,79413
27642,18265,8654,9611,2012,79414
27643,17178,8634,8544,2012,79415
27644,31849,15879,15970,2012,79416
27645,32937,15966,16971,2012,79423
27646,40330,19867,20463,2012,79424
27647,3361,1551,1810,2012,79501
27648,1234,675,559,2012,79502
27649,134,70,64,2012,79503
27650,2853,1443,1410,2012,79504
27651,431,179,252,2012,79505
27652,818,444,374,2012,79506
27653,1284,625,659,2012,79508
27654,7974,3800,4174,2012,79510
27655,998,453,545,2012,79511
27656,8268,5254,3014,2012,79512
27657,232,104,128,2012,79517
27658,159,73,86,2012,79518
27659,110,40,70,2012,79519
27660,2333,1101,1232,2012,79520
27661,3760,1805,1955,2012,79521
27662,2268,1125,1143,2012,79525
27663,986,534,452,2012,79526
27664,269,174,95,2012,79527
27665,602,292,310,2012,79528
27666,1330,642,688,2012,79529
27667,495,256,239,2012,79530
27668,913,498,415,2012,79532
27669,461,227,234,2012,79533
27670,229,160,69,2012,79534
27671,105,66,39,2012,79535
27672,4127,1924,2203,2012,79536
27673,116,60,56,2012,79537
27674,180,74,106,2012,79538
27675,196,123,73,2012,79539
27676,103,67,36,2012,79540
27677,754,319,435,2012,79541
27678,1123,528,595,2012,79543
27679,380,184,196,2012,79544
27680,1749,836,913,2012,79545
27681,2015,1014,1001,2012,79546
27682,833,463,370,2012,79547
27683,195,113,82,2012,79548
27684,15497,8191,7306,2012,79549
27685,3560,1532,2028,2012,79553
27686,13001,6450,6551,2012,79556
27687,108,62,46,2012,79560
27688,529,290,239,2012,79561
27689,4034,2082,1952,2012,79562
27690,1222,610,612,2012,79563
27691,237,99,138,2012,79565
27692,290,151,139,2012,79566
27693,3313,1673,1640,2012,79567
27694,26920,15308,11612,2012,79601
27695,21690,10995,10695,2012,79602
27696,23095,11032,12063,2012,79603
27697,29315,14035,15280,2012,79605
27698,24033,12136,11897,2012,79606
27699,2749,1628,1121,2012,79607
27700,397,145,252,2012,79699
27701,28634,14087,14547,2012,79701
27702,20391,9741,10650,2012,79703
27703,32807,15778,17029,2012,79705
27704,19181,9900,9281,2012,79706
27705,34289,17080,17209,2012,79707
27706,657,361,296,2012,79713
27707,15006,7478,7528,2012,79714
27708,1000,487,513,2012,79718
27709,436,213,223,2012,79719
27710,33787,19124,14663,2012,79720
27711,237,130,107,2012,79730
27712,4134,2056,2078,2012,79731
27713,194,87,107,2012,79733
27714,2118,1112,1006,2012,79734
27715,13368,7607,5761,2012,79735
27716,333,171,162,2012,79738
27717,1030,576,454,2012,79739
27718,286,135,151,2012,79741
27719,503,262,241,2012,79742
27720,337,157,180,2012,79743
27721,1253,656,597,2012,79744
27722,6183,3096,3087,2012,79745
27723,134,65,69,2012,79748
27724,323,174,149,2012,79749
27725,2185,1036,1149,2012,79752
27726,85,65,20,2012,79754
27727,187,101,86,2012,79755
27728,8927,4328,4599,2012,79756
27729,1777,816,961,2012,79758
27730,0,0,0,2012,79759
27731,29950,14968,14982,2012,79761
27732,40731,20597,20134,2012,79762
27733,34502,16468,18034,2012,79763
27734,20079,9923,10156,2012,79764
27735,7403,3663,3740,2012,79765
27736,6860,3449,3411,2012,79766
27737,0,0,0,2012,79770
27738,11939,6731,5208,2012,79772
27739,355,233,122,2012,79777
27740,928,504,424,2012,79778
27741,498,255,243,2012,79780
27742,298,176,122,2012,79781
27743,3989,1963,2026,2012,79782
27744,165,66,99,2012,79783
27745,240,83,157,2012,79785
27746,411,205,206,2012,79788
27747,954,534,420,2012,79789
27748,7305,4625,2680,2012,79821
27749,7559,3789,3770,2012,79830
27750,11,6,5,2012,79831
27751,183,80,103,2012,79834
27752,12775,6215,6560,2012,79835
27753,5067,2516,2551,2012,79836
27754,454,226,228,2012,79837
27755,8586,4345,4241,2012,79838
27756,2061,1024,1037,2012,79839
27757,547,261,286,2012,79842
27758,2685,1558,1127,2012,79843
27759,4886,2285,2601,2012,79845
27760,87,31,56,2012,79846
27761,51,32,19,2012,79847
27762,957,499,458,2012,79848
27763,13656,6775,6881,2012,79849
27764,714,378,336,2012,79851
27765,832,401,431,2012,79852
27766,3163,1611,1552,2012,79853
27767,190,82,108,2012,79854
27768,2391,1073,1318,2012,79855
27769,10473,5006,5467,2012,79901
27770,21142,9593,11549,2012,79902
27771,17836,8387,9449,2012,79903
27772,33652,15670,17982,2012,79904
27773,24372,10975,13397,2012,79905
27774,4333,2324,2009,2012,79906
27775,55584,25506,30078,2012,79907
27776,2326,1378,948,2012,79908
27777,2172,1207,965,2012,79911
27778,77242,37507,39735,2012,79912
27779,39402,19092,20310,2012,79915
27780,2915,2378,537,2012,79916
27781,73,73,0,2012,79920
27782,8415,3745,4670,2012,79922
27783,58320,27437,30883,2012,79924
27784,41111,19716,21395,2012,79925
27785,38132,18101,20031,2012,79927
27786,48055,24540,23515,2012,79928
27787,30123,14371,15752,2012,79930
27788,26219,12443,13776,2012,79932
27789,19674,9953,9721,2012,79934
27790,18623,9194,9429,2012,79935
27791,115538,55845,59693,2012,79936
27792,54984,28352,26632,2012,79938
27793,0,0,0,2012,79942
27794,18129,8836,9293,2012,80002
27795,35741,17254,18487,2012,80003
27796,35586,17149,18437,2012,80004
27797,26669,13042,13627,2012,80005
27798,7137,3606,3531,2012,80007
27799,42836,22486,20350,2012,80010
27800,47631,23986,23645,2012,80011
27801,44739,22096,22643,2012,80012
27802,70239,34811,35428,2012,80013
27803,35483,16244,19239,2012,80014
27804,64040,32171,31869,2012,80015
27805,40210,19596,20614,2012,80016
27806,33945,16711,17234,2012,80017
27807,9860,5058,4802,2012,80018
27808,1952,858,1094,2012,80019
27809,48700,24039,24661,2012,80020
27810,30292,14797,15495,2012,80021
27811,42662,21579,21083,2012,80022
27812,14322,7081,7241,2012,80023
27813,420,231,189,2012,80024
27814,248,81,167,2012,80025
27815,26730,13384,13346,2012,80026
27816,31175,15494,15681,2012,80027
27817,15307,7696,7611,2012,80030
27818,33131,16578,16553,2012,80031
27819,24660,12081,12579,2012,80033
27820,340,148,192,2012,80045
27821,183,95,88,2012,80101
27822,4969,2566,2403,2012,80102
27823,2354,1158,1196,2012,80103
27824,27061,13628,13433,2012,80104
27825,1096,567,529,2012,80105
27826,4791,2436,2355,2012,80106
27827,11577,5746,5831,2012,80107
27828,22341,10542,11799,2012,80108
27829,18096,9035,9061,2012,80109
27830,20999,10594,10405,2012,80110
27831,28854,14470,14384,2012,80111
27832,28476,13780,14696,2012,80112
27833,20558,9632,10926,2012,80113
27834,3542,1745,1797,2012,80116
27835,2792,1425,1367,2012,80117
27836,5211,2511,2700,2012,80118
27837,28745,13695,15050,2012,80120
27838,18070,8764,9306,2012,80121
27839,29987,14353,15634,2012,80122
27840,44097,21504,22593,2012,80123
27841,18244,9060,9184,2012,80124
27842,10057,5154,4903,2012,80125
27843,39455,19456,19999,2012,80126
27844,43780,21861,21919,2012,80127
27845,36007,17786,18221,2012,80128
27846,28058,14011,14047,2012,80129
27847,28605,14301,14304,2012,80130
27848,113,60,53,2012,80131
27849,19891,9931,9960,2012,80132
27850,2014,1047,967,2012,80133
27851,56044,27557,28487,2012,80134
27852,3389,1775,1614,2012,80135
27853,5124,2622,2502,2012,80136
27854,961,494,467,2012,80137
27855,29660,14945,14715,2012,80138
27856,10345,6058,4287,2012,80202
27857,19156,10670,8486,2012,80203
27858,30436,15079,15357,2012,80204
27859,27903,14162,13741,2012,80205
27860,21003,10375,10628,2012,80206
27861,20790,9595,11195,2012,80207
27862,21754,10914,10840,2012,80209
27863,34778,17125,17653,2012,80210
27864,32167,16350,15817,2012,80211
27865,17919,8516,9403,2012,80212
27866,24808,12821,11987,2012,80214
27867,17674,8705,8969,2012,80215
27868,11105,6177,4928,2012,80216
27869,18305,9659,8646,2012,80218
27870,62878,31937,30941,2012,80219
27871,34437,17125,17312,2012,80220
27872,39459,19994,19465,2012,80221
27873,19438,9626,9812,2012,80222
27874,16314,8602,7712,2012,80223
27875,16142,7817,8325,2012,80224
27876,31405,15879,15526,2012,80226
27877,34006,17053,16953,2012,80227
27878,30256,14795,15461,2012,80228
27879,50553,25384,25169,2012,80229
27880,8294,3846,4448,2012,80230
27881,33217,17070,16147,2012,80231
27882,21414,10794,10620,2012,80232
27883,45565,22876,22689,2012,80233
27884,25770,12672,13098,2012,80234
27885,9170,5102,4068,2012,80235
27886,17157,8167,8990,2012,80236
27887,17552,7931,9621,2012,80237
27888,10217,5191,5026,2012,80238
27889,39428,19494,19934,2012,80239
27890,31421,15747,15674,2012,80241
27891,12582,6430,6152,2012,80246
27892,24897,11070,13827,2012,80247
27893,25792,12151,13641,2012,80249
27894,30920,15665,15255,2012,80260
27895,0,0,0,2012,80264
27896,0,0,0,2012,80290
27897,0,0,0,2012,80293
27898,0,0,0,2012,80294
27899,23765,11768,11997,2012,80301
27900,27077,13901,13176,2012,80302
27901,22936,11496,11440,2012,80303
27902,26005,12532,13473,2012,80304
27903,17326,8884,8442,2012,80305
27904,5953,3337,2616,2012,80310
27905,37782,19777,18005,2012,80401
27906,18429,9771,8658,2012,80403
27907,259,222,37,2012,80419
27908,668,406,262,2012,80420
27909,8859,4368,4491,2012,80421
27910,4219,2189,2030,2012,80422
27911,87,56,31,2012,80423
27912,8977,4864,4113,2012,80424
27913,152,66,86,2012,80425
27914,213,126,87,2012,80426
27915,666,375,291,2012,80427
27916,559,223,336,2012,80428
27917,23,15,8,2012,80432
27918,8924,4379,4545,2012,80433
27919,64,30,34,2012,80434
27920,8468,4689,3779,2012,80435
27921,570,339,231,2012,80436
27922,308,180,128,2012,80438
27923,23160,11333,11827,2012,80439
27924,2249,1225,1024,2012,80440
27925,2744,1565,1179,2012,80442
27926,3125,1856,1269,2012,80443
27927,1211,635,576,2012,80444
27928,4103,2272,1831,2012,80446
27929,1639,894,745,2012,80447
27930,130,65,65,2012,80448
27931,681,335,346,2012,80449
27932,819,399,420,2012,80451
27933,2692,1419,1273,2012,80452
27934,78,43,35,2012,80453
27935,1092,549,543,2012,80454
27936,496,286,210,2012,80455
27937,739,475,264,2012,80456
27938,633,262,371,2012,80457
27939,2922,1337,1585,2012,80459
27940,7301,3711,3590,2012,80461
27941,147,85,62,2012,80463
27942,15000,7430,7570,2012,80465
27943,3216,1687,1529,2012,80466
27944,2168,1291,877,2012,80467
27945,469,334,135,2012,80468
27946,391,199,192,2012,80469
27947,4066,2107,1959,2012,80470
27948,0,0,0,2012,80471
27949,78,37,41,2012,80473
27950,26,0,26,2012,80475
27951,202,96,106,2012,80476
27952,643,427,216,2012,80477
27953,733,337,396,2012,80478
27954,32,14,18,2012,80479
27955,1255,682,573,2012,80480
27956,715,435,280,2012,80481
27957,1158,647,511,2012,80482
27958,649,404,245,2012,80483
27959,16280,8378,7902,2012,80487
27960,48,16,32,2012,80488
27961,214,120,94,2012,80497
27962,6969,3626,3343,2012,80498
27963,39911,20226,19685,2012,80501
27964,31275,15550,15725,2012,80503
27965,48089,23861,24228,2012,80504
27966,345,180,165,2012,80510
27967,74,33,41,2012,80511
27968,1957,1005,952,2012,80512
27969,10734,5387,5347,2012,80513
27970,4216,2118,2098,2012,80514
27971,746,396,350,2012,80515
27972,19824,9733,10091,2012,80516
27973,9303,4476,4827,2012,80517
27974,1023,517,506,2012,80520
27975,34427,17459,16968,2012,80521
27976,32272,16406,15866,2012,80524
27977,47005,22885,24120,2012,80525
27978,44605,22918,21687,2012,80526
27979,18633,9147,9486,2012,80528
27980,3309,1528,1781,2012,80530
27981,68,32,36,2012,80532
27982,11517,5886,5631,2012,80534
27983,2497,1344,1153,2012,80535
27984,1770,963,807,2012,80536
27985,38043,18837,19206,2012,80537
27986,44440,21336,23104,2012,80538
27987,4996,2484,2512,2012,80540
27988,3430,1809,1621,2012,80542
27989,5673,2830,2843,2012,80543
27990,0,0,0,2012,80544
27991,695,310,385,2012,80545
27992,73,33,40,2012,80546
27993,746,339,407,2012,80547
27994,9016,4522,4494,2012,80549
27995,20593,10427,10166,2012,80550
27996,34371,17147,17224,2012,80601
27997,28018,13788,14230,2012,80602
27998,10933,5453,5480,2012,80603
27999,2530,1288,1242,2012,80610
28000,750,392,358,2012,80611
28001,323,142,181,2012,80612
28002,7443,3549,3894,2012,80615
28003,17442,9044,8398,2012,80620
28004,12054,6480,5574,2012,80621
28005,189,73,116,2012,80622
28006,1095,573,522,2012,80623
28007,980,467,513,2012,80624
28008,48154,23968,24186,2012,80631
28009,54493,26494,27999,2012,80634
28010,10445,5292,5153,2012,80640
28011,4286,2390,1896,2012,80642
28012,3126,1484,1642,2012,80643
28013,2837,1547,1290,2012,80644
28014,4349,2264,2085,2012,80645
28015,1020,498,522,2012,80648
28016,283,139,144,2012,80649
28017,1545,691,854,2012,80650
28018,4147,2221,1926,2012,80651
28019,452,213,239,2012,80652
28020,692,362,330,2012,80653
28021,2294,1243,1051,2012,80654
28022,16301,8093,8208,2012,80701
28023,851,441,410,2012,80705
28024,2755,1458,1297,2012,80720
28025,88,59,29,2012,80721
28026,313,220,93,2012,80722
28027,7157,3458,3699,2012,80723
28028,474,293,181,2012,80726
28029,280,116,164,2012,80727
28030,996,532,464,2012,80728
28031,604,334,270,2012,80729
28032,1633,837,796,2012,80731
28033,472,273,199,2012,80733
28034,3016,1468,1548,2012,80734
28035,457,253,204,2012,80735
28036,579,375,204,2012,80736
28037,1505,719,786,2012,80737
28038,84,43,41,2012,80740
28039,903,531,372,2012,80741
28040,316,154,162,2012,80742
28041,1132,544,588,2012,80743
28042,569,297,272,2012,80744
28043,261,197,64,2012,80745
28044,33,25,8,2012,80746
28045,557,285,272,2012,80747
28046,306,162,144,2012,80749
28047,329,141,188,2012,80750
28048,18444,9923,8521,2012,80751
28049,224,120,104,2012,80754
28050,101,58,43,2012,80755
28051,254,134,120,2012,80757
28052,3752,1780,1972,2012,80758
28053,4569,2263,2306,2012,80759
28054,140,68,72,2012,80801
28055,230,117,113,2012,80802
28056,291,128,163,2012,80804
28057,546,295,251,2012,80805
28058,5369,3055,2314,2012,80807
28059,5872,2855,3017,2012,80808
28060,1509,729,780,2012,80809
28061,1229,596,633,2012,80810
28062,139,70,69,2012,80812
28063,2096,1073,1023,2012,80813
28064,4335,2538,1797,2012,80814
28065,916,528,388,2012,80815
28066,4949,2688,2261,2012,80816
28067,27228,13438,13790,2012,80817
28068,293,128,165,2012,80818
28069,750,364,386,2012,80819
28070,582,302,280,2012,80820
28071,881,363,518,2012,80821
28072,285,142,143,2012,80822
28073,225,101,124,2012,80823
28074,288,150,138,2012,80824
28075,547,250,297,2012,80825
28076,531,240,291,2012,80827
28077,3769,2494,1275,2012,80828
28078,5535,2563,2972,2012,80829
28079,167,58,109,2012,80830
28080,21489,11038,10451,2012,80831
28081,548,273,275,2012,80832
28082,617,347,270,2012,80833
28083,269,157,112,2012,80834
28084,793,364,429,2012,80835
28085,1088,627,461,2012,80836
28086,6816,4919,1897,2012,80840
28087,543,294,249,2012,80860
28088,263,149,114,2012,80861
28089,61,29,32,2012,80862
28090,11573,5595,5978,2012,80863
28091,1150,529,621,2012,80864
28092,11921,6808,5113,2012,80902
28093,14405,6840,7565,2012,80903
28094,20050,9844,10206,2012,80904
28095,16647,8146,8501,2012,80905
28096,37874,18881,18993,2012,80906
28097,26005,12723,13282,2012,80907
28098,14096,7064,7032,2012,80908
28099,35041,17598,17443,2012,80909
28100,28735,14022,14713,2012,80910
28101,30470,14793,15677,2012,80911
28102,2990,2463,527,2012,80913
28103,324,252,72,2012,80914
28104,19199,9918,9281,2012,80915
28105,37085,18795,18290,2012,80916
28106,28703,14058,14645,2012,80917
28107,46227,22672,23555,2012,80918
28108,27350,13552,13798,2012,80919
28109,38367,18733,19634,2012,80920
28110,18687,9209,9478,2012,80921
28111,26492,12707,13785,2012,80922
28112,26683,12849,13834,2012,80923
28113,4454,2108,2346,2012,80924
28114,6195,2968,3227,2012,80925
28115,1200,646,554,2012,80926
28116,824,385,439,2012,80927
28117,1205,569,636,2012,80928
28118,238,164,74,2012,80929
28119,1002,435,567,2012,80930
28120,29,15,14,2012,80938
28121,0,0,0,2012,80939
28122,4368,2240,2128,2012,80951
28123,29029,14337,14692,2012,81001
28124,15094,7389,7705,2012,81003
28125,25438,12275,13163,2012,81004
28126,30786,14833,15953,2012,81005
28127,12068,6193,5875,2012,81006
28128,29522,14590,14932,2012,81007
28129,10973,5365,5608,2012,81008
28130,1504,761,743,2012,81019
28131,1015,539,476,2012,81020
28132,7,3,4,2012,81021
28133,1263,584,679,2012,81022
28134,1218,640,578,2012,81023
28135,76,37,39,2012,81024
28136,1022,576,446,2012,81025
28137,163,94,69,2012,81027
28138,329,159,170,2012,81029
28139,99,52,47,2012,81030
28140,370,244,126,2012,81033
28141,987,470,517,2012,81036
28142,315,315,0,2012,81038
28143,1669,795,874,2012,81039
28144,679,310,369,2012,81040
28145,857,422,435,2012,81041
28146,63,24,39,2012,81043
28147,286,149,137,2012,81044
28148,61,37,24,2012,81045
28149,1423,720,703,2012,81047
28150,328,187,141,2012,81049
28151,10055,5021,5034,2012,81050
28152,9620,4757,4863,2012,81052
28153,4903,3169,1734,2012,81054
28154,1473,674,799,2012,81055
28155,470,243,227,2012,81057
28156,1140,655,485,2012,81058
28157,311,244,67,2012,81059
28158,1920,1483,437,2012,81062
28159,2601,1730,871,2012,81063
28160,343,195,148,2012,81064
28161,5832,2952,2880,2012,81067
28162,1681,950,731,2012,81069
28163,338,163,175,2012,81071
28164,1763,871,892,2012,81073
28165,544,321,223,2012,81076
28166,460,190,270,2012,81077
28167,64,29,35,2012,81081
28168,12515,6275,6240,2012,81082
28169,82,46,36,2012,81084
28170,154,66,88,2012,81087
28171,4292,2241,2051,2012,81089
28172,1164,568,596,2012,81090
28173,859,472,387,2012,81091
28174,800,412,388,2012,81092
28175,14873,7495,7378,2012,81101
28176,2058,1022,1036,2012,81120
28177,187,105,82,2012,81121
28178,7478,3633,3845,2012,81122
28179,881,469,412,2012,81123
28180,106,38,68,2012,81124
28181,3463,1743,1720,2012,81125
28182,180,85,95,2012,81126
28183,57,37,20,2012,81128
28184,184,112,72,2012,81129
28185,688,314,374,2012,81130
28186,1082,594,488,2012,81131
28187,3024,1586,1438,2012,81132
28188,958,482,476,2012,81133
28189,214,103,111,2012,81136
28190,5483,2901,2582,2012,81137
28191,63,25,38,2012,81138
28192,2399,1164,1235,2012,81140
28193,1498,753,745,2012,81141
28194,498,275,223,2012,81143
28195,7528,3498,4030,2012,81144
28196,651,361,290,2012,81146
28197,11561,5978,5583,2012,81147
28198,515,285,230,2012,81148
28199,1042,517,525,2012,81149
28200,1495,732,763,2012,81151
28201,1382,716,666,2012,81152
28202,1300,710,590,2012,81154
28203,221,132,89,2012,81155
28204,8910,4507,4403,2012,81201
28205,290,184,106,2012,81210
28206,7157,4134,3023,2012,81211
28207,30143,17359,12784,2012,81212
28208,127,62,65,2012,81220
28209,269,136,133,2012,81221
28210,175,100,75,2012,81222
28211,1531,810,721,2012,81223
28212,3603,1893,1710,2012,81224
28213,755,396,359,2012,81225
28214,8995,6241,2754,2012,81226
28215,0,0,0,2012,81227
28216,9179,4953,4226,2012,81230
28217,657,462,195,2012,81231
28218,91,53,38,2012,81232
28219,1172,577,595,2012,81233
28220,680,301,379,2012,81235
28221,899,423,476,2012,81236
28222,106,67,39,2012,81237
28223,41,10,31,2012,81239
28224,4151,2064,2087,2012,81240
28225,71,42,29,2012,81241
28226,913,453,460,2012,81242
28227,73,41,32,2012,81243
28228,306,151,155,2012,81244
28229,33,15,18,2012,81248
28230,71,48,23,2012,81251
28231,3738,2026,1712,2012,81252
28232,427,220,207,2012,81253
28233,28844,14682,14162,2012,81301
28234,7779,4012,3767,2012,81303
28235,271,111,160,2012,81320
28236,14286,6852,7434,2012,81321
28237,4896,2652,2244,2012,81323
28238,1193,667,526,2012,81324
28239,141,69,72,2012,81325
28240,2223,1123,1100,2012,81326
28241,766,392,374,2012,81327
28242,4020,1856,2164,2012,81328
28243,8,0,8,2012,81330
28244,169,97,72,2012,81331
28245,277,136,141,2012,81332
28246,1270,629,641,2012,81334
28247,125,63,62,2012,81335
28248,22488,10893,11595,2012,81401
28249,11115,5338,5777,2012,81403
28250,1474,778,696,2012,81410
28251,18,0,18,2012,81411
28252,5243,2537,2706,2012,81413
28253,1934,1113,821,2012,81415
28254,13593,6897,6696,2012,81416
28255,1782,792,990,2012,81418
28256,3757,1910,1847,2012,81419
28257,531,241,290,2012,81422
28258,1518,686,832,2012,81423
28259,1072,476,596,2012,81424
28260,5034,2722,2312,2012,81425
28261,143,66,77,2012,81426
28262,1025,506,519,2012,81427
28263,3810,1960,1850,2012,81428
28264,106,44,62,2012,81429
28265,544,260,284,2012,81430
28266,480,243,237,2012,81431
28267,2610,1378,1232,2012,81432
28268,732,449,283,2012,81433
28269,228,109,119,2012,81434
28270,5155,2885,2270,2012,81435
28271,23616,11944,11672,2012,81501
28272,14768,7244,7524,2012,81503
28273,29783,14909,14874,2012,81504
28274,9526,4759,4767,2012,81505
28275,10443,4966,5477,2012,81506
28276,14891,7334,7557,2012,81507
28277,14828,7194,7634,2012,81520
28278,14335,7317,7018,2012,81521
28279,0,0,0,2012,81522
28280,952,395,557,2012,81523
28281,2328,1168,1160,2012,81524
28282,677,392,285,2012,81525
28283,5296,2793,2503,2012,81526
28284,2044,1035,1009,2012,81527
28285,16166,8448,7718,2012,81601
28286,455,237,218,2012,81610
28287,9513,4978,4535,2012,81611
28288,0,0,0,2012,81612
28289,2766,1616,1150,2012,81615
28290,10644,6149,4495,2012,81620
28291,7122,3574,3548,2012,81621
28292,15353,7988,7365,2012,81623
28293,1396,687,709,2012,81624
28294,12651,6503,6148,2012,81625
28295,829,457,372,2012,81630
28296,7979,4380,3599,2012,81631
28297,9520,4555,4965,2012,81632
28298,0,0,0,2012,81633
28299,6527,3173,3354,2012,81635
28300,7495,3970,3525,2012,81637
28301,149,96,53,2012,81638
28302,2467,1319,1148,2012,81639
28303,238,147,91,2012,81640
28304,3467,1835,1632,2012,81641
28305,84,44,40,2012,81642
28306,783,433,350,2012,81643
28307,966,480,486,2012,81645
28308,132,71,61,2012,81646
28309,6856,3412,3444,2012,81647
28310,2510,1207,1303,2012,81648
28311,264,153,111,2012,81649
28312,13250,7170,6080,2012,81650
28313,4403,2239,2164,2012,81652
28314,67,32,35,2012,81653
28315,908,463,445,2012,81654
28316,99,55,44,2012,81655
28317,332,145,187,2012,81656
28318,5679,3240,2439,2012,81657
28319,35605,17331,18274,2012,82001
28320,447,403,44,2012,82005
28321,19502,9578,9924,2012,82007
28322,31896,16214,15682,2012,82009
28323,241,112,129,2012,82050
28324,5,5,0,2012,82051
28325,0,0,0,2012,82052
28326,1619,900,719,2012,82053
28327,710,321,389,2012,82054
28328,333,243,90,2012,82055
28329,15,11,4,2012,82058
28330,0,0,0,2012,82059
28331,169,101,68,2012,82060
28332,11,0,11,2012,82061
28333,59,30,29,2012,82063
28334,20339,10217,10122,2012,82070
28335,14946,8055,6891,2012,82072
28336,27,27,0,2012,82073
28337,0,0,0,2012,82081
28338,1542,798,744,2012,82082
28339,362,216,146,2012,82083
28340,0,0,0,2012,82084
28341,781,464,317,2012,82190
28342,6464,3305,3159,2012,82201
28343,523,257,266,2012,82210
28344,384,197,187,2012,82212
28345,542,303,239,2012,82213
28346,1285,617,668,2012,82214
28347,127,66,61,2012,82215
28348,154,98,56,2012,82217
28349,36,17,19,2012,82219
28350,541,235,306,2012,82221
28351,191,95,96,2012,82222
28352,1161,511,650,2012,82223
28353,23,13,10,2012,82224
28354,1985,893,1092,2012,82225
28355,187,70,117,2012,82227
28356,183,88,95,2012,82229
28357,9990,5248,4742,2012,82240
28358,40,19,21,2012,82242
28359,114,72,42,2012,82243
28360,785,424,361,2012,82244
28361,9556,5260,4296,2012,82301
28362,695,359,336,2012,82321
28363,116,56,60,2012,82322
28364,195,109,86,2012,82323
28365,306,167,139,2012,82324
28366,719,414,305,2012,82325
28367,853,412,441,2012,82327
28368,231,116,115,2012,82329
28369,2573,1327,1246,2012,82331
28370,43,27,16,2012,82332
28371,477,297,180,2012,82334
28372,0,0,0,2012,82335
28373,400,214,186,2012,82336
28374,7813,3894,3919,2012,82401
28375,1632,745,887,2012,82410
28376,519,285,234,2012,82411
28377,698,379,319,2012,82412
28378,14553,7115,7438,2012,82414
28379,776,380,396,2012,82420
28380,375,213,162,2012,82421
28381,69,42,27,2012,82422
28382,235,144,91,2012,82423
28383,2861,1466,1395,2012,82426
28384,46,27,19,2012,82428
28385,106,53,53,2012,82430
28386,3737,1829,1908,2012,82431
28387,197,98,99,2012,82432
28388,834,467,367,2012,82433
28389,205,96,109,2012,82434
28390,11935,5957,5978,2012,82435
28391,210,147,63,2012,82440
28392,266,147,119,2012,82441
28393,652,368,284,2012,82442
28394,4668,2281,2387,2012,82443
28395,165,77,88,2012,82450
28396,19424,9667,9757,2012,82501
28397,482,272,210,2012,82510
28398,208,116,92,2012,82512
28399,1774,923,851,2012,82513
28400,1403,646,757,2012,82514
28401,401,188,213,2012,82515
28402,449,213,236,2012,82516
28403,13661,6789,6872,2012,82520
28404,1054,538,516,2012,82523
28405,27295,13937,13358,2012,82601
28406,25785,12826,12959,2012,82604
28407,16322,8224,8098,2012,82609
28408,300,187,113,2012,82620
28409,0,0,0,2012,82630
28410,9185,4488,4697,2012,82633
28411,306,173,133,2012,82635
28412,3779,1866,1913,2012,82636
28413,4405,2433,1972,2012,82637
28414,0,0,0,2012,82638
28415,804,393,411,2012,82639
28416,18,11,7,2012,82640
28417,53,29,24,2012,82642
28418,606,331,275,2012,82643
28419,1448,820,628,2012,82644
28420,0,0,0,2012,82646
28421,13,13,0,2012,82648
28422,1194,608,586,2012,82649
28423,5453,2821,2632,2012,82701
28424,229,110,119,2012,82710
28425,43,33,10,2012,82711
28426,306,217,89,2012,82712
28427,184,49,135,2012,82714
28428,0,0,0,2012,82715
28429,17722,9068,8654,2012,82716
28430,23183,12255,10928,2012,82718
28431,1232,665,567,2012,82720
28432,2864,1471,1393,2012,82721
28433,314,174,140,2012,82723
28434,229,140,89,2012,82725
28435,2287,1128,1159,2012,82727
28436,2081,1001,1080,2012,82729
28437,1515,833,682,2012,82730
28438,94,33,61,2012,82731
28439,2270,1242,1028,2012,82732
28440,24881,12081,12800,2012,82801
28441,159,90,69,2012,82831
28442,658,404,254,2012,82832
28443,179,88,91,2012,82833
28444,7487,3759,3728,2012,82834
28445,347,174,173,2012,82835
28446,1019,523,496,2012,82836
28447,11,5,6,2012,82837
28448,406,175,231,2012,82838
28449,1057,579,478,2012,82839
28450,719,402,317,2012,82842
28451,62,33,29,2012,82844
28452,20,0,20,2012,82845
28453,28309,14743,13566,2012,82901
28454,149,76,73,2012,82922
28455,426,266,160,2012,82923
28456,157,100,57,2012,82925
28457,15,15,0,2012,82929
28458,14712,7269,7443,2012,82930
28459,1181,599,582,2012,82932
28460,671,368,303,2012,82933
28461,136,73,63,2012,82934
28462,13149,6887,6262,2012,82935
28463,4,4,0,2012,82936
28464,3393,1808,1585,2012,82937
28465,129,61,68,2012,82938
28466,1862,945,917,2012,82939
28467,5031,2696,2335,2012,82941
28468,15,10,5,2012,82942
28469,149,85,64,2012,82943
28470,300,173,127,2012,82944
28471,224,116,108,2012,82945
28472,16057,8179,7878,2012,83001
28473,148,76,72,2012,83011
28474,69,18,51,2012,83012
28475,317,113,204,2012,83013
28476,3927,2247,1680,2012,83014
28477,147,79,68,2012,83025
28478,2948,1538,1410,2012,83101
28479,5466,2764,2702,2012,83110
28480,474,259,215,2012,83111
28481,446,239,207,2012,83112
28482,3103,1638,1465,2012,83113
28483,999,522,477,2012,83114
28484,1103,629,474,2012,83115
28485,631,335,296,2012,83116
28486,1087,504,583,2012,83118
28487,54,25,29,2012,83119
28488,660,278,382,2012,83120
28489,5,5,0,2012,83121
28490,389,219,170,2012,83122
28491,641,333,308,2012,83123
28492,80,30,50,2012,83124
28493,208,118,90,2012,83126
28494,2658,1379,1279,2012,83127
28495,1375,782,593,2012,83128
28496,38477,19524,18953,2012,83201
28497,21046,10684,10362,2012,83202
28498,510,171,339,2012,83203
28499,17888,8341,9547,2012,83204
28500,781,408,373,2012,83209
28501,3331,1721,1610,2012,83210
28502,5933,2971,2962,2012,83211
28503,163,95,68,2012,83212
28504,1659,834,825,2012,83213
28505,520,282,238,2012,83214
28506,32,15,17,2012,83215
28507,768,393,375,2012,83217
28508,359,167,192,2012,83218
28509,102,28,74,2012,83220
28510,26614,13394,13220,2012,83221
28511,101,58,43,2012,83223
28512,2384,1228,1156,2012,83226
28513,212,185,27,2012,83227
28514,633,315,318,2012,83228
28515,429,209,220,2012,83232
28516,29,29,0,2012,83233
28517,976,518,458,2012,83234
28518,184,143,41,2012,83235
28519,2187,1125,1062,2012,83236
28520,1363,736,627,2012,83237
28521,106,54,52,2012,83238
28522,491,227,264,2012,83239
28523,1847,909,938,2012,83241
28524,130,76,54,2012,83243
28525,316,183,133,2012,83244
28526,2312,1183,1129,2012,83245
28527,881,375,506,2012,83246
28528,1679,856,823,2012,83250
28529,1210,619,591,2012,83251
28530,3959,2086,1873,2012,83252
28531,186,85,101,2012,83253
28532,3846,1836,2010,2012,83254
28533,1084,540,544,2012,83255
28534,535,268,267,2012,83261
28535,1143,573,570,2012,83262
28536,8606,4395,4211,2012,83263
28537,745,418,327,2012,83271
28538,392,248,144,2012,83272
28539,9611,4690,4921,2012,83274
28540,4074,2104,1970,2012,83276
28541,246,120,126,2012,83277
28542,65,23,42,2012,83278
28543,132,53,79,2012,83281
28544,134,68,66,2012,83283
28545,148,66,82,2012,83285
28546,1574,762,812,2012,83286
28547,301,158,143,2012,83287
28548,52184,25944,26240,2012,83301
28549,74,45,29,2012,83302
28550,469,226,243,2012,83311
28551,166,101,65,2012,83312
28552,3262,1575,1687,2012,83313
28553,1136,554,582,2012,83314
28554,9714,4800,4914,2012,83316
28555,16720,8320,8400,2012,83318
28556,1141,623,518,2012,83320
28557,606,307,299,2012,83321
28558,66,39,27,2012,83322
28559,2010,1178,832,2012,83323
28560,829,455,374,2012,83324
28561,756,362,394,2012,83325
28562,1109,622,487,2012,83327
28563,5040,2401,2639,2012,83328
28564,6329,3367,2962,2012,83330
28565,2528,1109,1419,2012,83332
28566,10886,5563,5323,2012,83333
28567,1871,963,908,2012,83334
28568,1912,1022,890,2012,83335
28569,4818,2419,2399,2012,83336
28570,26,22,4,2012,83337
28571,19614,9956,9658,2012,83338
28572,4466,2351,2115,2012,83340
28573,6623,3211,3412,2012,83341
28574,1676,867,809,2012,83342
28575,961,458,503,2012,83344
28576,1660,810,850,2012,83346
28577,3529,1817,1712,2012,83347
28578,200,129,71,2012,83348
28579,1028,480,548,2012,83349
28580,11815,6065,5750,2012,83350
28581,3499,1796,1703,2012,83352
28582,1184,625,559,2012,83353
28583,11,6,5,2012,83354
28584,5372,2825,2547,2012,83355
28585,38361,19437,18924,2012,83401
28586,26378,13008,13370,2012,83402
28587,21957,10465,11492,2012,83404
28588,15379,7761,7618,2012,83406
28589,355,228,127,2012,83414
28590,2630,1300,1330,2012,83420
28591,561,292,269,2012,83421
28592,3849,2053,1796,2012,83422
28593,696,372,324,2012,83423
28594,79,49,30,2012,83424
28595,771,447,324,2012,83425
28596,1187,624,563,2012,83427
28597,301,175,126,2012,83428
28598,788,463,325,2012,83429
28599,911,443,468,2012,83431
28600,7,4,3,2012,83433
28601,1996,1099,897,2012,83434
28602,515,273,242,2012,83435
28603,333,182,151,2012,83436
28604,35179,17174,18005,2012,83440
28605,18402,9061,9341,2012,83442
28606,1142,572,570,2012,83443
28607,1343,682,661,2012,83444
28608,6817,3586,3231,2012,83445
28609,46,13,33,2012,83446
28610,2403,1255,1148,2012,83448
28611,194,127,67,2012,83449
28612,1018,577,441,2012,83450
28613,603,304,299,2012,83451
28614,1128,618,510,2012,83452
28615,513,262,251,2012,83454
28616,4951,2574,2377,2012,83455
28617,929,339,590,2012,83460
28618,393,193,200,2012,83462
28619,72,54,18,2012,83463
28620,516,232,284,2012,83464
28621,119,66,53,2012,83465
28622,284,197,87,2012,83466
28623,6179,3125,3054,2012,83467
28624,164,63,101,2012,83468
28625,33,24,9,2012,83469
28626,34022,16950,17072,2012,83501
28627,181,94,87,2012,83520
28628,2228,1237,991,2012,83522
28629,762,372,390,2012,83523
28630,1123,570,553,2012,83524
28631,680,429,251,2012,83525
28632,354,178,176,2012,83526
28633,5475,2674,2801,2012,83530
28634,176,84,92,2012,83533
28635,1188,616,572,2012,83535
28636,3741,1847,1894,2012,83536
28637,1140,593,547,2012,83537
28638,2248,1220,1028,2012,83539
28639,2205,1106,1099,2012,83540
28640,990,446,544,2012,83541
28641,139,72,67,2012,83542
28642,658,362,296,2012,83543
28643,6002,3308,2694,2012,83544
28644,541,286,255,2012,83545
28645,716,410,306,2012,83546
28646,180,89,91,2012,83547
28647,163,69,94,2012,83548
28648,731,385,346,2012,83549
28649,1309,710,599,2012,83552
28650,1010,538,472,2012,83553
28651,574,283,291,2012,83554
28652,472,228,244,2012,83555
28653,19,8,11,2012,83601
28654,16,0,16,2012,83602
28655,859,465,394,2012,83604
28656,38688,19139,19549,2012,83605
28657,23277,11880,11397,2012,83607
28658,909,494,415,2012,83610
28659,2907,1563,1344,2012,83611
28660,2103,1055,1048,2012,83612
28661,878,411,467,2012,83615
28662,22342,10952,11390,2012,83616
28663,15431,7825,7606,2012,83617
28664,6950,3225,3725,2012,83619
28665,1435,724,711,2012,83622
28666,1542,713,829,2012,83623
28667,1370,729,641,2012,83624
28668,1016,493,523,2012,83626
28669,922,424,498,2012,83627
28670,4272,2252,2020,2012,83628
28671,1907,988,919,2012,83629
28672,1278,637,641,2012,83631
28673,279,146,133,2012,83632
28674,487,275,212,2012,83633
28675,24040,13739,10301,2012,83634
28676,163,61,102,2012,83636
28677,276,151,125,2012,83637
28678,5965,3038,2927,2012,83638
28679,3157,1548,1609,2012,83639
28680,3727,1989,1738,2012,83641
28681,35978,17787,18191,2012,83642
28682,132,74,58,2012,83643
28683,9984,5084,4900,2012,83644
28684,565,277,288,2012,83645
28685,48067,23715,24352,2012,83646
28686,20078,10288,9790,2012,83647
28687,3245,1930,1315,2012,83648
28688,626,296,330,2012,83650
28689,28550,14094,14456,2012,83651
28690,1486,787,699,2012,83654
28691,4626,2351,2275,2012,83655
28692,487,212,275,2012,83656
28693,179,101,78,2012,83657
28694,5793,3116,2677,2012,83660
28695,9429,4583,4846,2012,83661
28696,28,16,12,2012,83666
28697,7680,4011,3669,2012,83669
28698,568,273,295,2012,83670
28699,0,0,0,2012,83671
28700,8648,4250,4398,2012,83672
28701,4413,2333,2080,2012,83676
28702,102,34,68,2012,83677
28703,45749,22198,23551,2012,83686
28704,29581,14528,15053,2012,83687
28705,23288,12116,11172,2012,83702
28706,16187,7868,8319,2012,83703
28707,39232,19289,19943,2012,83704
28708,27743,14058,13685,2012,83705
28709,31289,15563,15726,2012,83706
28710,52411,26476,25935,2012,83709
28711,7904,3771,4133,2012,83712
28712,26384,12800,13584,2012,83713
28713,20524,9297,11227,2012,83714
28714,15210,8079,7131,2012,83716
28715,5546,2715,2831,2012,83801
28716,205,94,111,2012,83802
28717,507,281,226,2012,83803
28718,1360,709,651,2012,83804
28719,7718,3954,3764,2012,83805
28720,218,123,95,2012,83806
28721,182,86,96,2012,83808
28722,270,102,168,2012,83809
28723,1610,778,832,2012,83810
28724,1308,702,606,2012,83811
28725,138,86,52,2012,83812
28726,856,463,393,2012,83813
28727,23806,11583,12223,2012,83814
28728,31089,15375,15714,2012,83815
28729,403,216,187,2012,83821
28730,2580,1427,1153,2012,83822
28731,1499,785,714,2012,83823
28732,369,191,178,2012,83824
28733,288,147,141,2012,83825
28734,34,13,21,2012,83826
28735,127,76,51,2012,83827
28736,671,351,320,2012,83830
28737,1479,796,683,2012,83832
28738,1080,557,523,2012,83833
28739,224,106,118,2012,83834
28740,19739,9980,9759,2012,83835
28741,1204,548,656,2012,83836
28742,3135,1444,1691,2012,83837
28743,1018,581,437,2012,83839
28744,221,131,90,2012,83840
28745,105,7,98,2012,83841
28746,207,75,132,2012,83842
28747,25865,13441,12424,2012,83843
28748,1175,580,595,2012,83844
28749,1751,843,908,2012,83845
28750,750,402,348,2012,83846
28751,1354,782,572,2012,83847
28752,124,85,39,2012,83848
28753,1807,873,934,2012,83849
28754,1882,897,985,2012,83850
28755,1499,689,810,2012,83851
28756,1046,532,514,2012,83852
28757,37545,17947,19598,2012,83854
28758,2281,1136,1145,2012,83855
28759,5986,3083,2903,2012,83856
28760,552,294,258,2012,83857
28761,14019,7219,6800,2012,83858
28762,5339,2608,2731,2012,83860
28763,6846,3514,3332,2012,83861
28764,17560,8559,9001,2012,83864
28765,106,74,32,2012,83866
28766,705,372,333,2012,83867
28767,850,361,489,2012,83868
28768,4104,2093,2011,2012,83869
28769,266,143,123,2012,83870
28770,1964,968,996,2012,83871
28771,649,307,342,2012,83872
28772,1905,1118,787,2012,83873
28773,76,45,31,2012,83874
28774,1614,845,769,2012,83876
28775,1074,617,457,2012,84001
28776,282,175,107,2012,84002
28777,42318,21516,20802,2012,84003
28778,9850,5031,4819,2012,84004
28779,21106,10599,10507,2012,84005
28780,928,467,461,2012,84006
28781,510,256,254,2012,84007
28782,45310,22333,22977,2012,84010
28783,765,412,353,2012,84013
28784,15624,7861,7763,2012,84014
28785,61642,31428,30214,2012,84015
28786,3621,1854,1767,2012,84017
28787,96,64,32,2012,84018
28788,41538,21900,19638,2012,84020
28789,3600,1821,1779,2012,84021
28790,1206,568,638,2012,84022
28791,243,129,114,2012,84023
28792,101,52,49,2012,84024
28793,18748,9325,9423,2012,84025
28794,1302,650,652,2012,84026
28795,642,346,296,2012,84027
28796,587,267,320,2012,84028
28797,9399,4696,4703,2012,84029
28798,220,115,105,2012,84031
28799,17620,8888,8732,2012,84032
28800,953,462,491,2012,84033
28801,282,157,125,2012,84034
28802,662,347,315,2012,84035
28803,6099,3172,2927,2012,84036
28804,33462,16352,17110,2012,84037
28805,395,226,169,2012,84038
28806,849,403,446,2012,84039
28807,23606,11945,11661,2012,84040
28808,44210,22300,21910,2012,84041
28809,10093,5217,4876,2012,84042
28810,48555,24650,23905,2012,84043
28811,27697,13495,14202,2012,84044
28812,17043,8827,8216,2012,84045
28813,647,378,269,2012,84046
28814,29574,14859,14715,2012,84047
28815,4500,2252,2248,2012,84049
28816,9389,4759,4630,2012,84050
28817,518,335,183,2012,84051
28818,1099,591,508,2012,84052
28819,905,441,464,2012,84053
28820,15800,7958,7842,2012,84054
28821,1298,741,557,2012,84055
28822,3646,1801,1845,2012,84056
28823,37616,19025,18591,2012,84057
28824,30625,15384,15241,2012,84058
28825,7743,3828,3915,2012,84060
28826,570,295,275,2012,84061
28827,42771,20941,21830,2012,84062
28828,365,172,193,2012,84063
28829,873,455,418,2012,84064
28830,36991,19398,17593,2012,84065
28831,10766,5269,5497,2012,84066
28832,37343,18404,18939,2012,84067
28833,559,268,291,2012,84069
28834,24296,11733,12563,2012,84070
28835,1153,576,577,2012,84071
28836,527,278,249,2012,84072
28837,168,89,79,2012,84073
28838,44246,22278,21968,2012,84074
28839,24104,12505,11599,2012,84075
28840,316,186,130,2012,84076
28841,27133,13825,13308,2012,84078
28842,227,118,109,2012,84080
28843,41480,20849,20631,2012,84081
28844,742,429,313,2012,84082
28845,1242,602,640,2012,84083
28846,36832,18487,18345,2012,84084
28847,369,156,213,2012,84085
28848,409,210,199,2012,84086
28849,13707,6972,6735,2012,84087
28850,35188,18139,17049,2012,84088
28851,29848,15311,14537,2012,84092
28852,23534,12003,11531,2012,84093
28853,27650,13585,14065,2012,84094
28854,51364,26102,25262,2012,84095
28855,32998,16789,16209,2012,84096
28856,20823,9850,10973,2012,84097
28857,16933,8709,8224,2012,84098
28858,4705,2808,1897,2012,84101
28859,17212,9386,7826,2012,84102
28860,21742,10976,10766,2012,84103
28861,25163,13139,12024,2012,84104
28862,22672,10882,11790,2012,84105
28863,33006,15887,17119,2012,84106
28864,31472,15078,16394,2012,84107
28865,21623,10510,11113,2012,84108
28866,24131,12051,12080,2012,84109
28867,10950,5977,4973,2012,84111
28868,1656,891,765,2012,84112
28869,72,35,37,2012,84113
28870,24785,12895,11890,2012,84115
28871,31980,16763,15217,2012,84116
28872,24754,12111,12643,2012,84117
28873,66107,32692,33415,2012,84118
28874,53633,27572,26061,2012,84119
28875,47858,23920,23938,2012,84120
28876,41120,19808,21312,2012,84121
28877,38764,18999,19765,2012,84123
28878,21695,10525,11170,2012,84124
28879,29143,14162,14981,2012,84128
28880,24,8,16,2012,84144
28881,0,0,0,2012,84180
28882,869,457,412,2012,84301
28883,23966,12159,11807,2012,84302
28884,20,11,9,2012,84304
28885,732,409,323,2012,84305
28886,241,151,90,2012,84306
28887,1327,724,603,2012,84307
28888,406,216,190,2012,84308
28889,424,219,205,2012,84309
28890,4752,2278,2474,2012,84310
28891,800,401,399,2012,84311
28892,4059,2033,2026,2012,84312
28893,252,139,113,2012,84313
28894,784,364,420,2012,84314
28895,7926,4175,3751,2012,84315
28896,173,86,87,2012,84316
28897,1911,1010,901,2012,84317
28898,3885,1877,2008,2012,84318
28899,7723,3858,3865,2012,84319
28900,2134,1103,1031,2012,84320
28901,44361,21554,22807,2012,84321
28902,685,381,304,2012,84324
28903,1920,953,967,2012,84325
28904,1474,825,649,2012,84326
28905,875,450,425,2012,84327
28906,1662,849,813,2012,84328
28907,194,108,86,2012,84329
28908,315,148,167,2012,84330
28909,283,130,153,2012,84331
28910,7227,3557,3670,2012,84332
28911,2749,1405,1344,2012,84333
28912,175,87,88,2012,84334
28913,11259,5518,5741,2012,84335
28914,209,106,103,2012,84336
28915,11248,5382,5866,2012,84337
28916,514,265,249,2012,84338
28917,5164,2597,2567,2012,84339
28918,3565,1827,1738,2012,84340
28919,19990,10315,9675,2012,84341
28920,35179,18068,17111,2012,84401
28921,37487,18865,18622,2012,84403
28922,55837,28291,27546,2012,84404
28923,31232,15019,16213,2012,84405
28924,26078,13377,12701,2012,84414
28925,13518,6768,6750,2012,84501
28926,4476,2195,2281,2012,84511
28927,1089,618,471,2012,84512
28928,1896,1018,878,2012,84513
28929,0,0,0,2012,84515
28930,157,91,66,2012,84516
28931,612,324,288,2012,84518
28932,1359,671,688,2012,84520
28933,669,361,308,2012,84521
28934,389,203,186,2012,84522
28935,1883,907,976,2012,84523
28936,1247,561,686,2012,84525
28937,3806,1838,1968,2012,84526
28938,2834,1426,1408,2012,84528
28939,89,59,30,2012,84529
28940,313,145,168,2012,84530
28941,644,295,349,2012,84531
28942,9436,4874,4562,2012,84532
28943,133,102,31,2012,84533
28944,2444,1253,1191,2012,84534
28945,2746,1399,1347,2012,84535
28946,2026,936,1090,2012,84536
28947,1301,650,651,2012,84537
28948,523,267,256,2012,84539
28949,127,46,81,2012,84540
28950,1958,944,1014,2012,84542
28951,33064,16522,16542,2012,84601
28952,47558,22558,25000,2012,84604
28953,32910,16763,16147,2012,84606
28954,1120,537,583,2012,84620
28955,233,138,95,2012,84621
28956,1450,683,767,2012,84622
28957,230,156,74,2012,84623
28958,5594,2882,2712,2012,84624
28959,226,95,131,2012,84626
28960,6376,3066,3310,2012,84627
28961,691,382,309,2012,84628
28962,3333,1896,1437,2012,84629
28963,375,181,194,2012,84630
28964,3122,1581,1541,2012,84631
28965,1021,465,556,2012,84632
28966,1127,589,538,2012,84633
28967,3405,2421,984,2012,84634
28968,872,472,400,2012,84635
28969,442,196,246,2012,84636
28970,591,327,264,2012,84637
28971,224,106,118,2012,84638
28972,1112,588,524,2012,84639
28973,176,82,94,2012,84640
28974,3459,1789,1670,2012,84642
28975,555,255,300,2012,84643
28976,2596,1335,1261,2012,84645
28977,1625,705,920,2012,84646
28978,3729,1765,1964,2012,84647
28979,5727,2812,2915,2012,84648
28980,770,428,342,2012,84649
28981,23463,11785,11678,2012,84651
28982,807,417,390,2012,84652
28983,8058,4114,3944,2012,84653
28984,2663,1323,1340,2012,84654
28985,10477,5394,5083,2012,84655
28986,303,162,141,2012,84656
28987,556,270,286,2012,84657
28988,37454,18746,18708,2012,84660
28989,1282,660,622,2012,84662
28990,30139,15289,14850,2012,84663
28991,8148,4458,3690,2012,84664
28992,478,257,221,2012,84665
28993,393,191,202,2012,84667
28994,8593,4207,4386,2012,84701
28995,179,87,92,2012,84710
28996,539,266,273,2012,84711
28997,235,144,91,2012,84712
28998,3712,1929,1783,2012,84713
28999,1045,581,464,2012,84714
29000,481,240,241,2012,84715
29001,215,121,94,2012,84716
29002,195,100,95,2012,84718
29003,27,16,11,2012,84719
29004,19726,9734,9992,2012,84720
29005,20796,10496,10300,2012,84721
29006,749,383,366,2012,84722
29007,849,369,480,2012,84723
29008,1251,620,631,2012,84724
29009,1436,763,673,2012,84725
29010,799,399,400,2012,84726
29011,260,108,152,2012,84728
29012,396,192,204,2012,84729
29013,252,154,98,2012,84730
29014,122,64,58,2012,84731
29015,16,8,8,2012,84732
29016,221,129,92,2012,84733
29017,194,85,109,2012,84734
29018,204,90,114,2012,84735
29019,268,150,118,2012,84736
29020,14726,7221,7505,2012,84737
29021,6899,3431,3468,2012,84738
29022,490,234,256,2012,84739
29023,248,136,112,2012,84740
29024,5545,2709,2836,2012,84741
29025,185,85,100,2012,84742
29026,53,33,20,2012,84743
29027,246,118,128,2012,84744
29028,4097,1924,2173,2012,84745
29029,1493,744,749,2012,84746
29030,1126,585,541,2012,84747
29031,283,150,133,2012,84749
29032,445,232,213,2012,84750
29033,1822,908,914,2012,84751
29034,953,522,431,2012,84752
29035,35,11,24,2012,84753
29036,4024,2211,1813,2012,84754
29037,109,61,48,2012,84755
29038,311,182,129,2012,84756
29039,1075,588,487,2012,84757
29040,522,212,310,2012,84758
29041,2293,1180,1113,2012,84759
29042,679,326,353,2012,84760
29043,2951,1514,1437,2012,84761
29044,245,139,106,2012,84762
29045,299,147,152,2012,84763
29046,149,52,97,2012,84764
29047,6606,3292,3314,2012,84765
29048,227,143,84,2012,84766
29049,660,237,423,2012,84767
29050,40945,20235,20710,2012,84770
29051,136,76,60,2012,84772
29052,124,62,62,2012,84773
29053,1730,795,935,2012,84774
29054,548,282,266,2012,84775
29055,754,402,352,2012,84776
29056,422,234,188,2012,84779
29057,19356,10132,9224,2012,84780
29058,147,75,72,2012,84781
29059,1006,485,521,2012,84782
29060,587,267,320,2012,84783
29061,2801,1295,1506,2012,84784
29062,34251,16547,17704,2012,84790
29063,9373,5762,3611,2012,85003
29064,4391,2408,1983,2012,85004
29065,25083,13272,11811,2012,85006
29066,13934,7020,6914,2012,85007
29067,50193,25897,24296,2012,85008
29068,49581,27578,22003,2012,85009
29069,6805,3518,3287,2012,85012
29070,20136,10074,10062,2012,85013
29071,23984,12601,11383,2012,85014
29072,40644,20869,19775,2012,85015
29073,31605,16155,15450,2012,85016
29074,41937,21776,20161,2012,85017
29075,37734,18526,19208,2012,85018
29076,25850,13291,12559,2012,85019
29077,33255,16102,17153,2012,85020
29078,38677,18692,19985,2012,85021
29079,46427,22650,23777,2012,85022
29080,32219,16586,15633,2012,85023
29081,23058,10858,12200,2012,85024
29082,36929,18983,17946,2012,85027
29083,18939,8983,9956,2012,85028
29084,44117,21671,22446,2012,85029
29085,28880,14466,14414,2012,85031
29086,70382,35564,34818,2012,85032
29087,55440,28080,27360,2012,85033
29088,4826,2433,2393,2012,85034
29089,50189,23865,26324,2012,85035
29090,46422,24035,22387,2012,85037
29091,29244,14994,14250,2012,85040
29092,55037,26949,28088,2012,85041
29093,39618,19886,19732,2012,85042
29094,29522,15152,14370,2012,85043
29095,38664,19386,19278,2012,85044
29096,8089,3841,4248,2012,85045
29097,34791,17025,17766,2012,85048
29098,26833,12712,14121,2012,85050
29099,42565,21626,20939,2012,85051
29100,28567,14715,13852,2012,85053
29101,5312,2367,2945,2012,85054
29102,18176,9203,8973,2012,85083
29103,15916,7522,8394,2012,85085
29104,39954,19779,20175,2012,85086
29105,6463,3438,3025,2012,85087
29106,12478,6042,6436,2012,85118
29107,21892,10887,11005,2012,85119
29108,26488,13372,13116,2012,85120
29109,3064,1599,1465,2012,85121
29110,51310,24532,26778,2012,85122
29111,8004,3813,4191,2012,85123
29112,15252,7435,7817,2012,85128
29113,18562,12459,6103,2012,85131
29114,34579,25072,9507,2012,85132
29115,773,421,352,2012,85135
29116,2533,1302,1231,2012,85137
29117,31722,15695,16027,2012,85138
29118,16772,8561,8211,2012,85139
29119,32540,15588,16952,2012,85140
29120,376,238,138,2012,85141
29121,49644,24640,25004,2012,85142
29122,35655,18423,17232,2012,85143
29123,1455,802,653,2012,85145
29124,5213,2722,2491,2012,85147
29125,796,507,289,2012,85172
29126,2890,1447,1443,2012,85173
29127,1674,773,901,2012,85192
29128,4352,2166,2186,2012,85193
29129,6432,3241,3191,2012,85194
29130,46312,23116,23196,2012,85201
29131,36605,17898,18707,2012,85202
29132,32979,16819,16160,2012,85203
29133,60566,29541,31025,2012,85204
29134,42426,20111,22315,2012,85205
29135,32701,14812,17889,2012,85206
29136,45911,22100,23811,2012,85207
29137,35388,16875,18513,2012,85208
29138,39927,19537,20390,2012,85209
29139,37591,19643,17948,2012,85210
29140,24373,12512,11861,2012,85212
29141,33594,16794,16800,2012,85213
29142,15524,7586,7938,2012,85215
29143,44416,22480,21936,2012,85224
29144,70715,34402,36313,2012,85225
29145,37559,18840,18719,2012,85226
29146,39117,19149,19968,2012,85233
29147,51208,24916,26292,2012,85234
29148,29985,14090,15895,2012,85248
29149,37030,17825,19205,2012,85249
29150,16276,7388,8888,2012,85250
29151,34643,16252,18391,2012,85251
29152,16995,8443,8552,2012,85253
29153,47559,22808,24751,2012,85254
29154,37663,18196,19467,2012,85255
29155,5393,2477,2916,2012,85256
29156,28843,13561,15282,2012,85257
29157,22248,10262,11986,2012,85258
29158,21855,10755,11100,2012,85259
29159,36464,17407,19057,2012,85260
29160,10567,5515,5052,2012,85262
29161,2057,1043,1014,2012,85263
29162,1184,613,571,2012,85264
29163,11129,5506,5623,2012,85266
29164,22805,11141,11664,2012,85268
29165,56005,30318,25687,2012,85281
29166,51665,26129,25536,2012,85282
29167,44975,22228,22747,2012,85283
29168,17229,8433,8796,2012,85284
29169,38664,19392,19272,2012,85286
29170,35237,17224,18013,2012,85295
29171,39680,20078,19602,2012,85296
29172,26357,12724,13633,2012,85297
29173,20856,9650,11206,2012,85298
29174,60607,30544,30063,2012,85301
29175,37146,17217,19929,2012,85302
29176,31685,16271,15414,2012,85303
29177,26935,13566,13369,2012,85304
29178,12218,6354,5864,2012,85305
29179,24406,12095,12311,2012,85306
29180,8430,4349,4081,2012,85307
29181,64923,32007,32916,2012,85308
29182,807,722,85,2012,85309
29183,20120,10296,9824,2012,85310
29184,847,428,419,2012,85320
29185,4543,2201,2342,2012,85321
29186,755,370,385,2012,85322
29187,38374,18968,19406,2012,85323
29188,2158,1102,1056,2012,85324
29189,939,446,493,2012,85325
29190,50845,26966,23879,2012,85326
29191,265,180,85,2012,85328
29192,25922,12744,13178,2012,85331
29193,1545,703,842,2012,85332
29194,584,264,320,2012,85333
29195,832,435,397,2012,85334
29196,30959,14759,16200,2012,85335
29197,537,308,229,2012,85336
29198,2584,1277,1307,2012,85337
29199,43669,22206,21463,2012,85338
29200,35236,16999,18237,2012,85339
29201,28565,14071,14494,2012,85340
29202,23,12,11,2012,85341
29203,1510,730,780,2012,85342
29204,87,43,44,2012,85343
29205,10319,5141,5178,2012,85344
29206,57929,28554,29375,2012,85345
29207,4290,2099,2191,2012,85346
29208,573,276,297,2012,85347
29209,2459,1310,1149,2012,85348
29210,23788,11483,12305,2012,85349
29211,21902,11919,9983,2012,85350
29212,28281,11887,16394,2012,85351
29213,185,79,106,2012,85352
29214,31613,15251,16362,2012,85353
29215,5292,2788,2504,2012,85354
29216,9336,4727,4609,2012,85355
29217,4582,2294,2288,2012,85356
29218,732,391,341,2012,85357
29219,225,122,103,2012,85360
29220,5442,2499,2943,2012,85361
29221,611,285,326,2012,85362
29222,6081,2786,3295,2012,85363
29223,74083,36481,37602,2012,85364
29224,48079,24739,23340,2012,85365
29225,22150,11088,11062,2012,85367
29226,624,330,294,2012,85371
29227,17583,7839,9744,2012,85373
29228,45284,21422,23862,2012,85374
29229,28645,12618,16027,2012,85375
29230,2901,1431,1470,2012,85377
29231,40239,19373,20866,2012,85379
29232,25225,11944,13281,2012,85381
29233,39254,18483,20771,2012,85382
29234,37693,19299,18394,2012,85383
29235,10181,5038,5143,2012,85387
29236,21857,11381,10476,2012,85388
29237,8977,4432,4545,2012,85390
29238,35560,17385,18175,2012,85392
29239,22568,10244,12324,2012,85395
29240,10595,5475,5120,2012,85396
29241,13551,6799,6752,2012,85501
29242,1663,777,886,2012,85530
29243,394,184,210,2012,85531
29244,2734,1405,1329,2012,85533
29245,2429,1239,1190,2012,85534
29246,11,6,5,2012,85535
29247,258,142,116,2012,85536
29248,5179,2519,2660,2012,85539
29249,3396,1843,1553,2012,85540
29250,21860,10966,10894,2012,85541
29251,3504,1680,1824,2012,85542
29252,4443,2196,2247,2012,85543
29253,2208,1009,1199,2012,85544
29254,706,346,360,2012,85545
29255,19157,10440,8717,2012,85546
29256,5217,2635,2582,2012,85550
29257,500,246,254,2012,85551
29258,6179,3154,3025,2012,85552
29259,1120,651,469,2012,85553
29260,279,141,138,2012,85554
29261,615,351,264,2012,85601
29262,9304,4866,4438,2012,85602
29263,7450,3781,3669,2012,85603
29264,467,257,210,2012,85605
29265,1490,837,653,2012,85606
29266,19128,9861,9267,2012,85607
29267,3228,3188,40,2012,85608
29268,321,117,204,2012,85609
29269,1368,872,496,2012,85610
29270,911,463,448,2012,85611
29271,5319,3219,2100,2012,85613
29272,22152,10364,11788,2012,85614
29273,9250,4269,4981,2012,85615
29274,5346,2757,2589,2012,85616
29275,1292,585,707,2012,85617
29276,1453,698,755,2012,85618
29277,32,32,0,2012,85619
29278,928,426,502,2012,85620
29279,23074,11003,12071,2012,85621
29280,6441,2817,3624,2012,85622
29281,4328,2190,2138,2012,85623
29282,1100,484,616,2012,85624
29283,1993,1010,983,2012,85625
29284,594,319,275,2012,85626
29285,1066,562,504,2012,85627
29286,22442,11276,11166,2012,85629
29287,2877,1498,1379,2012,85630
29288,3886,1965,1921,2012,85631
29289,907,469,438,2012,85632
29290,37,16,21,2012,85633
29291,6102,2967,3135,2012,85634
29292,34735,15973,18762,2012,85635
29293,1177,576,601,2012,85637
29294,2004,1071,933,2012,85638
29295,494,228,266,2012,85640
29296,21091,10121,10970,2012,85641
29297,9423,5270,4153,2012,85643
29298,1954,1040,914,2012,85645
29299,1084,573,511,2012,85646
29300,19495,9125,10370,2012,85648
29301,14867,7344,7523,2012,85650
29302,13556,6909,6647,2012,85653
29303,275,120,155,2012,85654
29304,7904,4084,3820,2012,85658
29305,4692,2283,2409,2012,85701
29306,30789,14158,16631,2012,85704
29307,54766,27868,26898,2012,85705
29308,56347,27422,28925,2012,85706
29309,574,453,121,2012,85707
29310,3196,1566,1630,2012,85708
29311,55753,26082,29671,2012,85710
29312,41628,20456,21172,2012,85711
29313,32911,15533,17378,2012,85712
29314,49356,24772,24584,2012,85713
29315,14199,7241,6958,2012,85714
29316,18769,8796,9973,2012,85715
29317,32490,16530,15960,2012,85716
29318,27786,13074,14712,2012,85718
29319,42825,20892,21933,2012,85719
29320,0,0,0,2012,85723
29321,0,0,0,2012,85724
29322,0,0,0,2012,85726
29323,38967,19559,19408,2012,85730
29324,11453,5591,5862,2012,85735
29325,4719,2491,2228,2012,85736
29326,20951,10110,10841,2012,85737
29327,17492,8488,9004,2012,85739
29328,33817,17013,16804,2012,85741
29329,25476,12532,12944,2012,85742
29330,28844,14511,14333,2012,85743
29331,38099,18132,19967,2012,85745
29332,44304,21367,22937,2012,85746
29333,22764,11531,11233,2012,85747
29334,18764,9095,9669,2012,85748
29335,19400,9563,9837,2012,85749
29336,24205,11502,12703,2012,85750
29337,15561,7288,8273,2012,85755
29338,35314,20009,15305,2012,85756
29339,17611,8765,8846,2012,85757
29340,16448,7965,8483,2012,85901
29341,1753,918,835,2012,85911
29342,38,21,17,2012,85912
29343,387,194,193,2012,85920
29344,33,18,15,2012,85922
29345,921,373,548,2012,85923
29346,2765,1492,1273,2012,85924
29347,4858,2345,2513,2012,85925
29348,172,96,76,2012,85926
29349,183,92,91,2012,85927
29350,1075,551,524,2012,85928
29351,9384,4900,4484,2012,85929
29352,725,397,328,2012,85930
29353,167,77,90,2012,85931
29354,311,169,142,2012,85932
29355,2980,1293,1687,2012,85933
29356,546,388,158,2012,85934
29357,4916,2522,2394,2012,85935
29358,4189,2403,1786,2012,85936
29359,7419,3546,3873,2012,85937
29360,2744,1268,1476,2012,85938
29361,4556,2251,2305,2012,85939
29362,1224,594,630,2012,85940
29363,10683,5551,5132,2012,85941
29364,0,0,0,2012,85942
29365,40950,21193,19757,2012,86001
29366,25,0,25,2012,86003
29367,38731,19011,19720,2012,86004
29368,6320,2669,3651,2012,86011
29369,75,21,54,2012,86015
29370,102,73,29,2012,86016
29371,1028,509,519,2012,86017
29372,541,263,278,2012,86018
29373,1924,878,1046,2012,86020
29374,5738,2607,3131,2012,86021
29375,1937,978,959,2012,86022
29376,1420,810,610,2012,86023
29377,513,264,249,2012,86024
29378,5581,2735,2846,2012,86025
29379,0,0,0,2012,86028
29380,139,91,48,2012,86029
29381,1631,722,909,2012,86030
29382,1976,932,1044,2012,86031
29383,1280,624,656,2012,86032
29384,7366,3597,3769,2012,86033
29385,2233,1153,1080,2012,86034
29386,1725,818,907,2012,86035
29387,362,149,213,2012,86036
29388,26,26,0,2012,86038
29389,1309,587,722,2012,86039
29390,10401,5561,4840,2012,86040
29391,2094,976,1118,2012,86042
29392,1772,800,972,2012,86043
29393,3893,1864,2029,2012,86044
29394,11966,5531,6435,2012,86045
29395,6031,3040,2991,2012,86046
29396,15357,8532,6825,2012,86047
29397,24,15,9,2012,86052
29398,2611,1312,1299,2012,86053
29399,1659,835,824,2012,86054
29400,21620,10864,10756,2012,86301
29401,16633,8114,8519,2012,86303
29402,18873,9443,9430,2012,86305
29403,79,79,0,2012,86313
29404,34520,17253,17267,2012,86314
29405,6521,3014,3507,2012,86315
29406,1810,934,876,2012,86320
29407,2296,1324,972,2012,86321
29408,11307,5447,5860,2012,86322
29409,16781,8106,8675,2012,86323
29410,4052,1888,2164,2012,86324
29411,4638,2350,2288,2012,86325
29412,25026,12157,12869,2012,86326
29413,9421,4574,4847,2012,86327
29414,716,441,275,2012,86329
29415,490,301,189,2012,86331
29416,1686,806,880,2012,86332
29417,5105,2566,2539,2012,86333
29418,4218,2102,2116,2012,86334
29419,5105,2349,2756,2012,86335
29420,10925,4818,6107,2012,86336
29421,731,360,371,2012,86337
29422,477,258,219,2012,86338
29423,56,29,27,2012,86343
29424,6490,3086,3404,2012,86351
29425,25950,12870,13080,2012,86401
29426,15665,7518,8147,2012,86403
29427,16567,8120,8447,2012,86404
29428,24045,11474,12571,2012,86406
29429,26364,13186,13178,2012,86409
29430,114,63,51,2012,86411
29431,14464,9289,5175,2012,86413
29432,13950,6598,7352,2012,86426
29433,6764,3583,3181,2012,86429
29434,303,220,83,2012,86431
29435,2540,1231,1309,2012,86432
29436,136,76,60,2012,86433
29437,920,450,470,2012,86434
29438,222,118,104,2012,86435
29439,1875,763,1112,2012,86436
29440,58,34,24,2012,86437
29441,513,250,263,2012,86438
29442,7539,3653,3886,2012,86440
29443,1848,1025,823,2012,86441
29444,33602,16829,16773,2012,86442
29445,0,0,0,2012,86443
29446,917,517,400,2012,86444
29447,350,190,160,2012,86445
29448,1424,775,649,2012,86502
29449,10648,5302,5346,2012,86503
29450,6190,3150,3040,2012,86504
29451,8182,3995,4187,2012,86505
29452,1595,743,852,2012,86506
29453,2311,1122,1189,2012,86507
29454,902,476,426,2012,86508
29455,5138,2385,2753,2012,86510
29456,2974,1573,1401,2012,86511
29457,3041,1367,1674,2012,86512
29458,2806,1319,1487,2012,86514
29459,4662,2131,2531,2012,86515
29460,1765,841,924,2012,86520
29461,1112,645,467,2012,86535
29462,2410,1189,1221,2012,86538
29463,979,457,522,2012,86540
29464,1412,749,663,2012,86544
29465,1479,694,785,2012,86545
29466,1298,571,727,2012,86547
29467,1792,851,941,2012,86556
29468,3817,1916,1901,2012,87001
29469,23069,11520,11549,2012,87002
29470,10512,5153,5359,2012,87004
29471,553,256,297,2012,87005
29472,741,456,285,2012,87006
29473,794,534,260,2012,87007
29474,3171,1605,1566,2012,87008
29475,975,555,420,2012,87010
29476,16,16,0,2012,87011
29477,298,160,138,2012,87012
29478,4495,2344,2151,2012,87013
29479,494,192,302,2012,87014
29480,12886,6538,6348,2012,87015
29481,4028,2321,1707,2012,87016
29482,380,207,173,2012,87017
29483,423,219,204,2012,87018
29484,11166,5628,5538,2012,87020
29485,3215,1996,1219,2012,87021
29486,733,380,353,2012,87022
29487,473,229,244,2012,87023
29488,2192,1062,1130,2012,87024
29489,1119,562,557,2012,87025
29490,3858,1780,2078,2012,87026
29491,275,127,148,2012,87027
29492,341,171,170,2012,87028
29493,219,122,97,2012,87029
29494,43432,22351,21081,2012,87031
29495,0,0,0,2012,87032
29496,2231,992,1239,2012,87034
29497,7877,3846,4031,2012,87035
29498,1755,858,897,2012,87036
29499,623,281,342,2012,87037
29500,534,311,223,2012,87038
29501,631,299,332,2012,87040
29502,691,342,349,2012,87041
29503,3702,1864,1838,2012,87042
29504,5505,2575,2930,2012,87043
29505,576,299,277,2012,87044
29506,1239,745,494,2012,87045
29507,27,10,17,2012,87046
29508,5166,2585,2581,2012,87047
29509,9045,4444,4601,2012,87048
29510,1401,475,926,2012,87049
29511,940,590,350,2012,87051
29512,3056,1529,1527,2012,87052
29513,1046,513,533,2012,87053
29514,1580,871,709,2012,87056
29515,9588,4850,4738,2012,87059
29516,282,176,106,2012,87061
29517,2019,964,1055,2012,87062
29518,201,101,100,2012,87063
29519,128,27,101,2012,87064
29520,4708,2191,2517,2012,87068
29521,60,28,32,2012,87070
29522,462,233,229,2012,87072
29523,514,233,281,2012,87083
29524,20550,10859,9691,2012,87102
29525,11967,5550,6417,2012,87104
29526,58735,29636,29099,2012,87105
29527,25965,13126,12839,2012,87106
29528,31054,15479,15575,2012,87107
29529,36143,17591,18552,2012,87108
29530,40213,19113,21100,2012,87109
29531,38842,18621,20221,2012,87110
29532,57153,26772,30381,2012,87111
29533,43719,20846,22873,2012,87112
29534,15571,7352,8219,2012,87113
29535,62550,30839,31711,2012,87114
29536,4168,2380,1788,2012,87116
29537,253,216,37,2012,87117
29538,59124,28881,30243,2012,87120
29539,74413,36525,37888,2012,87121
29540,17923,8961,8962,2012,87122
29541,42270,20727,21543,2012,87123
29542,50058,23838,26220,2012,87124
29543,38494,19472,19022,2012,87144
29544,23601,11704,11897,2012,87301
29545,3238,1501,1737,2012,87305
29546,787,383,404,2012,87310
29547,3041,1508,1533,2012,87311
29548,362,170,192,2012,87312
29549,5914,2820,3094,2012,87313
29550,89,0,89,2012,87315
29551,1293,689,604,2012,87316
29552,1213,495,718,2012,87317
29553,2445,1096,1349,2012,87319
29554,729,319,410,2012,87320
29555,1706,920,786,2012,87321
29556,192,55,137,2012,87322
29557,4874,2419,2455,2012,87323
29558,2937,1387,1550,2012,87325
29559,1975,975,1000,2012,87326
29560,11392,5609,5783,2012,87327
29561,3189,1439,1750,2012,87328
29562,283,139,144,2012,87347
29563,716,309,407,2012,87357
29564,1164,574,590,2012,87364
29565,2870,1452,1418,2012,87375
29566,46531,22826,23705,2012,87401
29567,10989,5546,5443,2012,87402
29568,16755,8187,8568,2012,87410
29569,811,499,312,2012,87412
29570,16015,8165,7850,2012,87413
29571,2291,1007,1284,2012,87415
29572,5294,2697,2597,2012,87416
29573,5549,2769,2780,2012,87417
29574,1605,750,855,2012,87418
29575,238,149,89,2012,87419
29576,12955,6573,6382,2012,87420
29577,1675,781,894,2012,87421
29578,1747,849,898,2012,87455
29579,1464,760,704,2012,87461
29580,397,206,191,2012,87499
29581,15767,7219,8548,2012,87501
29582,29597,14286,15311,2012,87505
29583,13181,6409,6772,2012,87506
29584,46347,22686,23661,2012,87507
29585,18513,8980,9533,2012,87508
29586,577,310,267,2012,87510
29587,3129,1613,1516,2012,87511
29588,207,104,103,2012,87512
29589,818,301,517,2012,87513
29590,1461,775,686,2012,87514
29591,294,175,119,2012,87515
29592,140,63,77,2012,87516
29593,105,71,34,2012,87517
29594,58,21,37,2012,87518
29595,824,410,414,2012,87519
29596,1628,892,736,2012,87520
29597,834,411,423,2012,87521
29598,3013,1475,1538,2012,87522
29599,334,147,187,2012,87523
29600,144,51,93,2012,87524
29601,65,38,27,2012,87525
29602,709,310,399,2012,87527
29603,3391,1536,1855,2012,87528
29604,5027,2135,2892,2012,87529
29605,677,406,271,2012,87530
29606,444,232,212,2012,87531
29607,17573,8734,8839,2012,87532
29608,132,41,91,2012,87533
29609,802,344,458,2012,87535
29610,3286,1570,1716,2012,87537
29611,246,124,122,2012,87538
29612,332,163,169,2012,87539
29613,1196,509,687,2012,87540
29614,733,351,382,2012,87543
29615,18008,9022,8986,2012,87544
29616,1066,551,515,2012,87548
29617,979,391,588,2012,87549
29618,416,245,171,2012,87551
29619,3713,1947,1766,2012,87552
29620,1157,647,510,2012,87553
29621,57,40,17,2012,87554
29622,2118,1078,1040,2012,87556
29623,6453,3415,3038,2012,87557
29624,515,280,235,2012,87558
29625,1264,510,754,2012,87560
29626,545,282,263,2012,87562
29627,394,212,182,2012,87564
29628,258,131,127,2012,87565
29629,3024,1582,1442,2012,87566
29630,1633,772,861,2012,87567
29631,354,130,224,2012,87569
29632,10357,4937,5420,2012,87571
29633,0,0,0,2012,87573
29634,105,62,43,2012,87574
29635,592,351,241,2012,87575
29636,37,23,14,2012,87577
29637,992,481,511,2012,87578
29638,972,544,428,2012,87579
29639,580,311,269,2012,87580
29640,107,87,20,2012,87581
29641,1669,670,999,2012,87582
29642,86,53,33,2012,87583
29643,19887,9729,10158,2012,87701
29644,1982,921,1061,2012,87710
29645,636,325,311,2012,87711
29646,80,40,40,2012,87712
29647,197,81,116,2012,87713
29648,1020,499,521,2012,87714
29649,762,399,363,2012,87715
29650,580,379,201,2012,87718
29651,335,139,196,2012,87722
29652,307,172,135,2012,87723
29653,0,0,0,2012,87724
29654,281,150,131,2012,87728
29655,92,41,51,2012,87729
29656,12,9,3,2012,87730
29657,512,386,126,2012,87731
29658,1378,821,557,2012,87732
29659,194,107,87,2012,87733
29660,135,76,59,2012,87734
29661,45,26,19,2012,87735
29662,385,157,228,2012,87736
29663,7757,3842,3915,2012,87740
29664,924,355,569,2012,87742
29665,296,143,153,2012,87743
29666,1212,594,618,2012,87745
29667,38,17,21,2012,87746
29668,1717,983,734,2012,87747
29669,129,74,55,2012,87749
29670,37,37,0,2012,87750
29671,651,331,320,2012,87752
29672,194,128,66,2012,87753
29673,9919,5203,4716,2012,87801
29674,115,67,48,2012,87820
29675,698,388,310,2012,87821
29676,899,398,501,2012,87823
29677,302,191,111,2012,87824
29678,2141,1153,988,2012,87825
29679,153,81,72,2012,87827
29680,710,378,332,2012,87828
29681,767,445,322,2012,87829
29682,1396,742,654,2012,87830
29683,318,136,182,2012,87831
29684,887,341,546,2012,87832
29685,7066,3398,3668,2012,87901
29686,1476,759,717,2012,87930
29687,500,206,294,2012,87931
29688,49,42,7,2012,87933
29689,1360,661,699,2012,87935
29690,432,257,175,2012,87936
29691,2102,1049,1053,2012,87937
29692,187,170,17,2012,87939
29693,451,147,304,2012,87940
29694,1008,422,586,2012,87941
29695,758,484,274,2012,87942
29696,236,90,146,2012,87943
29697,36543,18228,18315,2012,88001
29698,1661,875,786,2012,88002
29699,1129,627,502,2012,88003
29700,282,282,0,2012,88004
29701,27552,13650,13902,2012,88005
29702,27447,13023,14424,2012,88007
29703,6215,3011,3204,2012,88008
29704,210,85,125,2012,88009
29705,26275,12879,13396,2012,88011
29706,26771,13353,13418,2012,88012
29707,612,290,322,2012,88020
29708,17341,8146,9195,2012,88021
29709,1113,530,583,2012,88022
29710,2763,1313,1450,2012,88023
29711,253,166,87,2012,88024
29712,441,205,236,2012,88025
29713,1473,722,751,2012,88026
29714,610,279,331,2012,88027
29715,536,281,255,2012,88028
29716,1621,694,927,2012,88029
29717,23541,11779,11762,2012,88030
29718,117,54,63,2012,88032
29719,15,15,0,2012,88033
29720,89,43,46,2012,88034
29721,490,265,225,2012,88038
29722,255,108,147,2012,88039
29723,93,51,42,2012,88040
29724,1142,584,558,2012,88041
29725,324,153,171,2012,88042
29726,1692,888,804,2012,88043
29727,4339,2189,2150,2012,88044
29728,3906,1940,1966,2012,88045
29729,773,447,326,2012,88046
29730,2003,977,1026,2012,88047
29731,3668,1750,1918,2012,88048
29732,299,137,162,2012,88049
29733,18,10,8,2012,88051
29734,49,25,24,2012,88052
29735,75,46,29,2012,88053
29736,10,10,0,2012,88055
29737,130,94,36,2012,88056
29738,18568,9136,9432,2012,88061
29739,12795,5940,6855,2012,88063
29740,845,381,464,2012,88065
29741,2712,1332,1380,2012,88072
29742,14041,7222,6819,2012,88081
29743,45048,22759,22289,2012,88101
29744,273,141,132,2012,88103
29745,193,95,98,2012,88112
29746,134,55,79,2012,88113
29747,28,18,10,2012,88114
29748,20,8,12,2012,88115
29749,382,175,207,2012,88116
29750,250,121,129,2012,88118
29751,1968,916,1052,2012,88119
29752,215,104,111,2012,88120
29753,138,69,69,2012,88121
29754,1097,508,589,2012,88124
29755,77,37,40,2012,88125
29756,66,36,30,2012,88126
29757,18610,9501,9109,2012,88130
29758,218,115,103,2012,88132
29759,53,26,27,2012,88134
29760,1448,705,743,2012,88135
29761,48,31,17,2012,88136
29762,25271,12326,12945,2012,88201
29763,31257,15156,16101,2012,88203
29764,16870,8269,8601,2012,88210
29765,34172,17160,17012,2012,88220
29766,5393,2826,2567,2012,88230
29767,3126,1639,1487,2012,88231
29768,2590,1562,1028,2012,88232
29769,36842,18524,18318,2012,88240
29770,6966,3789,3177,2012,88242
29771,125,68,57,2012,88250
29772,1979,1004,975,2012,88252
29773,912,511,401,2012,88253
29774,89,48,41,2012,88254
29775,79,48,31,2012,88255
29776,2068,996,1072,2012,88256
29777,14341,7438,6903,2012,88260
29778,7,4,3,2012,88262
29779,67,43,24,2012,88263
29780,0,0,0,2012,88264
29781,293,204,89,2012,88265
29782,1088,514,574,2012,88267
29783,0,0,0,2012,88268
29784,1421,824,597,2012,88301
29785,36038,18062,17976,2012,88310
29786,1528,850,678,2012,88311
29787,3208,1454,1754,2012,88312
29788,230,136,94,2012,88314
29789,2156,1054,1102,2012,88316
29790,1551,749,802,2012,88317
29791,343,191,152,2012,88318
29792,119,55,64,2012,88321
29793,21,14,7,2012,88323
29794,186,121,65,2012,88324
29795,956,468,488,2012,88325
29796,3585,1956,1629,2012,88330
29797,250,149,101,2012,88336
29798,2340,1153,1187,2012,88337
29799,105,49,56,2012,88338
29800,727,408,319,2012,88339
29801,3834,1812,2022,2012,88340
29802,353,99,254,2012,88341
29803,24,14,10,2012,88342
29804,13,5,8,2012,88343
29805,214,98,116,2012,88344
29806,8768,4276,4492,2012,88345
29807,3145,1563,1582,2012,88346
29808,164,87,77,2012,88347
29809,264,162,102,2012,88348
29810,30,16,14,2012,88349
29811,295,154,141,2012,88350
29812,251,111,140,2012,88351
29813,4801,2539,2262,2012,88352
29814,532,225,307,2012,88353
29815,173,83,90,2012,88354
29816,0,0,0,2012,88355
29817,6669,3238,3431,2012,88401
29818,99,78,21,2012,88410
29819,68,37,31,2012,88411
29820,95,46,49,2012,88414
29821,3422,1973,1449,2012,88415
29822,199,101,98,2012,88416
29823,58,15,43,2012,88417
29824,468,226,242,2012,88418
29825,256,110,146,2012,88419
29826,0,0,0,2012,88421
29827,35,17,18,2012,88422
29828,75,53,22,2012,88424
29829,1243,610,633,2012,88426
29830,136,75,61,2012,88427
29831,157,76,81,2012,88430
29832,35,15,20,2012,88431
29833,584,247,337,2012,88434
29834,3496,1940,1556,2012,88435
29835,89,32,57,2012,88436
29836,1038,500,538,2012,89001
29837,33146,16427,16719,2012,89002
29838,1011,629,382,2012,89003
29839,399,158,241,2012,89004
29840,15186,7932,7254,2012,89005
29841,1153,562,591,2012,89007
29842,1463,708,755,2012,89008
29843,281,150,131,2012,89010
29844,17690,8611,9079,2012,89011
29845,27936,13707,14229,2012,89012
29846,366,226,140,2012,89013
29847,37333,17915,19418,2012,89014
29848,38910,19359,19551,2012,89015
29849,188,89,99,2012,89017
29850,5637,5145,492,2012,89018
29851,1882,1070,812,2012,89019
29852,1077,644,433,2012,89020
29853,3037,1482,1555,2012,89021
29854,121,61,60,2012,89022
29855,1011,537,474,2012,89025
29856,573,468,105,2012,89026
29857,15366,7695,7671,2012,89027
29858,7169,3682,3487,2012,89029
29859,51857,26627,25230,2012,89030
29860,60297,29651,30646,2012,89031
29861,41233,20626,20607,2012,89032
29862,165,65,100,2012,89039
29863,3901,1749,2152,2012,89040
29864,1364,680,684,2012,89042
29865,1229,749,480,2012,89043
29866,14989,6963,8026,2012,89044
29867,1830,856,974,2012,89045
29868,517,319,198,2012,89046
29869,173,79,94,2012,89047
29870,20668,10229,10439,2012,89048
29871,3212,1698,1514,2012,89049
29872,48587,22856,25731,2012,89052
29873,150,95,55,2012,89054
29874,10623,5297,5326,2012,89060
29875,4552,2400,2152,2012,89061
29876,47794,23876,23918,2012,89074
29877,30045,14525,15520,2012,89081
29878,20379,10401,9978,2012,89084
29879,3950,1840,2110,2012,89085
29880,4784,2519,2265,2012,89086
29881,45219,25896,19323,2012,89101
29882,38143,20292,17851,2012,89102
29883,50057,26380,23677,2012,89103
29884,39608,21015,18593,2012,89104
29885,27004,13117,13887,2012,89106
29886,36534,18477,18057,2012,89107
29887,67208,34279,32929,2012,89108
29888,6904,3588,3316,2012,89109
29889,72269,36125,36144,2012,89110
29890,23964,12214,11750,2012,89113
29891,60509,31273,29236,2012,89115
29892,54900,26511,28389,2012,89117
29893,19640,9620,10020,2012,89118
29894,44392,23789,20603,2012,89119
29895,22382,11141,11241,2012,89120
29896,61813,31399,30414,2012,89121
29897,46004,22944,23060,2012,89122
29898,58968,29362,29606,2012,89123
29899,688,310,378,2012,89124
29900,37479,17557,19922,2012,89128
29901,52735,25404,27331,2012,89129
29902,30088,14772,15316,2012,89130
29903,45309,22867,22442,2012,89131
29904,26296,12517,13779,2012,89134
29905,24147,12474,11673,2012,89135
29906,12619,6434,6185,2012,89138
29907,31706,17076,14630,2012,89139
29908,27593,13850,13743,2012,89141
29909,32262,15685,16577,2012,89142
29910,10650,5146,5504,2012,89143
29911,19641,8902,10739,2012,89144
29912,23231,11287,11944,2012,89145
29913,19386,10317,9069,2012,89146
29914,51131,25181,25950,2012,89147
29915,39926,19516,20410,2012,89148
29916,32040,16450,15590,2012,89149
29917,27747,13641,14106,2012,89156
29918,102,55,47,2012,89161
29919,9776,5426,4350,2012,89166
29920,23183,12045,11138,2012,89169
29921,26198,13219,12979,2012,89178
29922,2132,1100,1032,2012,89179
29923,37323,18054,19269,2012,89183
29924,824,697,127,2012,89191
29925,6698,3700,2998,2012,89301
29926,520,307,213,2012,89310
29927,130,74,56,2012,89311
29928,224,111,113,2012,89314
29929,1560,781,779,2012,89316
29930,622,239,383,2012,89317
29931,1608,836,772,2012,89318
29932,816,426,390,2012,89319
29933,0,0,0,2012,89402
29934,14146,7011,7135,2012,89403
29935,0,0,0,2012,89404
29936,184,136,48,2012,89405
29937,24779,12354,12425,2012,89406
29938,19090,9534,9556,2012,89408
29939,149,89,60,2012,89409
29940,10809,5615,5194,2012,89410
29941,731,273,458,2012,89411
29942,223,109,114,2012,89412
29943,414,186,228,2012,89413
29944,288,144,144,2012,89414
29945,3901,1996,1905,2012,89415
29946,207,119,88,2012,89418
29947,5491,3682,1809,2012,89419
29948,35,9,26,2012,89420
29949,685,381,304,2012,89421
29950,94,50,44,2012,89422
29951,11088,5503,5585,2012,89423
29952,309,172,137,2012,89424
29953,807,424,383,2012,89425
29954,255,123,132,2012,89426
29955,688,327,361,2012,89427
29956,176,120,56,2012,89428
29957,7363,3851,3512,2012,89429
29958,215,121,94,2012,89430
29959,37047,18447,18600,2012,89431
29960,19440,9483,9957,2012,89433
29961,25109,12161,12948,2012,89434
29962,36078,17989,18089,2012,89436
29963,0,0,0,2012,89438
29964,1643,855,788,2012,89439
29965,866,398,468,2012,89440
29966,11982,5826,6156,2012,89441
29967,953,432,521,2012,89442
29968,2717,1374,1343,2012,89444
29969,15445,8064,7381,2012,89445
29970,124,80,44,2012,89446
29971,8402,4439,3963,2012,89447
29972,1268,630,638,2012,89448
29973,2561,1410,1151,2012,89449
29974,134,78,56,2012,89450
29975,7993,4468,3525,2012,89451
29976,13496,6778,6718,2012,89460
29977,3292,1998,1294,2012,89501
29978,44830,23390,21440,2012,89502
29979,29114,15822,13292,2012,89503
29980,41813,21075,20738,2012,89506
29981,11312,5894,5418,2012,89508
29982,33016,15963,17053,2012,89509
29983,1685,876,809,2012,89510
29984,25822,13211,12611,2012,89511
29985,24049,12584,11465,2012,89512
29986,8166,4016,4150,2012,89519
29987,24258,11934,12324,2012,89521
29988,31178,14871,16307,2012,89523
29989,26669,13700,12969,2012,89701
29990,192,192,0,2012,89702
29991,10099,5319,4780,2012,89703
29992,4735,2331,2404,2012,89704
29993,5218,2448,2770,2012,89705
29994,20034,10041,9993,2012,89706
29995,22320,11362,10958,2012,89801
29996,14161,7521,6640,2012,89815
29997,5596,2957,2639,2012,89820
29998,298,186,112,2012,89821
29999,2658,1588,1070,2012,89822
30000,27,17,10,2012,89823
30001,1410,668,742,2012,89825
30002,182,55,127,2012,89826
30003,337,140,197,2012,89828
30004,194,95,99,2012,89830
30005,28,14,14,2012,89831
30006,1410,846,564,2012,89832
30007,156,94,62,2012,89833
30008,181,105,76,2012,89834
30009,1795,921,874,2012,89835
30010,4494,2329,2165,2012,89883
30011,54480,26745,27735,2012,90001
30012,48613,23552,25061,2012,90002
30013,67226,32957,34269,2012,90003
30014,62884,31588,31296,2012,90004
30015,39592,20861,18731,2012,90005
30016,58849,30579,28270,2012,90006
30017,43653,21389,22264,2012,90007
30018,33754,15038,18716,2012,90008
30019,3835,1869,1966,2012,90010
30020,100671,50761,49910,2012,90011
30021,29164,17550,11614,2012,90012
30022,9318,5833,3485,2012,90013
30023,5556,3261,2295,2012,90014
30024,17668,9397,8271,2012,90015
30025,46779,22034,24745,2012,90016
30026,23171,12220,10951,2012,90017
30027,48497,22983,25514,2012,90018
30028,64613,31416,33197,2012,90019
30029,41086,20295,20791,2012,90020
30030,2664,1841,823,2012,90021
30031,68657,34249,34408,2012,90022
30032,45663,22872,22791,2012,90023
30033,50269,23292,26977,2012,90024
30034,42932,21974,20958,2012,90025
30035,69615,35165,34450,2012,90026
30036,45702,22877,22825,2012,90027
30037,28254,15737,12517,2012,90028
30038,39437,20350,19087,2012,90029
30039,39990,19903,20087,2012,90031
30040,49242,24600,24642,2012,90032
30041,49048,24280,24768,2012,90033
30042,59305,30146,29159,2012,90034
30043,30553,14186,16367,2012,90035
30044,35942,17867,18075,2012,90036
30045,60867,30234,30633,2012,90037
30046,30225,15510,14715,2012,90038
30047,28260,14828,13432,2012,90039
30048,12692,6294,6398,2012,90040
30049,28571,13405,15166,2012,90041
30050,62303,30532,31771,2012,90042
30051,43761,20160,23601,2012,90043
30052,85940,40931,45009,2012,90044
30053,40535,20251,20284,2012,90045
30054,49937,26127,23810,2012,90046
30055,47857,21960,25897,2012,90047
30056,20793,9887,10906,2012,90048
30057,36107,16531,19576,2012,90049
30058,8628,3777,4851,2012,90056
30059,44871,24211,20660,2012,90057
30060,3289,1548,1741,2012,90058
30061,40305,18663,21642,2012,90059
30062,26621,12628,13993,2012,90061
30063,31569,14390,17179,2012,90062
30064,53994,27112,26882,2012,90063
30065,25894,12180,13714,2012,90064
30066,45816,23605,22211,2012,90065
30067,56107,27741,28366,2012,90066
30068,2257,840,1417,2012,90067
30069,22270,12285,9985,2012,90068
30070,20328,11709,8619,2012,90069
30071,0,0,0,2012,90071
30072,623,514,109,2012,90073
30073,8262,3844,4418,2012,90077
30074,0,0,0,2012,90079
30075,3402,1473,1929,2012,90089
30076,0,0,0,2012,90090
30077,5567,2647,2920,2012,90094
30078,0,0,0,2012,90095
30079,101647,51883,49764,2012,90201
30080,21517,10238,11279,2012,90210
30081,7889,3384,4505,2012,90211
30082,12306,5653,6653,2012,90212
30083,50947,24007,26940,2012,90220
30084,51350,24796,26554,2012,90221
30085,30990,15225,15765,2012,90222
30086,32508,15123,17385,2012,90230
30087,15248,7712,7536,2012,90232
30088,25258,12552,12706,2012,90240
30089,43786,21374,22412,2012,90241
30090,42763,21398,21365,2012,90242
30091,16678,8450,8228,2012,90245
30092,46590,21711,24879,2012,90247
30093,9904,4982,4922,2012,90248
30094,26790,13024,13766,2012,90249
30095,93925,45778,48147,2012,90250
30096,19535,10406,9129,2012,90254
30097,75961,37789,38172,2012,90255
30098,35014,17871,17143,2012,90260
30099,69734,33251,36483,2012,90262
30100,1847,727,1120,2012,90263
30101,17749,9132,8617,2012,90265
30102,35226,17504,17722,2012,90266
30103,27443,13981,13462,2012,90270
30104,22893,11090,11803,2012,90272
30105,25387,12187,13200,2012,90274
30106,41903,20162,21741,2012,90275
30107,33972,16830,17142,2012,90277
30108,40867,19445,21422,2012,90278
30109,94703,46345,48358,2012,90280
30110,6983,3179,3804,2012,90290
30111,26961,14047,12914,2012,90291
30112,22350,10458,11892,2012,90292
30113,12129,5701,6428,2012,90293
30114,37165,18262,18903,2012,90301
30115,30344,14129,16215,2012,90302
30116,25828,12364,13464,2012,90303
30117,27198,14092,13106,2012,90304
30118,14896,6347,8549,2012,90305
30119,6766,3761,3005,2012,90401
30120,12351,5827,6524,2012,90402
30121,24286,11253,13033,2012,90403
30122,20739,9852,10887,2012,90404
30123,28114,13406,14708,2012,90405
30124,42363,20450,21913,2012,90501
30125,16845,8080,8765,2012,90502
30126,46253,22522,23731,2012,90503
30127,31650,15912,15738,2012,90504
30128,36135,17164,18971,2012,90505
30129,0,0,0,2012,90506
30130,32630,16579,16051,2012,90601
30131,25923,12678,13245,2012,90602
30132,19933,9633,10300,2012,90603
30133,40483,19981,20502,2012,90604
30134,40698,19978,20720,2012,90605
30135,32998,16376,16622,2012,90606
30136,44295,21327,22968,2012,90620
30137,35994,17493,18501,2012,90621
30138,15528,7246,8282,2012,90623
30139,48292,23110,25182,2012,90630
30140,67929,33429,34500,2012,90631
30141,49062,24021,25041,2012,90638
30142,62965,30508,32457,2012,90640
30143,105603,53509,52094,2012,90650
30144,63106,30748,32358,2012,90660
30145,15265,7674,7591,2012,90670
30146,30369,14706,15663,2012,90680
30147,16597,8428,8169,2012,90701
30148,49551,23723,25828,2012,90703
30149,3999,2021,1978,2012,90704
30150,76619,37333,39286,2012,90706
30151,27486,13077,14409,2012,90710
30152,31334,14709,16625,2012,90712
30153,27562,13817,13745,2012,90713
30154,21129,10541,10588,2012,90715
30155,14203,7093,7110,2012,90716
30156,21347,10209,11138,2012,90717
30157,21710,10337,11373,2012,90720
30158,54255,26798,27457,2012,90723
30159,59270,28951,30319,2012,90731
30160,19895,9069,10826,2012,90732
30161,23789,10721,13068,2012,90740
30162,968,525,443,2012,90742
30163,411,203,208,2012,90743
30164,57441,28958,28483,2012,90744
30165,58090,28392,29698,2012,90745
30166,25861,12280,13581,2012,90746
30167,0,0,0,2012,90747
30168,10994,5303,5691,2012,90755
30169,39017,20684,18333,2012,90802
30170,30855,14498,16357,2012,90803
30171,41094,19890,21204,2012,90804
30172,93117,45502,47615,2012,90805
30173,42873,20899,21974,2012,90806
30174,32176,15954,16222,2012,90807
30175,39064,19186,19878,2012,90808
30176,36935,18185,18750,2012,90810
30177,58719,29751,28968,2012,90813
30178,18633,9404,9229,2012,90814
30179,40502,19877,20625,2012,90815
30180,183,137,46,2012,90822
30181,0,0,0,2012,90831
30182,38066,18173,19893,2012,91001
30183,32339,15476,16863,2012,91006
30184,33836,15954,17882,2012,91007
30185,1122,543,579,2012,91008
30186,24913,11948,12965,2012,91010
30187,20468,9945,10523,2012,91011
30188,41610,19958,21652,2012,91016
30189,8462,4033,4429,2012,91020
30190,10939,5360,5579,2012,91024
30191,25603,12188,13415,2012,91030
30192,19903,10093,9810,2012,91040
30193,28266,13940,14326,2012,91042
30194,141,13,128,2012,91046
30195,21545,10729,10816,2012,91101
30196,27127,13209,13918,2012,91103
30197,36961,18291,18670,2012,91104
30198,10891,5163,5728,2012,91105
30199,24494,12590,11904,2012,91106
30200,31737,15796,15941,2012,91107
30201,13297,6173,7124,2012,91108
30202,23671,11655,12016,2012,91201
30203,22533,10499,12034,2012,91202
30204,13360,6284,7076,2012,91203
30205,16241,7866,8375,2012,91204
30206,38362,18750,19612,2012,91205
30207,32474,15378,17096,2012,91206
30208,10613,5575,5038,2012,91207
30209,15655,7608,8047,2012,91208
30210,228,89,139,2012,91210
30211,31479,15276,16203,2012,91214
30212,25834,13136,12698,2012,91301
30213,24910,12110,12800,2012,91302
30214,26613,13627,12986,2012,91303
30215,52907,25350,27557,2012,91304
30216,47048,24115,22933,2012,91306
30217,24983,12725,12258,2012,91307
30218,37945,18269,19676,2012,91311
30219,26368,12528,13840,2012,91316
30220,45433,22807,22626,2012,91320
30221,35148,18178,16970,2012,91321
30222,26742,12971,13771,2012,91324
30223,33268,16382,16886,2012,91325
30224,35691,16898,18793,2012,91326
30225,1470,604,866,2012,91330
30226,96965,48599,48366,2012,91331
30227,74641,37193,37448,2012,91335
30228,35207,17521,17686,2012,91340
30229,89001,44384,44617,2012,91342
30230,60759,30930,29829,2012,91343
30231,53014,25827,27187,2012,91344
30232,18654,9265,9389,2012,91345
30233,34293,17162,17131,2012,91350
30234,31936,16177,15759,2012,91351
30235,45494,22255,23239,2012,91352
30236,28392,14546,13846,2012,91354
30237,33203,16691,16512,2012,91355
30238,29590,14138,15452,2012,91356
30239,42937,20788,22149,2012,91360
30240,19731,9427,10304,2012,91361
30241,35485,17199,18286,2012,91362
30242,25947,12766,13181,2012,91364
30243,40323,19202,21121,2012,91367
30244,0,0,0,2012,91371
30245,14423,6910,7513,2012,91377
30246,19673,9738,9935,2012,91381
30247,29155,17926,11229,2012,91384
30248,40375,19894,20481,2012,91387
30249,20050,10093,9957,2012,91390
30250,40085,20286,19799,2012,91401
30251,70749,35371,35378,2012,91402
30252,23377,11484,11893,2012,91403
30253,54185,27181,27004,2012,91405
30254,53129,27062,26067,2012,91406
30255,23708,12545,11163,2012,91411
30256,30946,15202,15744,2012,91423
30257,14508,6817,7691,2012,91436
30258,20546,9896,10650,2012,91501
30259,11340,5261,6079,2012,91502
30260,25527,12186,13341,2012,91504
30261,30563,15057,15506,2012,91505
30262,18906,9447,9459,2012,91506
30263,37090,19561,17529,2012,91601
30264,17115,8414,8701,2012,91602
30265,28323,13822,14501,2012,91604
30266,55313,27580,27733,2012,91605
30267,46880,24011,22869,2012,91606
30268,28821,14004,14817,2012,91607
30269,0,0,0,2012,91608
30270,40553,19780,20773,2012,91701
30271,60284,29612,30672,2012,91702
30272,77028,38480,38548,2012,91706
30273,3840,1035,2805,2012,91708
30274,75211,37277,37934,2012,91709
30275,80801,42212,38589,2012,91710
30276,35857,17043,18814,2012,91711
30277,35408,17483,17925,2012,91722
30278,18713,8714,9999,2012,91723
30279,24935,12352,12583,2012,91724
30280,65610,32322,33288,2012,91730
30281,29703,15581,14122,2012,91731
30282,61832,31031,30801,2012,91732
30283,43902,21544,22358,2012,91733
30284,24254,11682,12572,2012,91737
30285,35770,18007,17763,2012,91739
30286,26115,12365,13750,2012,91740
30287,25282,12297,12985,2012,91741
30288,83182,42749,40433,2012,91744
30289,56370,26717,29653,2012,91745
30290,31086,15218,15868,2012,91746
30291,46946,23294,23652,2012,91748
30292,33906,17105,16801,2012,91750
30293,29664,14557,15107,2012,91752
30294,33052,16123,16929,2012,91754
30295,27334,13248,14086,2012,91755
30296,274,123,151,2012,91759
30297,59844,29251,30593,2012,91761
30298,54406,26025,28381,2012,91762
30299,36739,18574,18165,2012,91763
30300,54397,27167,27230,2012,91764
30301,47433,23171,24262,2012,91765
30302,70447,34697,35750,2012,91766
30303,49808,24583,25225,2012,91767
30304,36191,17208,18983,2012,91768
30305,61836,29984,31852,2012,91770
30306,33273,15818,17455,2012,91773
30307,24775,11859,12916,2012,91775
30308,37716,18866,18850,2012,91776
30309,34877,16751,18126,2012,91780
30310,26457,13114,13343,2012,91784
30311,51439,24395,27044,2012,91786
30312,42332,20994,21338,2012,91789
30313,44631,20736,23895,2012,91790
30314,32226,15193,17033,2012,91791
30315,31338,14992,16346,2012,91792
30316,53964,25834,28130,2012,91801
30317,29571,13931,15640,2012,91803
30318,17034,8348,8686,2012,91901
30319,17659,8536,9123,2012,91902
30320,1088,604,484,2012,91905
30321,3679,1903,1776,2012,91906
30322,73761,36168,37593,2012,91910
30323,82708,39231,43477,2012,91911
30324,40698,19852,20846,2012,91913
30325,16200,7106,9094,2012,91914
30326,25172,12955,12217,2012,91915
30327,1566,750,816,2012,91916
30328,560,261,299,2012,91917
30329,377,235,142,2012,91931
30330,25640,13164,12476,2012,91932
30331,364,169,195,2012,91934
30332,8171,4125,4046,2012,91935
30333,31582,15225,16357,2012,91941
30334,38719,18739,19980,2012,91942
30335,25523,12705,12818,2012,91945
30336,57,15,42,2012,91948
30337,60283,30506,29777,2012,91950
30338,1071,516,555,2012,91962
30339,1193,651,542,2012,91963
30340,60769,30333,30436,2012,91977
30341,9003,4603,4400,2012,91978
30342,258,113,145,2012,91980
30343,4000,2034,1966,2012,92003
30344,2637,1603,1034,2012,92004
30345,11135,5281,5854,2012,92007
30346,26746,13431,13315,2012,92008
30347,41210,20550,20660,2012,92009
30348,14695,7474,7221,2012,92010
30349,22416,10715,11701,2012,92011
30350,13247,6829,6418,2012,92014
30351,43676,21483,22193,2012,92019
30352,56807,28009,28798,2012,92020
30353,64441,31674,32767,2012,92021
30354,48725,24287,24438,2012,92024
30355,48567,23615,24952,2012,92025
30356,49309,24665,24644,2012,92026
30357,55129,27049,28080,2012,92027
30358,48103,24569,23534,2012,92028
30359,19823,10137,9686,2012,92029
30360,3202,1540,1662,2012,92036
30361,41746,20165,21581,2012,92037
30362,42232,20439,21793,2012,92040
30363,42688,22195,20493,2012,92054
30364,13130,12312,818,2012,92055
30365,51142,25128,26014,2012,92056
30366,54274,27700,26574,2012,92057
30367,45685,23486,22199,2012,92058
30368,1301,646,655,2012,92059
30369,162,83,79,2012,92060
30370,2301,1164,1137,2012,92061
30371,48208,23923,24285,2012,92064
30372,36341,18127,18214,2012,92065
30373,277,163,114,2012,92066
30374,7524,3444,4080,2012,92067
30375,45362,22481,22881,2012,92069
30376,1244,632,612,2012,92070
30377,53841,25789,28052,2012,92071
30378,12104,5827,6277,2012,92075
30379,43220,20005,23215,2012,92078
30380,27598,13746,13852,2012,92081
30381,19302,9639,9663,2012,92082
30382,36915,18323,18592,2012,92083
30383,47077,23192,23885,2012,92084
30384,1191,533,658,2012,92086
30385,1268,574,694,2012,92091
30386,35373,20782,14591,2012,92101
30387,43354,22741,20613,2012,92102
30388,30226,15850,14376,2012,92103
30389,44723,22926,21797,2012,92104
30390,67482,32853,34629,2012,92105
30391,19971,10110,9861,2012,92106
30392,26746,13002,13744,2012,92107
30393,18390,8991,9399,2012,92108
30394,43857,23528,20329,2012,92109
30395,27254,13946,13308,2012,92110
30396,46072,22707,23365,2012,92111
30397,55782,30522,25260,2012,92113
30398,68524,33539,34985,2012,92114
30399,60054,30162,29892,2012,92115
30400,31828,16768,15060,2012,92116
30401,52375,26497,25878,2012,92117
30402,19771,9689,10082,2012,92118
30403,23327,11189,12138,2012,92119
30404,25463,12618,12845,2012,92120
30405,4580,2437,2143,2012,92121
30406,46217,23070,23147,2012,92122
30407,27437,14215,13222,2012,92123
30408,31024,15496,15528,2012,92124
30409,76797,40660,36137,2012,92126
30410,40237,19881,20356,2012,92127
30411,48438,22399,26039,2012,92128
30412,53218,26655,26563,2012,92129
30413,47599,23202,24397,2012,92130
30414,34306,16373,17933,2012,92131
30415,0,0,0,2012,92132
30416,62,62,0,2012,92134
30417,1358,1176,182,2012,92135
30418,36528,18265,18263,2012,92139
30419,2661,2570,91,2012,92140
30420,1381,687,694,2012,92145
30421,459,365,94,2012,92147
30422,81952,42173,39779,2012,92154
30423,839,817,22,2012,92155
30424,28723,13307,15416,2012,92173
30425,63009,30922,32087,2012,92201
30426,24850,12463,12387,2012,92203
30427,4861,2268,2593,2012,92210
30428,24477,11689,12788,2012,92211
30429,31860,14796,17064,2012,92220
30430,0,0,0,2012,92222
30431,42408,20597,21811,2012,92223
30432,24292,16114,8178,2012,92225
30433,26310,13155,13155,2012,92227
30434,2121,1094,1027,2012,92230
30435,38700,18040,20660,2012,92231
30436,10520,7230,3290,2012,92233
30437,51507,25662,25845,2012,92234
30438,40881,20700,20181,2012,92236
30439,345,249,96,2012,92239
30440,33178,16560,16618,2012,92240
30441,9823,5073,4750,2012,92241
30442,1329,646,683,2012,92242
30443,47762,23337,24425,2012,92243
30444,7277,3786,3491,2012,92249
30445,8692,4453,4239,2012,92250
30446,21416,12752,8664,2012,92251
30447,9680,4928,4752,2012,92252
30448,37101,17957,19144,2012,92253
30449,11181,5576,5605,2012,92254
30450,3736,1906,1830,2012,92256
30451,2044,1047,997,2012,92257
30452,529,210,319,2012,92258
30453,334,203,131,2012,92259
30454,31365,14398,16967,2012,92260
30455,25302,14140,11162,2012,92262
30456,20397,11542,8855,2012,92264
30457,73,41,32,2012,92266
30458,35,11,24,2012,92267
30459,511,232,279,2012,92268
30460,17215,8590,8625,2012,92270
30461,1430,666,764,2012,92273
30462,18405,10152,8253,2012,92274
30463,1239,667,572,2012,92275
30464,7541,3707,3834,2012,92276
30465,23642,11764,11878,2012,92277
30466,4567,4267,300,2012,92278
30467,0,0,0,2012,92280
30468,1779,831,948,2012,92281
30469,735,378,357,2012,92282
30470,2807,1500,1307,2012,92283
30471,24685,12146,12539,2012,92284
30472,2441,1284,1157,2012,92285
30473,31907,16762,15145,2012,92301
30474,47,47,0,2012,92304
30475,312,175,137,2012,92305
30476,36891,17876,19015,2012,92307
30477,40217,18810,21407,2012,92308
30478,730,443,287,2012,92309
30479,9581,5484,4097,2012,92310
30480,32859,16817,16042,2012,92311
30481,12140,5811,6329,2012,92313
30482,9785,4821,4964,2012,92314
30483,5150,2384,2766,2012,92315
30484,31768,16167,15601,2012,92316
30485,7818,3823,3995,2012,92320
30486,1004,578,426,2012,92321
30487,598,321,277,2012,92322
30488,56471,28031,28440,2012,92324
30489,8174,4131,4043,2012,92325
30490,1253,593,660,2012,92327
30491,263,120,143,2012,92328
30492,6,6,0,2012,92332
30493,644,327,317,2012,92333
30494,98228,50007,48221,2012,92335
30495,89922,44413,45509,2012,92336
30496,36609,18028,18581,2012,92337
30497,0,0,0,2012,92338
30498,1046,400,646,2012,92339
30499,263,130,133,2012,92341
30500,5946,2814,3132,2012,92342
30501,19986,9893,10093,2012,92344
30502,79070,39510,39560,2012,92345
30503,57365,29002,28363,2012,92346
30504,1791,854,937,2012,92347
30505,6294,3101,3193,2012,92352
30506,21475,10399,11076,2012,92354
30507,6155,3082,3073,2012,92356
30508,1068,512,556,2012,92358
30509,7397,3670,3727,2012,92359
30510,5156,2559,2597,2012,92363
30511,53,30,23,2012,92364
30512,2552,1074,1478,2012,92365
30513,1030,507,523,2012,92368
30514,14727,7804,6923,2012,92371
30515,4859,2314,2545,2012,92372
30516,33279,16144,17135,2012,92373
30517,40494,19316,21178,2012,92374
30518,83613,41839,41774,2012,92376
30519,19698,9738,9960,2012,92377
30520,139,51,88,2012,92378
30521,5519,2821,2698,2012,92382
30522,59,34,25,2012,92384
30523,181,90,91,2012,92385
30524,1858,806,1052,2012,92386
30525,82,38,44,2012,92389
30526,2335,1218,1117,2012,92391
30527,52312,25500,26812,2012,92392
30528,34350,18616,15734,2012,92394
30529,43378,20093,23285,2012,92395
30530,4833,2486,2347,2012,92397
30531,1068,580,488,2012,92398
30532,53219,27225,25994,2012,92399
30533,1952,1038,914,2012,92401
30534,60222,29602,30620,2012,92404
30535,31075,15360,15715,2012,92405
30536,55780,26987,28793,2012,92407
30537,14077,7377,6700,2012,92408
30538,48069,24677,23392,2012,92410
30539,25443,12109,13334,2012,92411
30540,21887,11499,10388,2012,92501
30541,89783,45063,44720,2012,92503
30542,53194,26175,27019,2012,92504
30543,48803,24742,24061,2012,92505
30544,44129,21205,22924,2012,92506
30545,53791,26321,27470,2012,92507
30546,35278,17424,17854,2012,92508
30547,78700,40062,38638,2012,92509
30548,968,554,414,2012,92518
30549,48687,25020,23667,2012,92530
30550,19713,9592,10121,2012,92532
30551,3613,1513,2100,2012,92536
30552,4284,1970,2314,2012,92539
30553,34054,16425,17629,2012,92543
30554,45080,22522,22558,2012,92544
30555,38642,18297,20345,2012,92545
30556,6849,3378,3471,2012,92548
30557,1993,957,1036,2012,92549
30558,29230,14190,15040,2012,92551
30559,75136,36892,38244,2012,92553
30560,38751,18249,20502,2012,92555
30561,51001,24837,26164,2012,92557
30562,1332,741,591,2012,92561
30563,61376,30405,30971,2012,92562
30564,53655,26279,27376,2012,92563
30565,8634,4449,4185,2012,92567
30566,53722,26787,26935,2012,92570
30567,51614,25336,26278,2012,92571
30568,16166,7691,8475,2012,92582
30569,29431,14500,14931,2012,92583
30570,43203,21651,21552,2012,92584
30571,18071,8952,9119,2012,92585
30572,19556,8722,10834,2012,92586
30573,16169,7876,8293,2012,92587
30574,3676,1863,1813,2012,92590
30575,38723,18609,20114,2012,92591
30576,70726,34677,36049,2012,92592
30577,30209,15338,14871,2012,92595
30578,23815,11714,12101,2012,92596
30579,22051,10897,11154,2012,92602
30580,19215,9407,9808,2012,92603
30581,27453,13362,14091,2012,92604
30582,21252,10670,10582,2012,92606
30583,11555,5764,5791,2012,92610
30584,26386,13093,13293,2012,92612
30585,24538,11977,12561,2012,92614
30586,16855,7988,8867,2012,92617
30587,16614,8857,7757,2012,92618
30588,39927,20000,19927,2012,92620
30589,7237,3771,3466,2012,92624
30590,12442,5911,6531,2012,92625
30591,50759,25325,25434,2012,92626
30592,60167,30494,29673,2012,92627
30593,26182,13058,13124,2012,92629
30594,59083,29351,29732,2012,92630
30595,16325,5784,10541,2012,92637
30596,55367,26194,29173,2012,92646
30597,57117,28382,28735,2012,92647
30598,45360,22526,22834,2012,92648
30599,32694,16133,16561,2012,92649
30600,23636,12234,11402,2012,92651
30601,29473,14459,15014,2012,92653
30602,8544,4032,4512,2012,92655
30603,49067,23286,25781,2012,92656
30604,10136,5135,5001,2012,92657
30605,33671,16803,16868,2012,92660
30606,3931,1981,1950,2012,92661
30607,2931,1334,1597,2012,92662
30608,22163,11646,10517,2012,92663
30609,34445,16643,17802,2012,92672
30610,28819,14270,14549,2012,92673
30611,34829,17455,17374,2012,92675
30612,2254,1273,981,2012,92676
30613,63446,30517,32929,2012,92677
30614,514,216,298,2012,92678
30615,33034,16436,16598,2012,92679
30616,90074,44787,45287,2012,92683
30617,44302,21699,22603,2012,92688
30618,47295,23128,24167,2012,92691
30619,47672,23225,24447,2012,92692
30620,21448,10959,10489,2012,92694
30621,53979,27722,26257,2012,92701
30622,68926,35478,33448,2012,92703
30623,86136,43118,43018,2012,92704
30624,44945,21871,23074,2012,92705
30625,36660,18449,18211,2012,92706
30626,60495,30674,29821,2012,92707
30627,55914,27369,28545,2012,92708
30628,58181,29118,29063,2012,92780
30629,22588,10724,11864,2012,92782
30630,61627,31012,30615,2012,92801
30631,42032,20896,21136,2012,92802
30632,85174,42041,43133,2012,92804
30633,72033,37066,34967,2012,92805
30634,38300,19206,19094,2012,92806
30635,35738,17716,18022,2012,92807
30636,20384,10193,10191,2012,92808
30637,36275,17380,18895,2012,92821
30638,3048,1418,1630,2012,92823
30639,34693,16164,18529,2012,92831
30640,24694,12714,11980,2012,92832
30641,52609,25854,26755,2012,92833
30642,23055,11246,11809,2012,92835
30643,53943,27295,26648,2012,92840
30644,31890,16454,15436,2012,92841
30645,45341,22687,22654,2012,92843
30646,24523,12581,11942,2012,92844
30647,16774,7884,8890,2012,92845
30648,27235,15228,12007,2012,92860
30649,5809,2978,2831,2012,92861
30650,19358,10129,9229,2012,92865
30651,15017,7320,7697,2012,92866
30652,43557,21495,22062,2012,92867
30653,26279,14103,12176,2012,92868
30654,39167,19461,19706,2012,92869
30655,52510,25824,26686,2012,92870
30656,46912,23014,23898,2012,92879
30657,65093,32994,32099,2012,92880
30658,30846,15705,15141,2012,92881
30659,68715,34486,34229,2012,92882
30660,29549,14223,15326,2012,92883
30661,46907,22952,23955,2012,92886
30662,19654,9768,9886,2012,92887
30663,32464,16182,16282,2012,93001
30664,50113,24961,25152,2012,93003
30665,29698,14780,14918,2012,93004
30666,43358,21337,22021,2012,93010
30667,34339,16750,17589,2012,93012
30668,15867,7866,8001,2012,93013
30669,17484,8642,8842,2012,93015
30670,35720,17679,18041,2012,93021
30671,6698,3375,3323,2012,93022
30672,20601,9985,10616,2012,93023
30673,59298,30119,29179,2012,93030
30674,80492,41902,38590,2012,93033
30675,27767,13638,14129,2012,93035
30676,42133,20927,21206,2012,93036
30677,1699,739,960,2012,93040
30678,24075,11752,12323,2012,93041
30679,47,47,0,2012,93042
30680,0,0,0,2012,93043
30681,33380,17069,16311,2012,93060
30682,55662,27762,27900,2012,93063
30683,0,0,0,2012,93064
30684,71505,34292,37213,2012,93065
30685,3048,1663,1385,2012,93066
30686,622,281,341,2012,93067
30687,32327,16290,16037,2012,93101
30688,20931,10919,10012,2012,93103
30689,24719,11568,13151,2012,93105
30690,11201,5037,6164,2012,93108
30691,9838,4766,5072,2012,93109
30692,17020,8872,8148,2012,93110
30693,16901,8237,8664,2012,93111
30694,54182,27592,26590,2012,93117
30695,1014,515,499,2012,93201
30696,3623,1786,1837,2012,93202
30697,20774,10734,10040,2012,93203
30698,15341,9229,6112,2012,93204
30699,1900,809,1091,2012,93205
30700,2053,1087,966,2012,93206
30701,281,136,145,2012,93207
30702,139,77,62,2012,93208
30703,21293,13437,7856,2012,93210
30704,25588,18731,6857,2012,93212
30705,55355,32403,22952,2012,93215
30706,890,451,439,2012,93218
30707,9097,4595,4502,2012,93219
30708,59,17,42,2012,93220
30709,14691,7564,7127,2012,93221
30710,1535,735,800,2012,93222
30711,10632,5138,5494,2012,93223
30712,486,255,231,2012,93224
30713,4665,2335,2330,2012,93225
30714,383,196,187,2012,93226
30715,66186,33730,32456,2012,93230
30716,6952,3199,3753,2012,93234
30717,4864,2538,2326,2012,93235
30718,1496,819,677,2012,93238
30719,1604,859,745,2012,93239
30720,5308,2728,2580,2012,93240
30721,18542,9366,9176,2012,93241
30722,3326,1686,1640,2012,93242
30723,1925,978,947,2012,93243
30724,282,137,145,2012,93244
30725,36544,19482,17062,2012,93245
30726,18092,8969,9123,2012,93247
30727,2564,1501,1063,2012,93249
30728,13599,7924,5675,2012,93250
30729,261,157,104,2012,93251
30730,3752,2961,791,2012,93252
30731,626,328,298,2012,93254
30732,495,252,243,2012,93255
30733,5401,2863,2538,2012,93256
30734,76627,38937,37690,2012,93257
30735,1650,889,761,2012,93258
30736,149,94,55,2012,93260
30737,3263,1689,1574,2012,93261
30738,32,0,32,2012,93262
30739,19384,9821,9563,2012,93263
30740,3273,1647,1626,2012,93265
30741,1450,744,706,2012,93266
30742,6739,3395,3344,2012,93267
30743,16776,8415,8361,2012,93268
30744,5424,2638,2786,2012,93270
30745,2285,1138,1147,2012,93271
30746,3114,1707,1407,2012,93272
30747,69896,34517,35379,2012,93274
30748,160,97,63,2012,93276
30749,51125,24305,26820,2012,93277
30750,27029,16940,10089,2012,93280
30751,2090,1119,971,2012,93283
30752,2173,1057,1116,2012,93285
30753,9650,5046,4604,2012,93286
30754,133,74,59,2012,93287
30755,53123,27227,25896,2012,93291
30756,37472,18774,18698,2012,93292
30757,11421,5744,5677,2012,93301
30758,51208,25297,25911,2012,93304
30759,37204,19356,17848,2012,93305
30760,67736,33006,34730,2012,93306
30761,81404,40314,41090,2012,93307
30762,53514,26997,26517,2012,93308
30763,59051,28909,30142,2012,93309
30764,41234,19783,21451,2012,93311
30765,54750,27402,27348,2012,93312
30766,44122,22660,21462,2012,93313
30767,22084,11284,10800,2012,93314
30768,28311,14164,14147,2012,93401
30769,14949,7366,7583,2012,93402
30770,33655,21297,12358,2012,93405
30771,0,0,0,2012,93410
30772,29710,14309,15401,2012,93420
30773,31178,16219,14959,2012,93422
30774,913,463,450,2012,93424
30775,1193,677,516,2012,93426
30776,5394,2931,2463,2012,93427
30777,6400,3089,3311,2012,93428
30778,238,66,172,2012,93429
30779,2710,1310,1400,2012,93430
30780,1125,606,519,2012,93432
30781,13212,6336,6876,2012,93433
30782,7030,3541,3489,2012,93434
30783,54355,28177,26178,2012,93436
30784,3632,2044,1588,2012,93437
30785,1723,842,881,2012,93440
30786,1230,617,613,2012,93441
30787,10811,5425,5386,2012,93442
30788,19269,9338,9931,2012,93444
30789,7233,3385,3848,2012,93445
30790,42613,21101,21512,2012,93446
30791,7721,3708,4013,2012,93449
30792,770,375,395,2012,93450
30793,4261,2013,2248,2012,93451
30794,579,340,239,2012,93452
30795,3485,1669,1816,2012,93453
30796,35731,17838,17893,2012,93454
30797,41889,19928,21961,2012,93455
30798,55458,28538,26920,2012,93458
30799,5112,2436,2676,2012,93460
30800,1402,776,626,2012,93461
30801,7846,4056,3790,2012,93463
30802,10085,5053,5032,2012,93465
30803,5042,2586,2456,2012,93501
30804,13347,6558,6789,2012,93505
30805,7153,3672,3481,2012,93510
30806,110,21,89,2012,93512
30807,1516,797,719,2012,93513
30808,14511,7220,7291,2012,93514
30809,2046,924,1122,2012,93516
30810,424,234,190,2012,93517
30811,1098,604,494,2012,93518
30812,96,47,49,2012,93519
30813,35,21,14,2012,93522
30814,3002,1509,1493,2012,93523
30815,668,575,93,2012,93524
30816,611,294,317,2012,93526
30817,2335,1194,1141,2012,93527
30818,183,76,107,2012,93528
30819,418,392,26,2012,93529
30820,54,21,33,2012,93530
30821,357,183,174,2012,93531
30822,2736,1313,1423,2012,93532
30823,38655,18893,19762,2012,93534
30824,72231,34077,38154,2012,93535
30825,70599,37940,32659,2012,93536
30826,581,297,284,2012,93541
30827,12160,6362,5798,2012,93543
30828,912,470,442,2012,93544
30829,2256,1300,956,2012,93545
30830,9625,4984,4641,2012,93546
30831,364,152,212,2012,93549
30832,74389,36328,38061,2012,93550
30833,49372,24354,25018,2012,93551
30834,39396,18572,20824,2012,93552
30835,2169,1154,1015,2012,93553
30836,30,20,10,2012,93554
30837,32021,15737,16284,2012,93555
30838,50,9,41,2012,93558
30839,18496,9376,9120,2012,93560
30840,35446,20411,15035,2012,93561
30841,1943,1016,927,2012,93562
30842,292,202,90,2012,93563
30843,6503,3484,3019,2012,93591
30844,85,60,25,2012,93592
30845,1882,922,960,2012,93601
30846,3677,1872,1805,2012,93602
30847,280,123,157,2012,93603
30848,1186,556,630,2012,93604
30849,218,120,98,2012,93605
30850,373,197,176,2012,93606
30851,859,424,435,2012,93608
30852,6173,3075,3098,2012,93609
30853,24715,8376,16339,2012,93610
30854,46810,22575,24235,2012,93611
30855,34804,16523,18281,2012,93612
30856,11053,5901,5152,2012,93614
30857,6211,3193,3018,2012,93615
30858,2698,1515,1183,2012,93616
30859,28525,14462,14063,2012,93618
30860,29609,14648,14961,2012,93619
30861,9657,5260,4397,2012,93620
30862,322,133,189,2012,93621
30863,9489,4911,4578,2012,93622
30864,58,24,34,2012,93623
30865,1615,966,649,2012,93624
30866,6730,3402,3328,2012,93625
30867,702,388,314,2012,93626
30868,0,0,0,2012,93627
30869,402,164,238,2012,93628
30870,18039,9094,8945,2012,93630
30871,16666,8156,8510,2012,93631
30872,33,33,0,2012,93633
30873,49,26,23,2012,93634
30874,38661,19236,19425,2012,93635
30875,11443,5555,5888,2012,93636
30876,39577,19703,19874,2012,93637
30877,47823,25159,22664,2012,93638
30878,11600,6265,5335,2012,93640
30879,594,413,181,2012,93641
30880,2829,1445,1384,2012,93643
30881,7627,3822,3805,2012,93644
30882,712,278,434,2012,93645
30883,10960,5380,5580,2012,93646
30884,12401,6055,6346,2012,93647
30885,15403,7855,7548,2012,93648
30886,4063,1820,2243,2012,93650
30887,1653,843,810,2012,93651
30888,453,277,176,2012,93652
30889,1193,617,576,2012,93653
30890,30791,15837,14954,2012,93654
30891,6826,3564,3262,2012,93656
30892,35083,17321,17762,2012,93657
30893,4465,2394,2071,2012,93660
30894,29741,15119,14622,2012,93662
30895,687,407,280,2012,93664
30896,349,226,123,2012,93665
30897,243,111,132,2012,93666
30898,2156,1145,1011,2012,93667
30899,1498,679,819,2012,93668
30900,200,64,136,2012,93669
30901,967,582,385,2012,93673
30902,2335,1244,1091,2012,93675
30903,11057,5997,5060,2012,93701
30904,47667,24592,23075,2012,93702
30905,34551,17398,17153,2012,93703
30906,26828,12771,14057,2012,93704
30907,38597,18451,20146,2012,93705
30908,38448,19017,19431,2012,93706
30909,31980,15993,15987,2012,93710
30910,39079,18652,20427,2012,93711
30911,46351,21976,24375,2012,93720
30912,6570,4019,2551,2012,93721
30913,76672,37542,39130,2012,93722
30914,8640,4519,4121,2012,93723
30915,25386,12968,12418,2012,93725
30916,40627,20037,20590,2012,93726
30917,68590,34163,34427,2012,93727
30918,15164,7301,7863,2012,93728
30919,10098,4983,5115,2012,93730
30920,25823,12918,12905,2012,93901
30921,61000,31503,29497,2012,93905
30922,61030,30145,30885,2012,93906
30923,21987,11170,10817,2012,93907
30924,12878,6253,6625,2012,93908
30925,715,442,273,2012,93920
30926,2864,1441,1423,2012,93921
30927,13362,5980,7382,2012,93923
30928,6133,2896,3237,2012,93924
30929,1665,845,820,2012,93925
30930,8494,4448,4046,2012,93926
30931,16976,8331,8645,2012,93927
30932,338,204,134,2012,93928
30933,16222,9236,6986,2012,93930
30934,443,273,170,2012,93932
30935,22723,11155,11568,2012,93933
30936,31952,15972,15980,2012,93940
30937,42,40,2,2012,93943
30938,15102,7065,8037,2012,93950
30939,4470,2111,2359,2012,93953
30940,244,112,132,2012,93954
30941,33314,16742,16572,2012,93955
30942,27057,18633,8424,2012,93960
30943,931,507,424,2012,93962
30944,26141,12893,13248,2012,94002
30945,4266,2064,2202,2012,94005
30946,40907,20215,20692,2012,94010
30947,47866,23730,24136,2012,94014
30948,60446,29171,31275,2012,94015
30949,17688,8570,9118,2012,94019
30950,1651,794,857,2012,94020
30951,93,36,57,2012,94021
30952,19310,9545,9765,2012,94022
30953,22536,11023,11513,2012,94024
30954,40608,19213,21395,2012,94025
30955,7083,3506,3577,2012,94027
30956,6633,3197,3436,2012,94028
30957,21567,10367,11200,2012,94030
30958,2567,1156,1411,2012,94037
30959,2814,1337,1477,2012,94038
30960,33918,17572,16346,2012,94040
30961,12929,6587,6342,2012,94041
30962,27279,13967,13312,2012,94043
30963,37558,18681,18877,2012,94044
30964,1561,754,807,2012,94060
30965,36343,17376,18967,2012,94061
30966,26782,13263,13519,2012,94062
30967,31427,16818,14609,2012,94063
30968,11108,5444,5664,2012,94065
30969,41383,20164,21219,2012,94066
30970,29358,14443,14915,2012,94070
30971,241,160,81,2012,94074
30972,64363,32099,32264,2012,94080
30973,22688,11713,10975,2012,94085
30974,45531,24138,21393,2012,94086
30975,53446,26637,26809,2012,94087
30976,20282,9829,10453,2012,94089
30977,25531,14498,11033,2012,94102
30978,23909,13995,9914,2012,94103
30979,305,115,190,2012,94104
30980,4801,2888,1913,2012,94105
30981,26762,14296,12466,2012,94107
30982,13518,6949,6569,2012,94108
30983,54412,26995,27417,2012,94109
30984,70804,36737,34067,2012,94110
30985,3493,1804,1689,2012,94111
30986,80726,40323,40403,2012,94112
30987,32328,19424,12904,2012,94114
30988,32882,15834,17048,2012,94115
30989,43923,20409,23514,2012,94116
30990,40932,21916,19016,2012,94117
30991,39567,19241,20326,2012,94118
30992,43597,20609,22988,2012,94121
30993,57805,28338,29467,2012,94122
30994,23710,10763,12947,2012,94123
30995,34296,16894,17402,2012,94124
30996,19075,9898,9177,2012,94127
30997,48,0,48,2012,94128
30998,2730,1534,1196,2012,94129
30999,2501,1478,1023,2012,94130
31000,27914,14674,13240,2012,94131
31001,31425,14674,16751,2012,94132
31002,27580,13897,13683,2012,94133
31003,38889,19050,19839,2012,94134
31004,4340,2570,1770,2012,94158
31005,16819,8459,8360,2012,94301
31006,45714,22733,22981,2012,94303
31007,3791,1905,1886,2012,94304
31008,13541,7248,6293,2012,94305
31009,26448,12934,13514,2012,94306
31010,35721,18231,17490,2012,94401
31011,23622,11651,11971,2012,94402
31012,39311,19008,20303,2012,94403
31013,33792,16510,17282,2012,94404
31014,60639,29386,31253,2012,94501
31015,13384,6406,6978,2012,94502
31016,19494,9252,10242,2012,94503
31017,12680,6541,6139,2012,94505
31018,21312,10225,11087,2012,94506
31019,15817,7848,7969,2012,94507
31020,3638,1880,1758,2012,94508
31021,61665,29276,32389,2012,94509
31022,27180,13259,13921,2012,94510
31023,1910,951,959,2012,94511
31024,241,46,195,2012,94512
31025,53902,26875,27027,2012,94513
31026,1020,476,544,2012,94514
31027,6815,3457,3358,2012,94515
31028,120,66,54,2012,94516
31029,12582,6468,6114,2012,94517
31030,26162,12670,13492,2012,94518
31031,19819,9671,10148,2012,94519
31032,37477,19773,17704,2012,94520
31033,40854,19671,21183,2012,94521
31034,33728,16258,17470,2012,94523
31035,2866,1420,1446,2012,94525
31036,31915,15237,16678,2012,94526
31037,1175,538,637,2012,94528
31038,23913,11376,12537,2012,94530
31039,41237,20508,20729,2012,94531
31040,66641,32176,34465,2012,94533
31041,36026,17371,18655,2012,94534
31042,6007,4090,1917,2012,94535
31043,68924,34580,34344,2012,94536
31044,60439,30168,30271,2012,94538
31045,51369,25607,25762,2012,94539
31046,60736,29526,31210,2012,94541
31047,12446,6010,6436,2012,94542
31048,75917,37602,38315,2012,94544
31049,28966,14236,14730,2012,94545
31050,42766,20271,22495,2012,94546
31051,24060,11451,12609,2012,94547
31052,430,208,222,2012,94548
31053,27340,13088,14252,2012,94549
31054,46915,23220,23695,2012,94550
31055,36994,19210,17784,2012,94551
31056,14199,7173,7026,2012,94552
31057,47583,23850,23733,2012,94553
31058,34463,17411,17052,2012,94555
31059,14716,6986,7730,2012,94556
31060,66743,33585,33158,2012,94558
31061,27132,13933,13199,2012,94559
31062,42712,21543,21169,2012,94560
31063,36908,18729,18179,2012,94561
31064,17779,8922,8857,2012,94563
31065,18505,8950,9555,2012,94564
31066,85275,42318,42957,2012,94565
31067,41006,19777,21229,2012,94566
31068,691,329,362,2012,94567
31069,45695,22919,22776,2012,94568
31070,361,221,140,2012,94569
31071,7784,3719,4065,2012,94571
31072,8867,4238,4629,2012,94572
31073,127,77,50,2012,94573
31074,9288,4383,4905,2012,94574
31075,1581,729,852,2012,94575
31076,116,23,93,2012,94576
31077,44778,22072,22706,2012,94577
31078,38230,18470,19760,2012,94578
31079,20528,10339,10189,2012,94579
31080,28531,13410,15121,2012,94580
31081,37131,18038,19093,2012,94582
31082,35248,17444,17804,2012,94583
31083,28972,14893,14079,2012,94585
31084,848,398,450,2012,94586
31085,69820,34243,35577,2012,94587
31086,30435,15781,14654,2012,94588
31087,31174,13947,17227,2012,94589
31088,34960,17446,17514,2012,94590
31089,52796,25366,27430,2012,94591
31090,583,256,327,2012,94592
31091,16400,6231,10169,2012,94595
31092,20192,9416,10776,2012,94596
31093,19933,9906,10027,2012,94597
31094,26127,12014,14113,2012,94598
31095,3071,1519,1552,2012,94599
31096,49138,25208,23930,2012,94601
31097,28559,12991,15568,2012,94602
31098,33774,16239,17535,2012,94603
31099,40890,19317,21573,2012,94605
31100,36051,17955,18096,2012,94606
31101,23602,11336,12266,2012,94607
31102,25994,12871,13123,2012,94608
31103,21389,9821,11568,2012,94609
31104,30276,14198,16078,2012,94610
31105,36277,17514,18763,2012,94611
31106,13110,6436,6674,2012,94612
31107,800,146,654,2012,94613
31108,17074,7832,9242,2012,94618
31109,23525,11356,12169,2012,94619
31110,31410,15400,16010,2012,94621
31111,16187,7584,8603,2012,94702
31112,20758,10517,10241,2012,94703
31113,24065,11131,12934,2012,94704
31114,12687,6331,6356,2012,94705
31115,19469,9361,10108,2012,94706
31116,12100,5626,6474,2012,94707
31117,11289,5554,5735,2012,94708
31118,12643,7059,5584,2012,94709
31119,5897,2795,3102,2012,94710
31120,2960,1466,1494,2012,94720
31121,29277,14724,14553,2012,94801
31122,25641,12338,13303,2012,94803
31123,39635,18813,20822,2012,94804
31124,13242,6398,6844,2012,94805
31125,59976,29674,30302,2012,94806
31126,0,0,0,2012,94850
31127,40663,21102,19561,2012,94901
31128,29709,14142,15567,2012,94903
31129,12156,5667,6489,2012,94904
31130,12490,5779,6711,2012,94920
31131,270,71,199,2012,94922
31132,970,436,534,2012,94923
31133,1108,540,568,2012,94924
31134,9267,4204,5063,2012,94925
31135,42206,20077,22129,2012,94928
31136,142,62,80,2012,94929
31137,8287,4079,4208,2012,94930
31138,8578,4128,4450,2012,94931
31139,1190,622,568,2012,94933
31140,1129,579,550,2012,94937
31141,745,298,447,2012,94938
31142,6779,3134,3645,2012,94939
31143,215,118,97,2012,94940
31144,31070,14735,16335,2012,94941
31145,17496,8448,9048,2012,94945
31146,532,278,254,2012,94946
31147,24254,11241,13013,2012,94947
31148,17000,8481,8519,2012,94949
31149,53,16,37,2012,94950
31150,4318,2090,2228,2012,94951
31151,32925,16344,16581,2012,94952
31152,37384,18233,19151,2012,94954
31153,1718,815,903,2012,94956
31154,1002,464,538,2012,94957
31155,15749,7373,8376,2012,94960
31156,539,269,270,2012,94963
31157,5279,5099,180,2012,94964
31158,11029,5253,5776,2012,94965
31159,525,284,241,2012,94970
31160,483,221,262,2012,94971
31161,35,17,18,2012,94972
31162,1454,712,742,2012,94973
31163,1906,936,970,2012,95002
31164,23946,11442,12504,2012,95003
31165,3795,1940,1855,2012,95004
31166,5945,2876,3069,2012,95005
31167,9543,4764,4779,2012,95006
31168,602,471,131,2012,95007
31169,44909,22138,22771,2012,95008
31170,8980,4639,4341,2012,95010
31171,10490,5245,5245,2012,95012
31172,0,0,0,2012,95013
31173,60690,29748,30942,2012,95014
31174,698,370,328,2012,95017
31175,8110,3896,4214,2012,95018
31176,8157,4090,4067,2012,95019
31177,56865,28626,28239,2012,95020
31178,49598,24616,24982,2012,95023
31179,13534,6209,7325,2012,95030
31180,25039,12027,13012,2012,95032
31181,9540,4862,4678,2012,95033
31182,67380,34414,32966,2012,95035
31183,45924,22244,23680,2012,95037
31184,1253,561,692,2012,95039
31185,202,104,98,2012,95041
31186,595,285,310,2012,95043
31187,3644,1961,1683,2012,95045
31188,6691,3432,3259,2012,95046
31189,36587,18533,18054,2012,95050
31190,53394,26698,26696,2012,95051
31191,2312,1158,1154,2012,95053
31192,23188,11951,11237,2012,95054
31193,46821,23773,23048,2012,95060
31194,35827,17992,17835,2012,95062
31195,7090,3623,3467,2012,95064
31196,8620,4380,4240,2012,95065
31197,15038,7361,7677,2012,95066
31198,30533,15097,15436,2012,95070
31199,10235,5121,5114,2012,95073
31200,264,129,135,2012,95075
31201,81736,40696,41040,2012,95076
31202,18179,9601,8578,2012,95110
31203,57125,28864,28261,2012,95111
31204,53268,28001,25267,2012,95112
31205,702,371,331,2012,95113
31206,49728,25451,24277,2012,95116
31207,30980,16543,14437,2012,95117
31208,31312,15460,15852,2012,95118
31209,9466,4904,4562,2012,95119
31210,38351,19021,19330,2012,95120
31211,37135,18384,18751,2012,95121
31212,54873,27423,27450,2012,95122
31213,63495,31010,32485,2012,95123
31214,47854,24174,23680,2012,95124
31215,52805,24842,27963,2012,95125
31216,31965,16255,15710,2012,95126
31217,64392,33544,30848,2012,95127
31218,36020,18794,17226,2012,95128
31219,39436,19552,19884,2012,95129
31220,14529,7516,7013,2012,95130
31221,28990,14756,14234,2012,95131
31222,40882,20403,20479,2012,95132
31223,26189,12803,13386,2012,95133
31224,15316,8278,7038,2012,95134
31225,21159,10078,11081,2012,95135
31226,42565,20980,21585,2012,95136
31227,19104,8969,10135,2012,95138
31228,6690,3238,3452,2012,95139
31229,321,186,135,2012,95140
31230,45677,22577,23100,2012,95148
31231,5808,3064,2744,2012,95202
31232,15431,8148,7283,2012,95203
31233,29200,13810,15390,2012,95204
31234,36300,18497,17803,2012,95205
31235,63820,31920,31900,2012,95206
31236,47604,22276,25328,2012,95207
31237,41153,19837,21316,2012,95209
31238,40502,19728,20774,2012,95210
31239,1919,619,1300,2012,95211
31240,25219,12462,12757,2012,95212
31241,23902,12359,11543,2012,95215
31242,27913,13421,14492,2012,95219
31243,6819,3449,3370,2012,95220
31244,5062,2320,2742,2012,95222
31245,3156,1580,1576,2012,95223
31246,291,137,154,2012,95224
31247,506,240,266,2012,95225
31248,274,164,110,2012,95226
31249,892,428,464,2012,95227
31250,4365,2315,2050,2012,95228
31251,833,353,480,2012,95230
31252,5205,3334,1871,2012,95231
31253,396,145,251,2012,95232
31254,419,136,283,2012,95233
31255,180,159,21,2012,95234
31256,3752,1789,1963,2012,95236
31257,3431,1824,1607,2012,95237
31258,46811,23153,23658,2012,95240
31259,25351,12407,12944,2012,95242
31260,2217,1213,1004,2012,95245
31261,1119,552,567,2012,95246
31262,4518,1955,2563,2012,95247
31263,205,74,131,2012,95248
31264,3817,2159,1658,2012,95249
31265,33,17,16,2012,95250
31266,819,435,384,2012,95251
31267,15050,7950,7100,2012,95252
31268,511,200,311,2012,95254
31269,2380,1124,1256,2012,95255
31270,425,171,254,2012,95257
31271,3799,2008,1791,2012,95258
31272,36542,18705,17837,2012,95301
31273,949,476,473,2012,95303
31274,17586,10548,7038,2012,95304
31275,85,36,49,2012,95305
31276,872,410,462,2012,95306
31277,43596,21673,21923,2012,95307
31278,1820,800,1020,2012,95310
31279,2119,1075,1044,2012,95311
31280,357,169,188,2012,95312
31281,1472,954,518,2012,95313
31282,0,0,0,2012,95314
31283,12916,6311,6605,2012,95315
31284,6619,3145,3474,2012,95316
31285,942,586,356,2012,95317
31286,471,150,321,2012,95318
31287,1191,568,623,2012,95319
31288,12947,6691,6256,2012,95320
31289,3506,1806,1700,2012,95321
31290,9646,5088,4558,2012,95322
31291,1131,578,553,2012,95323
31292,6886,3528,3358,2012,95324
31293,61,49,12,2012,95325
31294,8884,4132,4752,2012,95326
31295,9776,6363,3413,2012,95327
31296,4325,2327,1998,2012,95328
31297,2744,1355,1389,2012,95329
31298,16278,8122,8156,2012,95330
31299,2896,1448,1448,2012,95333
31300,15747,8085,7662,2012,95334
31301,707,267,440,2012,95335
31302,43753,21470,22283,2012,95336
31303,30987,15094,15893,2012,95337
31304,11834,5789,6045,2012,95338
31305,31624,14847,16777,2012,95340
31306,33934,17431,16503,2012,95341
31307,264,130,134,2012,95345
31308,970,488,482,2012,95346
31309,31570,15256,16314,2012,95348
31310,50159,24115,26044,2012,95350
31311,46681,23146,23535,2012,95351
31312,24364,12344,12020,2012,95354
31313,59392,27504,31888,2012,95355
31314,31539,15216,16323,2012,95356
31315,11099,5300,5799,2012,95357
31316,31592,16144,15448,2012,95358
31317,11583,5750,5833,2012,95360
31318,32440,16028,16412,2012,95361
31319,25603,13425,12178,2012,95363
31320,0,0,0,2012,95364
31321,5300,2769,2531,2012,95365
31322,16603,7985,8618,2012,95366
31323,23076,11935,11141,2012,95367
31324,14319,7474,6845,2012,95368
31325,1161,603,558,2012,95369
31326,27551,13681,13870,2012,95370
31327,1549,822,727,2012,95372
31328,1813,1106,707,2012,95374
31329,179,72,107,2012,95375
31330,49357,25093,24264,2012,95376
31331,30326,15484,14842,2012,95377
31332,3716,1831,1885,2012,95379
31333,39704,19792,19912,2012,95380
31334,37570,18743,18827,2012,95382
31335,3774,2004,1770,2012,95383
31336,403,184,219,2012,95385
31337,9816,5030,4786,2012,95386
31338,850,403,447,2012,95387
31339,14001,7360,6641,2012,95388
31340,1234,854,380,2012,95389
31341,10276,4899,5377,2012,95391
31342,35882,17737,18145,2012,95401
31343,46070,22979,23091,2012,95403
31344,38817,19503,19314,2012,95404
31345,20927,10280,10647,2012,95405
31346,40068,20773,19295,2012,95407
31347,26549,12162,14387,2012,95409
31348,948,363,585,2012,95410
31349,298,166,132,2012,95412
31350,1631,887,744,2012,95415
31351,218,104,114,2012,95417
31352,591,322,269,2012,95420
31353,1400,724,676,2012,95421
31354,15379,7708,7671,2012,95422
31355,3147,1724,1423,2012,95423
31356,10555,5200,5355,2012,95425
31357,2344,1163,1181,2012,95426
31358,278,150,128,2012,95427
31359,2528,1188,1340,2012,95428
31360,114,65,49,2012,95429
31361,0,0,0,2012,95430
31362,538,331,207,2012,95431
31363,514,261,253,2012,95432
31364,166,129,37,2012,95435
31365,5355,2806,2549,2012,95436
31366,14193,7364,6829,2012,95437
31367,727,323,404,2012,95439
31368,2301,1260,1041,2012,95441
31369,3575,1750,1825,2012,95442
31370,251,143,108,2012,95443
31371,903,264,639,2012,95444
31372,1758,908,850,2012,95445
31373,4788,2589,2199,2012,95446
31374,16645,8050,8595,2012,95448
31375,1518,833,685,2012,95449
31376,191,88,103,2012,95450
31377,11565,5841,5724,2012,95451
31378,1070,560,510,2012,95452
31379,11054,5715,5339,2012,95453
31380,2226,1225,1001,2012,95454
31381,943,302,641,2012,95456
31382,3369,1723,1646,2012,95457
31383,3049,1417,1632,2012,95458
31384,605,269,336,2012,95459
31385,2406,1066,1340,2012,95460
31386,3811,2046,1765,2012,95461
31387,1377,567,810,2012,95462
31388,0,0,0,2012,95463
31389,2132,866,1266,2012,95464
31390,2235,1141,1094,2012,95465
31391,956,597,359,2012,95466
31392,5679,2832,2847,2012,95467
31393,1222,612,610,2012,95468
31394,1915,1067,848,2012,95469
31395,6070,3079,2991,2012,95470
31396,425,160,265,2012,95471
31397,29118,14540,14578,2012,95472
31398,37602,18107,19495,2012,95476
31399,33163,16607,16556,2012,95482
31400,2115,1111,1004,2012,95485
31401,17,0,17,2012,95486
31402,254,113,141,2012,95488
31403,12602,6032,6570,2012,95490
31404,28844,14156,14688,2012,95492
31405,274,98,176,2012,95493
31406,153,88,65,2012,95494
31407,762,371,391,2012,95497
31408,23800,11969,11831,2012,95501
31409,24717,11910,12807,2012,95503
31410,430,293,137,2012,95511
31411,187,51,136,2012,95514
31412,19135,9572,9563,2012,95519
31413,20108,9887,10221,2012,95521
31414,2133,1105,1028,2012,95524
31415,1768,919,849,2012,95525
31416,410,179,231,2012,95526
31417,562,277,285,2012,95527
31418,1079,510,569,2012,95528
31419,24301,13586,10715,2012,95531
31420,3065,1572,1493,2012,95536
31421,120,56,64,2012,95537
31422,13159,6747,6412,2012,95540
31423,2259,1069,1190,2012,95542
31424,628,300,328,2012,95543
31425,61,42,19,2012,95545
31426,3424,1644,1780,2012,95546
31427,1244,667,577,2012,95547
31428,1658,939,719,2012,95548
31429,813,397,416,2012,95549
31430,226,157,69,2012,95550
31431,2009,1144,865,2012,95551
31432,425,232,193,2012,95552
31433,1073,615,458,2012,95553
31434,476,248,228,2012,95554
31435,335,182,153,2012,95555
31436,649,442,207,2012,95556
31437,312,196,116,2012,95558
31438,164,37,127,2012,95559
31439,1098,554,544,2012,95560
31440,3388,1684,1704,2012,95562
31441,585,316,269,2012,95563
31442,521,292,229,2012,95564
31443,1038,469,569,2012,95565
31444,1909,852,1057,2012,95567
31445,128,50,78,2012,95568
31446,319,221,98,2012,95569
31447,2103,1079,1024,2012,95570
31448,59,22,37,2012,95571
31449,1507,747,760,2012,95573
31450,440,194,246,2012,95585
31451,117,62,55,2012,95587
31452,1127,586,541,2012,95589
31453,176,101,75,2012,95595
31454,183,101,82,2012,95601
31455,17687,8807,8880,2012,95602
31456,28113,13914,14199,2012,95603
31457,0,0,0,2012,95604
31458,13706,6752,6954,2012,95605
31459,114,57,57,2012,95606
31460,331,180,151,2012,95607
31461,60288,29345,30943,2012,95608
31462,43805,21353,22452,2012,95610
31463,1056,485,571,2012,95612
31464,3972,1973,1999,2012,95614
31465,1025,556,469,2012,95615
31466,49138,23157,25981,2012,95616
31467,26397,13672,12725,2012,95618
31468,5220,2514,2706,2012,95619
31469,20638,10289,10349,2012,95620
31470,40829,19266,21563,2012,95621
31471,3934,1984,1950,2012,95623
31472,59573,29265,30308,2012,95624
31473,192,80,112,2012,95625
31474,6050,2926,3124,2012,95626
31475,3270,1613,1657,2012,95627
31476,39863,19381,20482,2012,95628
31477,907,451,456,2012,95629
31478,71676,39216,32460,2012,95630
31479,5624,2718,2906,2012,95631
31480,29793,14671,15122,2012,95632
31481,3442,1702,1740,2012,95633
31482,3239,1672,1567,2012,95634
31483,1109,594,515,2012,95635
31484,878,505,373,2012,95636
31485,605,217,388,2012,95637
31486,2213,1192,1021,2012,95638
31487,244,78,166,2012,95639
31488,11024,7542,3482,2012,95640
31489,1704,834,870,2012,95641
31490,6736,3290,3446,2012,95642
31491,1716,1017,699,2012,95645
31492,105,41,64,2012,95646
31493,46870,22811,24059,2012,95648
31494,11504,5667,5837,2012,95650
31495,511,216,295,2012,95651
31496,776,421,355,2012,95652
31497,444,208,236,2012,95653
31498,4687,2163,2524,2012,95655
31499,6664,3117,3547,2012,95658
31500,679,333,346,2012,95659
31501,31443,15822,15621,2012,95660
31502,30373,14584,15789,2012,95661
31503,31672,15781,15891,2012,95662
31504,2749,1311,1438,2012,95663
31505,1169,630,539,2012,95664
31506,4392,2244,2148,2012,95665
31507,5504,2473,3031,2012,95666
31508,36175,17793,18382,2012,95667
31509,908,503,405,2012,95668
31510,2682,1354,1328,2012,95669
31511,53678,26782,26896,2012,95670
31512,5390,2756,2634,2012,95672
31513,14641,7109,7532,2012,95673
31514,803,397,406,2012,95674
31515,627,347,280,2012,95675
31516,22928,10843,12085,2012,95677
31517,42135,20713,21422,2012,95678
31518,35,10,25,2012,95679
31519,152,109,43,2012,95680
31520,1317,695,622,2012,95681
31521,29269,14226,15043,2012,95682
31522,6651,3111,3540,2012,95683
31523,2905,1394,1511,2012,95684
31524,4405,2070,2335,2012,95685
31525,1014,539,475,2012,95686
31526,65634,36464,29170,2012,95687
31527,34385,17017,17368,2012,95688
31528,1130,550,580,2012,95689
31529,2010,925,1085,2012,95690
31530,34676,16718,17958,2012,95691
31531,4968,2452,2516,2012,95692
31532,5616,2668,2948,2012,95693
31533,9739,4617,5122,2012,95694
31534,37556,18173,19383,2012,95695
31535,455,295,160,2012,95697
31536,263,170,93,2012,95698
31537,163,121,42,2012,95699
31538,760,385,375,2012,95701
31539,1082,519,563,2012,95703
31540,4905,2564,2341,2012,95709
31541,9428,4776,4652,2012,95713
31542,335,200,135,2012,95714
31543,67,29,38,2012,95715
31544,234,111,123,2012,95717
31545,93,60,33,2012,95720
31546,13,13,0,2012,95721
31547,4417,2079,2338,2012,95722
31548,0,0,0,2012,95724
31549,8769,4046,4723,2012,95726
31550,352,174,178,2012,95728
31551,29,17,12,2012,95735
31552,264,128,136,2012,95736
31553,8141,4166,3975,2012,95742
31554,23441,11667,11774,2012,95746
31555,51513,24646,26867,2012,95747
31556,41246,21613,19633,2012,95757
31557,61247,29411,31836,2012,95758
31558,39749,20506,19243,2012,95762
31559,34508,16932,17576,2012,95765
31560,21962,11008,10954,2012,95776
31561,7309,3849,3460,2012,95811
31562,9242,5758,3484,2012,95814
31563,25406,12681,12725,2012,95815
31564,16133,7869,8264,2012,95816
31565,13978,6303,7675,2012,95817
31566,19866,9136,10730,2012,95818
31567,16805,7694,9111,2012,95819
31568,33412,15803,17609,2012,95820
31569,32558,15551,17007,2012,95821
31570,42185,19616,22569,2012,95822
31571,73832,35120,38712,2012,95823
31572,30973,16055,14918,2012,95824
31573,31870,14524,17346,2012,95825
31574,37064,18422,18642,2012,95826
31575,20095,9581,10514,2012,95827
31576,59266,29258,30008,2012,95828
31577,26010,12860,13150,2012,95829
31578,787,404,383,2012,95830
31579,42052,19752,22300,2012,95831
31580,12507,5935,6572,2012,95832
31581,37746,17487,20259,2012,95833
31582,24063,12074,11989,2012,95834
31583,38729,19709,19020,2012,95835
31584,289,170,119,2012,95837
31585,35849,18092,17757,2012,95838
31586,18216,8547,9669,2012,95841
31587,31965,15353,16612,2012,95842
31588,46143,21977,24166,2012,95843
31589,21538,10363,11175,2012,95864
31590,32278,16101,16177,2012,95901
31591,2039,1293,746,2012,95903
31592,83,50,33,2012,95910
31593,4799,2361,2438,2012,95912
31594,739,374,365,2012,95914
31595,59,28,31,2012,95915
31596,1210,687,523,2012,95916
31597,3073,1596,1477,2012,95917
31598,1740,857,883,2012,95918
31599,1595,818,777,2012,95919
31600,381,191,190,2012,95920
31601,560,298,262,2012,95922
31602,25,16,9,2012,95923
31603,305,132,173,2012,95925
31604,37613,19128,18485,2012,95926
31605,36517,17585,18932,2012,95928
31606,0,0,0,2012,95930
31607,7795,4124,3671,2012,95932
31608,305,123,182,2012,95934
31609,322,205,117,2012,95935
31610,326,201,125,2012,95936
31611,1160,603,557,2012,95937
31612,4000,1984,2016,2012,95938
31613,474,252,222,2012,95939
31614,410,243,167,2012,95941
31615,1398,764,634,2012,95942
31616,889,446,443,2012,95943
31617,67,37,30,2012,95944
31618,24235,11531,12704,2012,95945
31619,10155,4926,5229,2012,95946
31620,1698,801,897,2012,95947
31621,10501,5482,5019,2012,95948
31622,20810,9976,10834,2012,95949
31623,839,457,382,2012,95950
31624,2654,1445,1209,2012,95951
31625,10447,5119,5328,2012,95953
31626,12336,6212,6124,2012,95954
31627,1189,548,641,2012,95955
31628,421,242,179,2012,95956
31629,950,472,478,2012,95957
31630,17697,9068,8629,2012,95959
31631,929,412,517,2012,95960
31632,26300,13274,13026,2012,95961
31633,1282,722,560,2012,95962
31634,15302,7659,7643,2012,95963
31635,20709,10308,10401,2012,95965
31636,30909,15239,15670,2012,95966
31637,1534,704,830,2012,95968
31638,27385,13117,14268,2012,95969
31639,402,225,177,2012,95970
31640,5789,2808,2981,2012,95971
31641,32008,15656,16352,2012,95973
31642,0,0,0,2012,95974
31643,1914,1080,834,2012,95975
31644,1394,740,654,2012,95977
31645,27,27,0,2012,95978
31646,475,314,161,2012,95979
31647,180,108,72,2012,95981
31648,3082,1488,1594,2012,95982
31649,693,427,266,2012,95983
31650,80,34,46,2012,95984
31651,19,0,19,2012,95986
31652,6059,3108,2951,2012,95987
31653,8789,4384,4405,2012,95988
31654,40172,19587,20585,2012,95991
31655,36715,18736,17979,2012,95993
31656,33805,16441,17364,2012,96001
31657,33360,16228,17132,2012,96002
31658,45295,22194,23101,2012,96003
31659,582,292,290,2012,96006
31660,22304,10576,11728,2012,96007
31661,1196,739,457,2012,96008
31662,552,273,279,2012,96009
31663,209,132,77,2012,96010
31664,116,68,48,2012,96011
31665,3358,1647,1711,2012,96013
31666,251,136,115,2012,96014
31667,645,301,344,2012,96015
31668,530,278,252,2012,96016
31669,232,103,129,2012,96017
31670,10114,4948,5166,2012,96019
31671,2488,1263,1225,2012,96020
31672,15932,8002,7930,2012,96021
31673,17063,8387,8676,2012,96022
31674,1190,574,616,2012,96023
31675,1190,604,586,2012,96024
31676,2243,1095,1148,2012,96025
31677,2353,1235,1118,2012,96027
31678,1552,635,917,2012,96028
31679,130,68,62,2012,96029
31680,169,73,96,2012,96031
31681,2258,1207,1051,2012,96032
31682,402,236,166,2012,96033
31683,300,164,136,2012,96034
31684,3372,1851,1521,2012,96035
31685,303,145,158,2012,96037
31686,478,184,294,2012,96038
31687,1279,623,656,2012,96039
31688,177,97,80,2012,96040
31689,2790,1603,1187,2012,96041
31690,1122,522,600,2012,96044
31691,257,138,119,2012,96046
31692,826,455,371,2012,96047
31693,1078,498,580,2012,96048
31694,109,66,43,2012,96049
31695,460,252,208,2012,96050
31696,1126,617,509,2012,96051
31697,1817,1060,757,2012,96052
31698,291,157,134,2012,96054
31699,4399,2140,2259,2012,96055
31700,1516,721,795,2012,96056
31701,1543,755,788,2012,96057
31702,760,402,358,2012,96058
31703,649,351,298,2012,96059
31704,41,21,20,2012,96061
31705,1247,670,577,2012,96062
31706,193,104,89,2012,96063
31707,4277,2113,2164,2012,96064
31708,330,210,120,2012,96065
31709,7152,3531,3621,2012,96067
31710,219,169,50,2012,96068
31711,812,409,403,2012,96069
31712,88,44,44,2012,96071
31713,4740,2480,2260,2012,96073
31714,247,188,59,2012,96074
31715,355,225,130,2012,96075
31716,147,80,67,2012,96076
31717,28149,13861,14288,2012,96080
31718,579,261,318,2012,96084
31719,31,22,9,2012,96085
31720,402,203,199,2012,96086
31721,487,295,192,2012,96087
31722,4377,2434,1943,2012,96088
31723,419,201,218,2012,96090
31724,732,398,334,2012,96091
31725,269,142,127,2012,96092
31726,3786,1619,2167,2012,96093
31727,6432,3233,3199,2012,96094
31728,828,418,410,2012,96096
31729,10159,5037,5122,2012,96097
31730,4928,2424,2504,2012,96101
31731,1254,578,676,2012,96103
31732,768,389,379,2012,96104
31733,625,261,364,2012,96105
31734,249,133,116,2012,96106
31735,1514,874,640,2012,96107
31736,19,9,10,2012,96108
31737,701,317,384,2012,96109
31738,100,48,52,2012,96110
31739,53,17,36,2012,96111
31740,151,93,58,2012,96112
31741,2001,1652,349,2012,96113
31742,3226,1780,1446,2012,96114
31743,238,102,136,2012,96115
31744,199,102,97,2012,96116
31745,182,92,90,2012,96117
31746,1500,734,766,2012,96118
31747,59,25,34,2012,96119
31748,1054,613,441,2012,96120
31749,274,136,138,2012,96121
31750,4147,2126,2021,2012,96122
31751,20,11,9,2012,96123
31752,366,167,199,2012,96124
31753,318,98,220,2012,96125
31754,128,83,45,2012,96126
31755,537,304,233,2012,96128
31756,164,85,79,2012,96129
31757,22317,14558,7759,2012,96130
31758,29,13,16,2012,96132
31759,110,35,75,2012,96133
31760,2798,1492,1306,2012,96134
31761,78,36,42,2012,96135
31762,161,75,86,2012,96136
31763,3554,1948,1606,2012,96137
31764,1298,633,665,2012,96140
31765,741,388,353,2012,96141
31766,726,299,427,2012,96142
31767,3994,2335,1659,2012,96143
31768,3283,1732,1551,2012,96145
31769,879,421,458,2012,96146
31770,637,312,325,2012,96148
31771,29024,14981,14043,2012,96150
31772,0,0,0,2012,96155
31773,17935,9376,8559,2012,96161
31774,40268,20479,19789,2012,96701
31775,2375,1253,1122,2012,96703
31776,7101,3542,3559,2012,96704
31777,2357,1206,1151,2012,96705
31778,63491,31992,31499,2012,96706
31779,37138,18662,18476,2012,96707
31780,10586,4995,5591,2012,96708
31781,510,260,250,2012,96710
31782,7720,4026,3694,2012,96712
31783,1801,1021,780,2012,96713
31784,968,482,486,2012,96714
31785,2982,1486,1496,2012,96716
31786,5129,2392,2737,2012,96717
31787,2548,1301,1247,2012,96719
31788,47796,23014,24782,2012,96720
31789,2604,1210,1394,2012,96722
31790,4215,2272,1943,2012,96725
31791,579,237,342,2012,96726
31792,5043,2567,2476,2012,96727
31793,553,277,276,2012,96728
31794,1003,486,517,2012,96729
31795,1226,579,647,2012,96730
31796,3148,1583,1565,2012,96731
31797,24808,11880,12928,2012,96732
31798,52650,27235,25415,2012,96734
31799,3664,1864,1800,2012,96737
31800,6353,3414,2939,2012,96738
31801,37265,18993,18272,2012,96740
31802,5277,2828,2449,2012,96741
31803,66,34,32,2012,96742
31804,11377,5728,5649,2012,96743
31805,53095,25612,27483,2012,96744
31806,17465,8933,8532,2012,96746
31807,794,390,404,2012,96747
31808,4284,2144,2140,2012,96748
31809,15588,7717,7871,2012,96749
31810,3627,1877,1750,2012,96750
31811,176,52,124,2012,96751
31812,3248,1714,1534,2012,96752
31813,28097,14393,13704,2012,96753
31814,4524,2385,2139,2012,96754
31815,2727,1420,1307,2012,96755
31816,5557,2573,2984,2012,96756
31817,836,406,430,2012,96757
31818,682,393,289,2012,96759
31819,2453,1240,1213,2012,96760
31820,19717,10031,9686,2012,96761
31821,5767,2634,3133,2012,96762
31822,3429,1893,1536,2012,96763
31823,844,383,461,2012,96764
31824,413,175,238,2012,96765
31825,16226,8022,8204,2012,96766
31826,17687,9147,8540,2012,96768
31827,323,178,145,2012,96769
31828,686,379,307,2012,96770
31829,6185,2957,3228,2012,96771
31830,2165,1119,1046,2012,96772
31831,238,70,168,2012,96773
31832,408,248,160,2012,96774
31833,1987,1200,787,2012,96776
31834,1333,760,573,2012,96777
31835,13334,6752,6582,2012,96778
31836,2704,1382,1322,2012,96779
31837,711,364,347,2012,96780
31838,2140,1069,1071,2012,96781
31839,39561,21018,18543,2012,96782
31840,2066,1062,1004,2012,96783
31841,2589,1275,1314,2012,96785
31842,39677,20102,19575,2012,96786
31843,54479,27733,26746,2012,96789
31844,8734,4160,4574,2012,96790
31845,7790,4026,3764,2012,96791
31846,46723,23133,23590,2012,96792
31847,30565,15478,15087,2012,96793
31848,10037,4764,5273,2012,96795
31849,1824,912,912,2012,96796
31850,75313,37558,37755,2012,96797
31851,23134,11969,11165,2012,96813
31852,18601,9494,9107,2012,96814
31853,31274,15675,15599,2012,96815
31854,51067,24846,26221,2012,96816
31855,56018,27449,28569,2012,96817
31856,51220,25621,25599,2012,96818
31857,50175,25184,24991,2012,96819
31858,19827,9876,9951,2012,96821
31859,44980,21842,23138,2012,96822
31860,29661,14526,15135,2012,96825
31861,31619,15153,16466,2012,96826
31862,0,0,0,2012,96850
31863,252,220,32,2012,96853
31864,2544,2273,271,2012,96857
31865,0,0,0,2012,96859
31866,924,814,110,2012,96860
31867,25,25,0,2012,96863
31868,288,130,158,2012,97001
31869,5781,2905,2876,2012,97002
31870,4860,2467,2393,2012,97004
31871,23745,12308,11437,2012,97005
31872,64347,31660,32687,2012,97006
31873,69030,33373,35657,2012,97007
31874,29750,14375,15375,2012,97008
31875,7998,4000,3998,2012,97009
31876,712,333,379,2012,97011
31877,23219,11137,12082,2012,97013
31878,1109,576,533,2012,97014
31879,19894,9605,10289,2012,97015
31880,6551,3375,3176,2012,97016
31881,2506,1349,1157,2012,97017
31882,2147,1029,1118,2012,97018
31883,3168,1543,1625,2012,97019
31884,692,337,355,2012,97020
31885,758,381,377,2012,97021
31886,3241,1705,1536,2012,97022
31887,10333,5115,5218,2012,97023
31888,9907,4958,4949,2012,97024
31889,3952,2035,1917,2012,97026
31890,12455,5859,6596,2012,97027
31891,133,69,64,2012,97028
31892,330,180,150,2012,97029
31893,37265,18665,18600,2012,97030
31894,18674,9189,9485,2012,97031
31895,4815,2409,2406,2012,97032
31896,43,23,20,2012,97033
31897,18891,9273,9618,2012,97034
31898,23820,11040,12780,2012,97035
31899,882,453,429,2012,97037
31900,15265,7418,7847,2012,97038
31901,411,197,214,2012,97039
31902,1254,557,697,2012,97040
31903,2522,1256,1266,2012,97041
31904,3448,1812,1636,2012,97042
31905,50773,26004,24769,2012,97045
31906,6728,3308,3420,2012,97048
31907,1967,1009,958,2012,97049
31908,262,141,121,2012,97050
31909,15904,7805,8099,2012,97051
31910,3124,1613,1511,2012,97053
31911,1243,639,604,2012,97054
31912,15957,7833,8124,2012,97055
31913,11380,5675,5705,2012,97056
31914,13,6,7,2012,97057
31915,20305,10121,10184,2012,97058
31916,21305,10808,10497,2012,97060
31917,27309,13593,13716,2012,97062
31918,842,459,383,2012,97063
31919,3575,1875,1700,2012,97064
31920,819,376,443,2012,97065
31921,1835,853,982,2012,97067
31922,28303,14130,14173,2012,97068
31923,21114,10056,11058,2012,97070
31924,28716,14844,13872,2012,97071
31925,40102,19644,20458,2012,97080
31926,25919,12653,13266,2012,97086
31927,11689,5814,5875,2012,97089
31928,4056,2071,1985,2012,97101
31929,246,124,122,2012,97102
31930,17036,8612,8424,2012,97103
31931,4153,2023,2130,2012,97106
31932,1395,735,660,2012,97107
31933,430,216,214,2012,97108
31934,744,389,355,2012,97109
31935,1173,501,672,2012,97110
31936,3064,1582,1482,2012,97111
31937,1949,954,995,2012,97112
31938,14134,6734,7400,2012,97113
31939,4980,2369,2611,2012,97114
31940,3908,1960,1948,2012,97115
31941,24440,11618,12822,2012,97116
31942,407,215,192,2012,97117
31943,736,378,358,2012,97118
31944,4486,2289,2197,2012,97119
31945,1469,524,945,2012,97121
31946,651,400,251,2012,97122
31947,44019,22411,21608,2012,97123
31948,48132,24164,23968,2012,97124
31949,217,122,95,2012,97125
31950,3709,1890,1819,2012,97127
31951,36276,17706,18570,2012,97128
31952,438,216,222,2012,97130
31953,2751,1597,1154,2012,97131
31954,28162,13958,14204,2012,97132
31955,4514,2288,2226,2012,97133
31956,95,73,22,2012,97134
31957,963,489,474,2012,97135
31958,1532,756,776,2012,97136
31959,1372,719,653,2012,97137
31960,10019,4932,5087,2012,97138
31961,23309,11672,11637,2012,97140
31962,13607,6676,6931,2012,97141
31963,194,122,72,2012,97144
31964,200,68,132,2012,97145
31965,5898,2911,2987,2012,97146
31966,273,117,156,2012,97147
31967,3485,1827,1658,2012,97148
31968,345,134,211,2012,97149
31969,14744,7332,7412,2012,97201
31970,38951,18937,20014,2012,97202
31971,30003,14164,15839,2012,97203
31972,1557,1252,305,2012,97204
31973,6526,3668,2858,2012,97205
31974,47544,23748,23796,2012,97206
31975,0,0,0,2012,97208
31976,14095,7722,6373,2012,97209
31977,10836,5202,5634,2012,97210
31978,30731,15549,15182,2012,97211
31979,24565,11737,12828,2012,97212
31980,29940,14445,15495,2012,97213
31981,24399,12200,12199,2012,97214
31982,16302,7723,8579,2012,97215
31983,15572,7760,7812,2012,97216
31984,31170,15787,15383,2012,97217
31985,15335,7703,7632,2012,97218
31986,39061,18958,20103,2012,97219
31987,29397,14580,14817,2012,97220
31988,11853,5713,6140,2012,97221
31989,34608,17101,17507,2012,97222
31990,46095,22942,23153,2012,97223
31991,31658,14528,17130,2012,97224
31992,25684,12913,12771,2012,97225
31993,4052,1938,2114,2012,97227
31994,57851,28683,29168,2012,97229
31995,41010,19952,21058,2012,97230
31996,4269,2356,1913,2012,97231
31997,11404,5497,5907,2012,97232
31998,39263,19533,19730,2012,97233
31999,36217,17622,18595,2012,97236
32000,15349,7398,7951,2012,97239
32001,33185,16445,16740,2012,97266
32002,32173,15637,16536,2012,97267
32003,53608,27399,26209,2012,97301
32004,37725,18387,19338,2012,97302
32005,38480,18990,19490,2012,97303
32006,28834,13832,15002,2012,97304
32007,38212,18584,19628,2012,97305
32008,27611,13216,14395,2012,97306
32009,24888,12652,12236,2012,97317
32010,24617,11881,12736,2012,97321
32011,34558,16424,18134,2012,97322
32012,1281,668,613,2012,97324
32013,6729,3256,3473,2012,97325
32014,1012,506,506,2012,97326
32015,2875,1364,1511,2012,97327
32016,93,61,32,2012,97329
32017,41947,20805,21142,2012,97330
32018,2405,1373,1032,2012,97331
32019,21144,10817,10327,2012,97333
32020,19895,9910,9985,2012,97338
32021,2505,1235,1270,2012,97341
32022,177,67,110,2012,97342
32023,381,171,210,2012,97343
32024,1276,630,646,2012,97344
32025,337,160,177,2012,97345
32026,1013,519,494,2012,97346
32027,1585,619,966,2012,97347
32028,1518,799,719,2012,97348
32029,285,154,131,2012,97350
32030,10014,5254,4760,2012,97351
32031,5920,3062,2858,2012,97352
32032,28206,14069,14137,2012,97355
32033,150,86,64,2012,97357
32034,2381,1300,1081,2012,97358
32035,2142,1024,1118,2012,97360
32036,11279,5088,6191,2012,97361
32037,4163,2048,2115,2012,97362
32038,847,373,474,2012,97364
32039,10779,5098,5681,2012,97365
32040,1214,532,682,2012,97366
32041,9062,4320,4742,2012,97367
32042,3604,1816,1788,2012,97368
32043,325,153,172,2012,97369
32044,8037,3893,4144,2012,97370
32045,709,372,337,2012,97371
32046,199,199,0,2012,97373
32047,5284,2761,2523,2012,97374
32048,1026,596,430,2012,97375
32049,1266,563,703,2012,97376
32050,1233,816,417,2012,97377
32051,8479,4943,3536,2012,97378
32052,2945,1505,1440,2012,97380
32053,15365,7392,7973,2012,97381
32054,9831,5118,4713,2012,97383
32055,0,0,0,2012,97384
32056,3123,1399,1724,2012,97385
32057,13639,6639,7000,2012,97386
32058,738,340,398,2012,97388
32059,1694,906,788,2012,97389
32060,706,388,318,2012,97390
32061,5103,2589,2514,2012,97391
32062,5426,2693,2733,2012,97392
32063,4012,2004,2008,2012,97394
32064,2880,1402,1478,2012,97396
32065,39955,20008,19947,2012,97401
32066,50797,24911,25886,2012,97402
32067,12481,6213,6268,2012,97403
32068,32682,16193,16489,2012,97404
32069,43685,21449,22236,2012,97405
32070,94,68,26,2012,97406
32071,11470,5376,6094,2012,97408
32072,761,357,404,2012,97410
32073,6444,3357,3087,2012,97411
32074,542,322,220,2012,97412
32075,1076,471,605,2012,97413
32076,211,147,64,2012,97414
32077,13610,6497,7113,2012,97415
32078,883,455,428,2012,97416
32079,2522,1294,1228,2012,97417
32080,1471,717,754,2012,97419
32081,27785,13855,13930,2012,97420
32082,7238,3589,3649,2012,97423
32083,17068,8389,8679,2012,97424
32084,9704,4600,5104,2012,97426
32085,581,260,321,2012,97429
32086,294,150,144,2012,97430
32087,2373,1132,1241,2012,97431
32088,848,440,408,2012,97434
32089,2169,1197,972,2012,97435
32090,870,420,450,2012,97436
32091,2548,1122,1426,2012,97437
32092,1126,609,517,2012,97438
32093,14795,7143,7652,2012,97439
32094,94,56,38,2012,97441
32095,2083,1099,984,2012,97442
32096,1942,926,1016,2012,97443
32097,5266,2523,2743,2012,97444
32098,5187,2858,2329,2012,97446
32099,883,426,457,2012,97447
32100,11954,6427,5527,2012,97448
32101,1760,957,803,2012,97449
32102,749,401,348,2012,97450
32103,466,271,195,2012,97451
32104,1399,714,685,2012,97452
32105,693,327,366,2012,97453
32106,1464,771,693,2012,97454
32107,2662,1300,1362,2012,97455
32108,2944,1425,1519,2012,97456
32109,9916,4850,5066,2012,97457
32110,4206,2052,2154,2012,97458
32111,14301,6876,7425,2012,97459
32112,607,269,338,2012,97461
32113,4013,2149,1864,2012,97462
32114,3809,1867,1942,2012,97463
32115,2542,1391,1151,2012,97465
32116,1115,558,557,2012,97466
32117,5280,2614,2666,2012,97467
32118,2498,1234,1264,2012,97469
32119,20153,9659,10494,2012,97470
32120,30748,15540,15208,2012,97471
32121,350,178,172,2012,97473
32122,83,52,31,2012,97476
32123,36886,17445,19441,2012,97477
32124,37798,18685,19113,2012,97478
32125,9419,4346,5073,2012,97479
32126,305,163,142,2012,97480
32127,619,306,313,2012,97481
32128,266,140,126,2012,97484
32129,507,280,227,2012,97486
32130,8019,4074,3945,2012,97487
32131,811,446,365,2012,97488
32132,793,377,416,2012,97489
32133,407,186,221,2012,97490
32134,694,377,317,2012,97492
32135,369,221,148,2012,97493
32136,0,0,0,2012,97494
32137,1032,454,578,2012,97495
32138,7147,3558,3589,2012,97496
32139,2043,979,1064,2012,97497
32140,1836,943,893,2012,97498
32141,2038,937,1101,2012,97499
32142,42391,20839,21552,2012,97501
32143,27797,13896,13901,2012,97502
32144,10208,5518,4690,2012,97503
32145,44802,21652,23150,2012,97504
32146,24541,11054,13487,2012,97520
32147,715,348,367,2012,97522
32148,5793,2915,2878,2012,97523
32149,13433,6604,6829,2012,97524
32150,4186,2114,2072,2012,97525
32151,34808,17049,17759,2012,97526
32152,33363,16054,17309,2012,97527
32153,7141,3442,3699,2012,97530
32154,397,167,230,2012,97531
32155,2244,1136,1108,2012,97532
32156,250,145,105,2012,97534
32157,5388,2442,2946,2012,97535
32158,1021,471,550,2012,97536
32159,7628,3912,3716,2012,97537
32160,1999,972,1027,2012,97538
32161,3373,1595,1778,2012,97539
32162,8250,4022,4228,2012,97540
32163,835,411,424,2012,97541
32164,1177,588,589,2012,97543
32165,2466,1155,1311,2012,97544
32166,22748,11208,11540,2012,97601
32167,29360,14133,15227,2012,97603
32168,70,41,29,2012,97604
32169,59,24,35,2012,97620
32170,323,158,165,2012,97621
32171,431,257,174,2012,97622
32172,2402,1203,1199,2012,97623
32173,3093,1575,1518,2012,97624
32174,182,95,87,2012,97625
32175,205,94,111,2012,97626
32176,852,415,437,2012,97627
32177,5080,2693,2387,2012,97630
32178,1333,748,585,2012,97632
32179,1379,852,527,2012,97633
32180,265,117,148,2012,97634
32181,536,309,227,2012,97635
32182,485,223,262,2012,97636
32183,107,63,44,2012,97637
32184,498,261,237,2012,97638
32185,527,289,238,2012,97639
32186,133,82,51,2012,97640
32187,1045,543,502,2012,97641
32188,59089,28598,30491,2012,97701
32189,41433,20956,20477,2012,97702
32190,5863,3174,2689,2012,97707
32191,172,95,77,2012,97710
32192,132,66,66,2012,97711
32193,87,51,36,2012,97712
32194,4217,2214,2003,2012,97720
32195,484,262,222,2012,97721
32196,135,89,46,2012,97722
32197,331,141,190,2012,97730
32198,444,322,122,2012,97731
32199,193,86,107,2012,97732
32200,715,377,338,2012,97733
32201,2976,1420,1556,2012,97734
32202,155,103,52,2012,97735
32203,111,63,48,2012,97736
32204,293,151,142,2012,97737
32205,1766,863,903,2012,97738
32206,10779,5667,5112,2012,97739
32207,11976,6418,5558,2012,97741
32208,377,193,184,2012,97750
32209,136,80,56,2012,97751
32210,14,7,7,2012,97752
32211,2212,1024,1188,2012,97753
32212,18467,9243,9224,2012,97754
32213,34020,16241,17779,2012,97756
32214,75,34,41,2012,97758
32215,6478,3363,3115,2012,97759
32216,6295,3127,3168,2012,97760
32217,3912,2025,1887,2012,97761
32218,21478,11314,10164,2012,97801
32219,780,362,418,2012,97810
32220,894,528,366,2012,97812
32221,1240,559,681,2012,97813
32222,12420,6351,6069,2012,97814
32223,34,13,21,2012,97817
32224,3827,2026,1801,2012,97818
32225,25,10,15,2012,97819
32226,947,455,492,2012,97820
32227,927,443,484,2012,97823
32228,2010,1045,965,2012,97824
32229,261,133,128,2012,97825
32230,990,470,520,2012,97826
32231,2306,1173,1133,2012,97827
32232,2854,1327,1527,2012,97828
32233,595,275,320,2012,97830
32234,976,481,495,2012,97833
32235,981,494,487,2012,97834
32236,423,197,226,2012,97835
32237,2148,1075,1073,2012,97836
32238,69,34,35,2012,97837
32239,25511,13058,12453,2012,97838
32240,539,263,276,2012,97839
32241,95,47,48,2012,97840
32242,417,221,196,2012,97841
32243,164,100,64,2012,97842
32244,637,327,310,2012,97843
32245,3859,1969,1890,2012,97844
32246,2767,1376,1391,2012,97845
32247,1857,950,907,2012,97846
32248,236,110,126,2012,97848
32249,16708,8085,8623,2012,97850
32250,426,219,207,2012,97856
32251,559,269,290,2012,97857
32252,77,33,44,2012,97859
32253,11767,5814,5953,2012,97862
32254,277,147,130,2012,97864
32255,1068,534,534,2012,97865
32256,898,367,531,2012,97867
32257,2027,1016,1011,2012,97868
32258,1159,563,596,2012,97869
32259,382,184,198,2012,97870
32260,125,69,56,2012,97873
32261,353,185,168,2012,97874
32262,2689,1367,1322,2012,97875
32263,1078,573,505,2012,97876
32264,172,90,82,2012,97877
32265,183,112,71,2012,97880
32266,7696,4688,3008,2012,97882
32267,2428,1195,1233,2012,97883
32268,124,62,62,2012,97884
32269,1504,803,701,2012,97885
32270,1132,544,588,2012,97886
32271,612,298,314,2012,97901
32272,137,86,51,2012,97903
32273,172,95,77,2012,97904
32274,148,63,85,2012,97905
32275,292,148,144,2012,97906
32276,552,260,292,2012,97907
32277,63,26,37,2012,97908
32278,22,11,11,2012,97909
32279,717,404,313,2012,97910
32280,58,32,26,2012,97911
32281,5534,2847,2687,2012,97913
32282,19234,10952,8282,2012,97914
32283,4348,2122,2226,2012,97918
32284,22,13,9,2012,97920
32285,32403,16500,15903,2012,98001
32286,32826,15756,17070,2012,98002
32287,43564,20958,22606,2012,98003
32288,27978,13965,14013,2012,98004
32289,16892,8403,8489,2012,98005
32290,37858,18705,19153,2012,98006
32291,25434,13318,12116,2012,98007
32292,24544,12420,12124,2012,98008
32293,4827,2323,2504,2012,98010
32294,30539,14678,15861,2012,98011
32295,51109,24960,26149,2012,98012
32296,6851,3404,3447,2012,98014
32297,10564,5357,5207,2012,98019
32298,18678,8493,10185,2012,98020
32299,26209,12907,13302,2012,98021
32300,21335,10540,10795,2012,98022
32301,48937,24369,24568,2012,98023
32302,5888,3196,2692,2012,98024
32303,35426,17522,17904,2012,98026
32304,27685,13170,14515,2012,98027
32305,20574,10112,10462,2012,98028
32306,25583,12349,13234,2012,98029
32307,30864,15271,15593,2012,98030
32308,33874,17176,16698,2012,98031
32309,31733,15722,16011,2012,98032
32310,34130,16810,17320,2012,98033
32311,43130,21298,21832,2012,98034
32312,35336,18156,17180,2012,98036
32313,28064,13615,14449,2012,98037
32314,31881,15500,16381,2012,98038
32315,2996,1426,1570,2012,98039
32316,22922,11359,11563,2012,98040
32317,42368,21152,21216,2012,98042
32318,20066,9803,10263,2012,98043
32319,13912,7277,6635,2012,98045
32320,6399,3280,3119,2012,98047
32321,174,74,100,2012,98050
32322,3930,2169,1761,2012,98051
32323,58681,30564,28117,2012,98052
32324,20872,10369,10503,2012,98053
32325,20839,10275,10564,2012,98055
32326,32487,17000,15487,2012,98056
32327,10948,5539,5409,2012,98057
32328,43758,21753,22005,2012,98058
32329,35990,18203,17787,2012,98059
32330,12502,6622,5880,2012,98065
32331,348,177,171,2012,98068
32332,10854,5010,5844,2012,98070
32333,22078,10814,11264,2012,98072
32334,24792,12339,12453,2012,98074
32335,21441,10532,10909,2012,98075
32336,14283,7513,6770,2012,98077
32337,30525,14870,15655,2012,98087
32338,39119,20059,19060,2012,98092
32339,9851,5373,4478,2012,98101
32340,21805,10865,10940,2012,98102
32341,44766,22510,22256,2012,98103
32342,12630,7536,5094,2012,98104
32343,45268,22407,22861,2012,98105
32344,23380,12048,11332,2012,98106
32345,21793,10949,10844,2012,98107
32346,23587,11893,11694,2012,98108
32347,21221,11056,10165,2012,98109
32348,22933,11286,11647,2012,98110
32349,21678,10534,11144,2012,98112
32350,46336,23054,23282,2012,98115
32351,23056,10451,12605,2012,98116
32352,31391,15161,16230,2012,98117
32353,43765,20837,22928,2012,98118
32354,21971,10472,11499,2012,98119
32355,11914,6651,5263,2012,98121
32356,31287,15622,15665,2012,98122
32357,36028,18024,18004,2012,98125
32358,20448,9663,10785,2012,98126
32359,44307,21336,22971,2012,98133
32360,915,608,307,2012,98134
32361,14544,6831,7713,2012,98136
32362,26329,13335,12994,2012,98144
32363,24572,12672,11900,2012,98146
32364,9504,4619,4885,2012,98148
32365,0,0,0,2012,98154
32366,32805,16280,16525,2012,98155
32367,0,0,0,2012,98158
32368,29,21,8,2012,98164
32369,18706,9483,9223,2012,98166
32370,32677,16538,16139,2012,98168
32371,57,44,13,2012,98174
32372,19476,9506,9970,2012,98177
32373,24559,11838,12721,2012,98178
32374,22916,11681,11235,2012,98188
32375,12,11,1,2012,98195
32376,35353,18295,17058,2012,98198
32377,20308,9621,10687,2012,98199
32378,28466,14839,13627,2012,98201
32379,34633,16459,18174,2012,98203
32380,40850,20420,20430,2012,98204
32381,11353,5603,5750,2012,98205
32382,1553,1345,208,2012,98207
32383,50834,25141,25693,2012,98208
32384,742,470,272,2012,98220
32385,20340,9919,10421,2012,98221
32386,44,24,20,2012,98222
32387,40293,20332,19961,2012,98223
32388,280,163,117,2012,98224
32389,45783,22238,23545,2012,98225
32390,41464,20788,20676,2012,98226
32391,30862,15477,15385,2012,98229
32392,16136,7995,8141,2012,98230
32393,3458,1808,1650,2012,98232
32394,14839,7383,7456,2012,98233
32395,97,49,48,2012,98235
32396,6244,3286,2958,2012,98236
32397,4052,1946,2106,2012,98237
32398,70,28,42,2012,98238
32399,6758,3126,3632,2012,98239
32400,3140,1549,1591,2012,98240
32401,2069,1069,1000,2012,98241
32402,370,201,169,2012,98243
32403,2922,1405,1517,2012,98244
32404,3494,1682,1812,2012,98245
32405,9379,4825,4554,2012,98247
32406,22117,11096,11021,2012,98248
32407,4394,2192,2202,2012,98249
32408,8050,3906,4144,2012,98250
32409,5011,2686,2325,2012,98251
32410,8233,4461,3772,2012,98252
32411,1719,843,876,2012,98253
32412,369,219,150,2012,98255
32413,390,157,233,2012,98256
32414,4191,2014,2177,2012,98257
32415,30987,15810,15177,2012,98258
32416,5085,2222,2863,2012,98260
32417,2332,1117,1215,2012,98261
32418,1044,564,480,2012,98262
32419,70,39,31,2012,98263
32420,17963,8649,9314,2012,98264
32421,4198,1912,2286,2012,98266
32422,415,177,238,2012,98267
32423,46490,23134,23356,2012,98270
32424,26793,13425,13368,2012,98271
32425,27758,15112,12646,2012,98272
32426,29708,15039,14669,2012,98273
32427,16743,8055,8688,2012,98274
32428,20263,10619,9644,2012,98275
32429,561,253,308,2012,98276
32430,37983,19090,18893,2012,98277
32431,938,773,165,2012,98278
32432,653,342,311,2012,98279
32433,352,160,192,2012,98280
32434,1309,712,597,2012,98281
32435,15586,7552,8034,2012,98282
32436,605,196,409,2012,98283
32437,23475,11752,11723,2012,98284
32438,274,139,135,2012,98286
32439,178,83,95,2012,98288
32440,33228,16347,16881,2012,98290
32441,21414,10791,10623,2012,98292
32442,6579,3316,3263,2012,98294
32443,2245,1166,1079,2012,98295
32444,28225,14348,13877,2012,98296
32445,104,47,57,2012,98297
32446,852,448,404,2012,98303
32447,809,468,341,2012,98304
32448,291,188,103,2012,98305
32449,18939,9002,9937,2012,98310
32450,25970,13048,12922,2012,98311
32451,32040,16876,15164,2012,98312
32452,1484,1310,174,2012,98314
32453,5419,3629,1790,2012,98315
32454,1264,639,625,2012,98320
32455,14066,7285,6781,2012,98321
32456,742,381,361,2012,98323
32457,1908,934,974,2012,98325
32458,1113,878,235,2012,98326
32459,8205,3979,4226,2012,98327
32460,9714,4643,5071,2012,98328
32461,10176,5125,5051,2012,98329
32462,178,76,102,2012,98330
32463,6240,3479,2761,2012,98331
32464,15234,6951,8283,2012,98332
32465,3366,1678,1688,2012,98333
32466,25006,12153,12853,2012,98335
32467,858,428,430,2012,98336
32468,7220,3995,3225,2012,98337
32469,23463,11865,11598,2012,98338
32470,3302,1659,1643,2012,98339
32471,2567,1202,1365,2012,98340
32472,1263,583,680,2012,98342
32473,378,199,179,2012,98345
32474,9777,4878,4899,2012,98346
32475,4281,1911,2370,2012,98349
32476,539,291,248,2012,98350
32477,1216,632,584,2012,98351
32478,0,0,0,2012,98353
32479,7114,3291,3823,2012,98354
32480,580,283,297,2012,98355
32481,1888,894,994,2012,98356
32482,1444,739,705,2012,98357
32483,965,507,458,2012,98358
32484,5338,2925,2413,2012,98359
32485,11862,5883,5979,2012,98360
32486,1384,734,650,2012,98361
32487,21515,10638,10877,2012,98362
32488,14108,7038,7070,2012,98363
32489,0,0,0,2012,98364
32490,4636,2307,2329,2012,98365
32491,34581,17989,16592,2012,98366
32492,27096,13647,13449,2012,98367
32493,14395,6902,7493,2012,98368
32494,28786,13518,15268,2012,98370
32495,20519,9994,10525,2012,98371
32496,22773,11540,11233,2012,98372
32497,22517,11150,11367,2012,98373
32498,38487,18616,19871,2012,98374
32499,27510,13793,13717,2012,98375
32500,1911,974,937,2012,98376
32501,1831,1025,806,2012,98377
32502,4161,1977,2184,2012,98380
32503,616,408,208,2012,98381
32504,26966,12623,14343,2012,98382
32505,20438,10099,10339,2012,98383
32506,489,271,218,2012,98385
32507,44136,21981,22155,2012,98387
32508,7092,4059,3033,2012,98388
32509,10207,5004,5203,2012,98390
32510,44711,22360,22351,2012,98391
32511,2930,1408,1522,2012,98392
32512,1474,822,652,2012,98394
32513,522,255,267,2012,98396
32514,6745,4312,2433,2012,98402
32515,7209,3536,3673,2012,98403
32516,32741,16006,16735,2012,98404
32517,22838,11034,11804,2012,98405
32518,22178,10646,11532,2012,98406
32519,20094,9546,10548,2012,98407
32520,19653,9748,9905,2012,98408
32521,23367,11433,11934,2012,98409
32522,1361,637,724,2012,98416
32523,9755,4739,5016,2012,98418
32524,28,12,16,2012,98421
32525,20523,10041,10482,2012,98422
32526,9967,5012,4955,2012,98424
32527,0,0,0,2012,98430
32528,17860,10453,7407,2012,98433
32529,274,215,59,2012,98438
32530,5443,3085,2358,2012,98439
32531,5354,2781,2573,2012,98443
32532,34654,17293,17361,2012,98444
32533,29799,14958,14841,2012,98445
32534,9767,4784,4983,2012,98446
32535,849,411,438,2012,98447
32536,6138,2855,3283,2012,98465
32537,26942,12316,14626,2012,98466
32538,14440,6854,7586,2012,98467
32539,28148,13636,14512,2012,98498
32540,29351,14371,14980,2012,98499
32541,39154,19049,20105,2012,98501
32542,30621,14665,15956,2012,98502
32543,36469,17244,19225,2012,98503
32544,17079,8364,8715,2012,98506
32545,28330,13824,14506,2012,98512
32546,32672,15687,16985,2012,98513
32547,20666,10170,10496,2012,98516
32548,24275,13184,11091,2012,98520
32549,2689,1378,1311,2012,98524
32550,224,98,126,2012,98526
32551,179,96,83,2012,98527
32552,10072,5005,5067,2012,98528
32553,580,287,293,2012,98530
32554,23486,11355,12131,2012,98531
32555,23766,12094,11672,2012,98532
32556,718,404,314,2012,98533
32557,422,225,197,2012,98535
32558,114,60,54,2012,98536
32559,2132,1036,1096,2012,98537
32560,273,126,147,2012,98538
32561,9958,5372,4586,2012,98541
32562,609,307,302,2012,98542
32563,0,0,0,2012,98544
32564,2931,1580,1351,2012,98546
32565,1619,815,804,2012,98547
32566,2387,1105,1282,2012,98548
32567,12064,5696,6368,2012,98550
32568,446,223,223,2012,98552
32569,282,158,124,2012,98555
32570,3138,1565,1573,2012,98557
32571,158,76,82,2012,98558
32572,0,0,0,2012,98559
32573,195,84,111,2012,98560
32574,132,35,97,2012,98562
32575,8196,4112,4084,2012,98563
32576,2584,1390,1194,2012,98564
32577,581,353,228,2012,98565
32578,2701,1244,1457,2012,98568
32579,5759,2753,3006,2012,98569
32580,3801,2098,1703,2012,98570
32581,401,241,160,2012,98571
32582,608,298,310,2012,98572
32583,193,90,103,2012,98575
32584,4297,2244,2053,2012,98576
32585,6880,3558,3322,2012,98577
32586,13276,6785,6491,2012,98579
32587,10013,5147,4866,2012,98580
32588,239,93,146,2012,98581
32589,716,251,465,2012,98582
32590,90,50,40,2012,98583
32591,36016,18873,17143,2012,98584
32592,538,224,314,2012,98585
32593,1905,943,962,2012,98586
32594,827,462,365,2012,98587
32595,2122,1073,1049,2012,98588
32596,7050,3608,3442,2012,98589
32597,277,136,141,2012,98590
32598,3696,1814,1882,2012,98591
32599,1720,781,939,2012,98592
32600,775,448,327,2012,98593
32601,2406,1384,1022,2012,98595
32602,7741,3759,3982,2012,98596
32603,20957,10634,10323,2012,98597
32604,2492,1195,1297,2012,98601
32605,100,74,26,2012,98602
32606,827,464,363,2012,98603
32607,33812,16526,17286,2012,98604
32608,1578,789,789,2012,98605
32609,8902,4462,4440,2012,98606
32610,27988,14247,13741,2012,98607
32611,2746,1542,1204,2012,98610
32612,9529,4778,4751,2012,98611
32613,2498,1217,1281,2012,98612
32614,526,274,252,2012,98613
32615,227,102,125,2012,98614
32616,157,57,100,2012,98616
32617,1298,626,672,2012,98617
32618,533,250,283,2012,98619
32619,7585,3828,3757,2012,98620
32620,593,287,306,2012,98621
32621,1393,746,647,2012,98624
32622,6197,3018,3179,2012,98625
32623,24538,12420,12118,2012,98626
32624,420,208,212,2012,98628
32625,8536,4436,4100,2012,98629
32626,3549,1710,1839,2012,98631
32627,49014,23581,25433,2012,98632
32628,1610,800,810,2012,98635
32629,1451,809,642,2012,98638
32630,810,376,434,2012,98639
32631,4039,1948,2091,2012,98640
32632,0,0,0,2012,98641
32633,15420,7843,7577,2012,98642
32634,517,272,245,2012,98643
32635,524,298,226,2012,98644
32636,1337,657,680,2012,98645
32637,225,112,113,2012,98647
32638,3098,1565,1533,2012,98648
32639,1000,534,466,2012,98649
32640,819,413,406,2012,98650
32641,869,425,444,2012,98651
32642,12032,5906,6126,2012,98660
32643,41954,20811,21143,2012,98661
32644,32273,16006,16267,2012,98662
32645,13604,7047,6557,2012,98663
32646,21641,10143,11498,2012,98664
32647,22923,10923,12000,2012,98665
32648,110,78,32,2012,98670
32649,21969,11095,10874,2012,98671
32650,5086,2526,2560,2012,98672
32651,406,213,193,2012,98673
32652,11559,6059,5500,2012,98674
32653,6497,3474,3023,2012,98675
32654,55129,27232,27897,2012,98682
32655,30769,14893,15876,2012,98683
32656,27179,13120,14059,2012,98684
32657,26691,13186,13505,2012,98685
32658,17783,8621,9162,2012,98686
32659,40522,19422,21100,2012,98801
32660,28477,13857,14620,2012,98802
32661,102,37,65,2012,98811
32662,4466,2190,2276,2012,98812
32663,3479,1962,1517,2012,98813
32664,420,207,213,2012,98814
32665,7432,3755,3677,2012,98815
32666,6867,3791,3076,2012,98816
32667,566,372,194,2012,98817
32668,144,77,67,2012,98819
32669,566,344,222,2012,98821
32670,2359,1093,1266,2012,98822
32671,10423,5551,4872,2012,98823
32672,340,151,189,2012,98824
32673,6057,2808,3249,2012,98826
32674,572,261,311,2012,98827
32675,1774,896,878,2012,98828
32676,486,250,236,2012,98829
32677,457,240,217,2012,98830
32678,3626,1954,1672,2012,98831
32679,156,65,91,2012,98832
32680,208,80,128,2012,98833
32681,218,125,93,2012,98834
32682,671,352,319,2012,98836
32683,40860,20882,19978,2012,98837
32684,4837,2533,2304,2012,98840
32685,8920,4358,4562,2012,98841
32686,1419,776,643,2012,98843
32687,4513,2285,2228,2012,98844
32688,173,96,77,2012,98845
32689,1077,612,465,2012,98846
32690,2060,1188,872,2012,98847
32691,11980,5681,6299,2012,98848
32692,1551,838,713,2012,98849
32693,1514,731,783,2012,98850
32694,3493,1867,1626,2012,98851
32695,24,2,22,2012,98852
32696,5,3,2,2012,98853
32697,6458,3106,3352,2012,98855
32698,2110,1068,1042,2012,98856
32699,4135,2073,2062,2012,98857
32700,1841,1008,833,2012,98858
32701,192,78,114,2012,98859
32702,318,136,182,2012,98860
32703,2100,1169,931,2012,98862
32704,29745,15048,14697,2012,98901
32705,46682,23011,23671,2012,98902
32706,14845,7265,7580,2012,98903
32707,35331,17265,18066,2012,98908
32708,548,252,296,2012,98921
32709,5145,2730,2415,2012,98922
32710,969,559,410,2012,98923
32711,524,287,237,2012,98925
32712,30841,15281,15560,2012,98926
32713,0,0,0,2012,98929
32714,16347,8306,8041,2012,98930
32715,4959,2340,2619,2012,98932
32716,1113,576,537,2012,98933
32717,1149,604,545,2012,98934
32718,3843,1833,2010,2012,98935
32719,5645,2801,2844,2012,98936
32720,3967,1915,2052,2012,98937
32721,1475,815,660,2012,98938
32722,235,128,107,2012,98939
32723,502,250,252,2012,98940
32724,1019,551,468,2012,98941
32725,16074,8294,7780,2012,98942
32726,688,343,345,2012,98943
32727,22205,11133,11072,2012,98944
32728,525,239,286,2012,98946
32729,2831,1559,1272,2012,98947
32730,13273,6794,6479,2012,98948
32731,263,148,115,2012,98950
32732,13964,7178,6786,2012,98951
32733,2536,1146,1390,2012,98952
32734,7078,3587,3491,2012,98953
32735,6035,3894,2141,2012,99001
32736,4998,2648,2350,2012,99003
32737,17763,8660,9103,2012,99004
32738,8435,4204,4231,2012,99005
32739,10665,5216,5449,2012,99006
32740,559,279,280,2012,99008
32741,4732,2191,2541,2012,99009
32742,3262,1985,1277,2012,99011
32743,1211,655,556,2012,99012
32744,1851,976,875,2012,99013
32745,12621,6167,6454,2012,99016
32746,197,103,94,2012,99017
32747,288,114,174,2012,99018
32748,9939,5033,4906,2012,99019
32749,104,22,82,2012,99020
32750,9160,4610,4550,2012,99021
32751,8670,4187,4483,2012,99022
32752,407,199,208,2012,99023
32753,4771,2285,2486,2012,99025
32754,8735,4538,4197,2012,99026
32755,6270,3189,3081,2012,99027
32756,1686,820,866,2012,99029
32757,1087,532,555,2012,99030
32758,722,400,322,2012,99031
32759,667,325,342,2012,99032
32760,847,390,457,2012,99033
32761,208,119,89,2012,99034
32762,1197,583,614,2012,99036
32763,13306,6812,6494,2012,99037
32764,78,46,32,2012,99039
32765,554,310,244,2012,99040
32766,1685,861,824,2012,99101
32767,442,249,193,2012,99102
32768,446,240,206,2012,99103
32769,42,14,28,2012,99105
32770,4972,2485,2487,2012,99109
32771,1596,905,691,2012,99110
32772,4151,2112,2039,2012,99111
32773,649,339,310,2012,99113
32774,12289,5798,6491,2012,99114
32775,1066,509,557,2012,99115
32776,1859,1074,785,2012,99116
32777,523,256,267,2012,99117
32778,921,510,411,2012,99118
32779,1169,631,538,2012,99119
32780,182,96,86,2012,99121
32781,3742,1955,1787,2012,99122
32782,1293,607,686,2012,99123
32783,355,190,165,2012,99124
32784,583,296,287,2012,99125
32785,1194,582,612,2012,99126
32786,468,264,204,2012,99128
32787,722,424,298,2012,99129
32788,723,356,367,2012,99130
32789,175,95,80,2012,99131
32790,1670,919,751,2012,99133
32791,565,310,255,2012,99134
32792,167,106,61,2012,99135
32793,34,19,15,2012,99136
32794,276,144,132,2012,99137
32795,1074,545,529,2012,99138
32796,1204,590,614,2012,99139
32797,382,218,164,2012,99140
32798,5171,2541,2630,2012,99141
32799,574,308,266,2012,99143
32800,56,35,21,2012,99144
32801,91,39,52,2012,99146
32802,124,55,69,2012,99147
32803,2124,1045,1079,2012,99148
32804,153,67,86,2012,99149
32805,266,145,121,2012,99150
32806,134,68,66,2012,99151
32807,211,122,89,2012,99152
32808,505,289,216,2012,99153
32809,8,3,5,2012,99154
32810,957,494,463,2012,99155
32811,8058,4224,3834,2012,99156
32812,835,437,398,2012,99157
32813,595,283,312,2012,99158
32814,1306,640,666,2012,99159
32815,108,55,53,2012,99160
32816,1350,617,733,2012,99161
32817,31579,16055,15524,2012,99163
32818,3,3,0,2012,99164
32819,3721,1961,1760,2012,99166
32820,590,286,304,2012,99167
32821,2911,1448,1463,2012,99169
32822,1095,550,545,2012,99170
32823,988,484,504,2012,99171
32824,1601,855,746,2012,99173
32825,67,31,36,2012,99174
32826,164,68,96,2012,99176
32827,563,285,278,2012,99179
32828,1079,505,574,2012,99180
32829,1749,883,866,2012,99181
32830,1153,555,598,2012,99185
32831,12945,7202,5743,2012,99201
32832,20895,10211,10684,2012,99202
32833,20324,9951,10373,2012,99203
32834,6824,3515,3309,2012,99204
32835,42036,20212,21824,2012,99205
32836,35821,18289,17532,2012,99206
32837,29723,14431,15292,2012,99207
32838,49284,22755,26529,2012,99208
32839,19150,9813,9337,2012,99212
32840,23294,11278,12016,2012,99216
32841,17173,8456,8717,2012,99217
32842,15785,7459,8326,2012,99218
32843,30023,14461,15562,2012,99223
32844,19485,9681,9804,2012,99224
32845,69086,35514,33572,2012,99301
32846,8589,4433,4156,2012,99320
32847,919,353,566,2012,99321
32848,296,155,141,2012,99322
32849,3646,1807,1839,2012,99323
32850,8816,4271,4545,2012,99324
32851,5107,3043,2064,2012,99326
32852,3759,1925,1834,2012,99328
32853,130,68,62,2012,99329
32854,568,280,288,2012,99330
32855,42,23,19,2012,99333
32856,481,263,218,2012,99335
32857,48276,24050,24226,2012,99336
32858,29968,15461,14507,2012,99337
32859,11701,5591,6110,2012,99338
32860,771,425,346,2012,99341
32861,3000,1644,1356,2012,99343
32862,16341,8308,8033,2012,99344
32863,281,150,131,2012,99345
32864,401,166,235,2012,99346
32865,2292,1105,1187,2012,99347
32866,1857,886,971,2012,99348
32867,7689,3963,3726,2012,99349
32868,12962,6480,6482,2012,99350
32869,27785,13719,14066,2012,99352
32870,13478,6731,6747,2012,99353
32871,21173,10608,10565,2012,99354
32872,392,210,182,2012,99356
32873,3462,2048,1414,2012,99357
32874,98,60,38,2012,99359
32875,1250,580,670,2012,99360
32876,1764,847,917,2012,99361
32877,41274,21511,19763,2012,99362
32878,0,0,0,2012,99363
32879,224,97,127,2012,99371
32880,231,110,121,2012,99401
32881,1619,730,889,2012,99402
32882,19880,9653,10227,2012,99403
32883,16693,8433,8260,2012,99501
32884,24122,11902,12220,2012,99502
32885,14242,7583,6659,2012,99503
32886,40786,20020,20766,2012,99504
32887,6327,3837,2490,2012,99505
32888,7213,3848,3365,2012,99506
32889,39010,20466,18544,2012,99507
32890,35835,17429,18406,2012,99508
32891,257,216,41,2012,99510
32892,0,0,0,2012,99513
32893,22097,10496,11601,2012,99515
32894,20818,10866,9952,2012,99516
32895,15527,8172,7355,2012,99517
32896,10804,5431,5373,2012,99518
32897,745,678,67,2012,99519
32898,324,170,154,2012,99540
32899,127,62,65,2012,99546
32900,87,68,19,2012,99547
32901,66,32,34,2012,99548
32902,70,39,31,2012,99549
32903,259,133,126,2012,99550
32904,638,329,309,2012,99551
32905,364,181,183,2012,99552
32906,932,734,198,2012,99553
32907,570,317,253,2012,99554
32908,208,113,95,2012,99555
32909,2694,1423,1271,2012,99556
32910,701,344,357,2012,99557
32911,94,50,44,2012,99558
32912,7693,3939,3754,2012,99559
32913,489,270,219,2012,99561
32914,953,490,463,2012,99563
32915,116,66,50,2012,99564
32916,76,30,46,2012,99565
32917,248,109,139,2012,99566
32918,9256,4837,4419,2012,99567
32919,198,126,72,2012,99568
32920,72,37,35,2012,99569
32921,82,46,36,2012,99571
32922,315,168,147,2012,99572
32923,798,458,340,2012,99573
32924,2548,1509,1039,2012,99574
32925,152,74,78,2012,99575
32926,2471,1270,1201,2012,99576
32927,26446,13287,13159,2012,99577
32928,281,141,140,2012,99578
32929,47,30,17,2012,99579
32930,119,57,62,2012,99580
32931,847,485,362,2012,99581
32932,18,12,6,2012,99583
32933,365,190,175,2012,99585
32934,644,307,337,2012,99586
32935,1975,1128,847,2012,99587
32936,980,531,449,2012,99588
32937,353,204,149,2012,99589
32938,186,98,88,2012,99590
32939,88,44,44,2012,99591
32940,183,86,97,2012,99602
32941,9518,4750,4768,2012,99603
32942,1195,606,589,2012,99604
32943,98,75,23,2012,99605
32944,401,173,228,2012,99606
32945,228,118,110,2012,99607
32946,557,313,244,2012,99609
32947,2240,1219,1021,2012,99610
32948,15671,8332,7339,2012,99611
32949,892,643,249,2012,99612
32950,360,217,143,2012,99613
32951,626,306,320,2012,99614
32952,12770,6853,5917,2012,99615
32953,565,284,281,2012,99620
32954,705,385,320,2012,99621
32955,252,124,128,2012,99622
32956,95,60,35,2012,99624
32957,112,59,53,2012,99625
32958,267,120,147,2012,99626
32959,416,199,217,2012,99627
32960,475,258,217,2012,99628
32961,173,116,57,2012,99630
32962,348,224,124,2012,99631
32963,768,383,385,2012,99632
32964,578,281,297,2012,99633
32965,340,193,147,2012,99634
32966,521,296,225,2012,99636
32967,650,345,305,2012,99637
32968,30,23,7,2012,99638
32969,863,433,430,2012,99639
32970,208,106,102,2012,99640
32971,403,225,178,2012,99641
32972,243,150,93,2012,99643
32973,343,199,144,2012,99644
32974,24992,12844,12148,2012,99645
32975,26,9,17,2012,99647
32976,98,42,56,2012,99648
32977,71,42,29,2012,99649
32978,510,273,237,2012,99650
32979,53,32,21,2012,99651
32980,4071,2094,1977,2012,99652
32981,158,76,82,2012,99653
32982,52551,27141,25410,2012,99654
32983,635,322,313,2012,99655
32984,27,16,11,2012,99656
32985,402,208,194,2012,99657
32986,704,370,334,2012,99658
32987,393,199,194,2012,99659
32988,643,392,251,2012,99660
32989,1190,866,324,2012,99661
32990,534,284,250,2012,99662
32991,449,217,232,2012,99663
32992,5014,2876,2138,2012,99664
32993,64,23,41,2012,99665
32994,143,80,63,2012,99666
32995,35,14,21,2012,99667
32996,77,45,32,2012,99668
32997,14178,7197,6981,2012,99669
32998,57,29,28,2012,99670
32999,576,293,283,2012,99671
33000,3423,1697,1726,2012,99672
33001,1315,697,618,2012,99674
33002,1329,698,631,2012,99676
33003,47,18,29,2012,99677
33004,1021,515,506,2012,99678
33005,433,207,226,2012,99679
33006,409,234,175,2012,99680
33007,312,160,152,2012,99681
33008,465,263,202,2012,99682
33009,604,294,310,2012,99683
33010,743,397,346,2012,99684
33011,4167,2776,1391,2012,99685
33012,3976,2092,1884,2012,99686
33013,2834,1597,1237,2012,99688
33014,570,296,274,2012,99689
33015,343,185,158,2012,99690
33016,47,34,13,2012,99691
33017,95,68,27,2012,99692
33018,222,118,104,2012,99693
33019,1438,716,722,2012,99694
33020,0,0,0,2012,99695
33021,18748,9695,9053,2012,99701
33022,2628,1350,1278,2012,99702
33023,6968,3884,3084,2012,99703
33024,37,37,0,2012,99704
33025,23904,12352,11552,2012,99705
33026,0,0,0,2012,99706
33027,31235,16618,14617,2012,99709
33028,11798,6346,5452,2012,99712
33029,1164,662,502,2012,99714
33030,126,75,51,2012,99720
33031,344,165,179,2012,99721
33032,104,65,39,2012,99722
33033,4224,2405,1819,2012,99723
33034,88,40,48,2012,99724
33035,64,38,26,2012,99726
33036,527,265,262,2012,99727
33037,180,105,75,2012,99729
33038,122,54,68,2012,99730
33039,0,0,0,2012,99732
33040,74,32,42,2012,99733
33041,831,773,58,2012,99734
33042,87,41,46,2012,99736
33043,5012,2816,2196,2012,99737
33044,155,91,64,2012,99738
33045,354,211,143,2012,99739
33046,517,279,238,2012,99740
33047,559,306,253,2012,99741
33048,719,389,330,2012,99742
33049,1013,493,520,2012,99743
33050,208,100,108,2012,99744
33051,80,36,44,2012,99745
33052,352,187,165,2012,99746
33053,258,157,101,2012,99747
33054,193,140,53,2012,99748
33055,348,180,168,2012,99749
33056,453,275,178,2012,99750
33057,121,55,66,2012,99751
33058,3596,1952,1644,2012,99752
33059,340,180,160,2012,99753
33060,112,56,56,2012,99754
33061,359,139,220,2012,99755
33062,92,43,49,2012,99756
33063,16,9,7,2012,99757
33064,239,131,108,2012,99758
33065,301,187,114,2012,99759
33066,976,604,372,2012,99760
33067,465,238,227,2012,99761
33068,3980,2111,1869,2012,99762
33069,708,404,304,2012,99763
33070,322,160,162,2012,99764
33071,289,164,125,2012,99765
33072,894,468,426,2012,99766
33073,20,11,9,2012,99767
33074,224,129,95,2012,99768
33075,726,373,353,2012,99769
33076,688,360,328,2012,99770
33077,233,136,97,2012,99771
33078,633,331,302,2012,99772
33079,368,191,177,2012,99773
33080,61,33,28,2012,99774
33081,1008,591,417,2012,99775
33082,132,76,56,2012,99776
33083,252,141,111,2012,99777
33084,274,173,101,2012,99778
33085,1569,768,801,2012,99780
33086,160,91,69,2012,99781
33087,645,370,275,2012,99782
33088,108,64,44,2012,99783
33089,164,108,56,2012,99784
33090,337,179,158,2012,99785
33091,240,119,121,2012,99786
33092,59,37,22,2012,99788
33093,487,259,228,2012,99789
33094,58,29,29,2012,99790
33095,290,147,143,2012,99791
33096,29356,15002,14354,2012,99801
33097,427,227,200,2012,99820
33098,2263,1114,1149,2012,99824
33099,67,30,37,2012,99825
33100,511,281,230,2012,99826
33101,2629,1469,1160,2012,99827
33102,760,360,400,2012,99829
33103,413,226,187,2012,99830
33104,110,56,54,2012,99832
33105,3380,1764,1616,2012,99833
33106,8909,4460,4449,2012,99835
33107,29,17,12,2012,99836
33108,1050,549,501,2012,99840
33109,138,82,56,2012,99841
33110,13577,7083,6494,2012,99901
33111,7,5,2,2012,99903
33112,102,79,23,2012,99918
33113,558,328,230,2012,99919
33114,2031,1103,928,2012,99921
33115,411,201,210,2012,99922
33116,77,39,38,2012,99923
33117,673,351,322,2012,99925
33118,1624,879,745,2012,99926
33119,75,42,33,2012,99927
33120,2361,1122,1239,2012,99929
0,Estimate!!SEX AND AGE!!Total population,Estimate!!SEX AND AGE!!Male,Estimate!!SEX AND AGE!!Female,2011,Geographic Area Name
1,313,174,139,2011,89010
2,2172,1324,848,2011,89019
3,10691,5342,5349,2011,89060
4,4658,2490,2168,2011,89061
5,1457,797,660,2011,89439
6,54760,26996,27764,2011,90001
7,46509,22471,24038,2011,90002
8,66183,32017,34166,2011,90003
9,63932,32396,31536,2011,90004
10,41178,21558,19620,2011,90005
11,57912,30013,27899,2011,90006
12,42265,20972,21293,2011,90007
13,34429,15135,19294,2011,90008
14,3229,1601,1628,2011,90010
15,101523,51794,49729,2011,90011
16,29298,17893,11405,2011,90012
17,8216,4984,3232,2011,90013
18,5204,3072,2132,2011,90014
19,17957,9339,8618,2011,90015
20,46871,22290,24581,2011,90016
21,22401,11840,10561,2011,90017
22,48212,23054,25158,2011,90018
23,63894,30962,32932,2011,90019
24,40596,20069,20527,2011,90020
25,2603,1797,806,2011,90021
26,67322,33793,33529,2011,90022
27,44706,22554,22152,2011,90023
28,49427,22855,26572,2011,90024
29,42653,21963,20690,2011,90025
30,70052,35936,34116,2011,90026
31,45491,22691,22800,2011,90027
32,27434,15038,12396,2011,90028
33,38563,19445,19118,2011,90029
34,39076,19399,19677,2011,90031
35,48729,24257,24472,2011,90032
36,49102,24180,24922,2011,90033
37,59662,30174,29488,2011,90034
38,29113,13559,15554,2011,90035
39,36124,17457,18667,2011,90036
40,60639,30147,30492,2011,90037
41,30498,15855,14643,2011,90038
42,29262,15227,14035,2011,90039
43,12862,6544,6318,2011,90040
44,28857,13389,15468,2011,90041
45,63424,31455,31969,2011,90042
46,44042,20290,23752,2011,90043
47,88164,41483,46681,2011,90044
48,40150,19564,20586,2011,90045
49,49212,25876,23336,2011,90046
50,47550,21796,25754,2011,90047
51,20931,9947,10984,2011,90048
52,36451,16624,19827,2011,90049
53,8108,3604,4504,2011,90056
54,43808,23031,20777,2011,90057
55,3484,1633,1851,2011,90058
56,40209,18494,21715,2011,90059
57,26952,13144,13808,2011,90061
58,30710,14111,16599,2011,90062
59,52883,26247,26636,2011,90063
60,25633,12430,13203,2011,90064
61,46844,24714,22130,2011,90065
62,56210,28048,28162,2011,90066
63,2468,1039,1429,2011,90067
64,22048,12241,9807,2011,90068
65,19789,11361,8428,2011,90069
66,0,0,0,2011,90071
67,560,416,144,2011,90073
68,8571,4169,4402,2011,90077
69,0,0,0,2011,90079
70,3516,1471,2045,2011,90089
71,0,0,0,2011,90090
72,4994,2398,2596,2011,90094
73,0,0,0,2011,90095
74,101584,51265,50319,2011,90201
75,21719,10356,11363,2011,90210
76,8097,3326,4771,2011,90211
77,11836,5680,6156,2011,90212
78,50741,24070,26671,2011,90220
79,51535,25173,26362,2011,90221
80,30628,15048,15580,2011,90222
81,32019,14751,17268,2011,90230
82,15001,7697,7304,2011,90232
83,25398,12819,12579,2011,90240
84,43558,21501,22057,2011,90241
85,42373,21373,21000,2011,90242
86,16597,8448,8149,2011,90245
87,46729,22053,24676,2011,90247
88,10268,5436,4832,2011,90248
89,26735,13033,13702,2011,90249
90,93154,45222,47932,2011,90250
91,19422,10268,9154,2011,90254
92,76137,37572,38565,2011,90255
93,34471,17665,16806,2011,90260
94,69643,32757,36886,2011,90262
95,1710,654,1056,2011,90263
96,17822,8843,8979,2011,90265
97,34986,17408,17578,2011,90266
98,27454,13858,13596,2011,90270
99,22765,11021,11744,2011,90272
100,25319,12218,13101,2011,90274
101,41712,20158,21554,2011,90275
102,34382,16964,17418,2011,90277
103,40661,19100,21561,2011,90278
104,94586,46228,48358,2011,90280
105,6820,3083,3737,2011,90290
106,26992,14062,12930,2011,90291
107,22152,10565,11587,2011,90292
108,12833,6221,6612,2011,90293
109,37024,17639,19385,2011,90301
110,30729,14396,16333,2011,90302
111,26055,12560,13495,2011,90303
112,26978,13957,13021,2011,90304
113,14107,5981,8126,2011,90305
114,6531,3674,2857,2011,90401
115,12615,6048,6567,2011,90402
116,24770,11365,13405,2011,90403
117,20123,9411,10712,2011,90404
118,27350,13349,14001,2011,90405
119,41290,20457,20833,2011,90501
120,16655,8282,8373,2011,90502
121,46402,22402,24000,2011,90503
122,31463,15620,15843,2011,90504
123,35804,17200,18604,2011,90505
124,0,0,0,2011,90506
125,32524,15855,16669,2011,90601
126,26210,12943,13267,2011,90602
127,19199,9453,9746,2011,90603
128,40340,20016,20324,2011,90604
129,40159,19847,20312,2011,90605
130,32929,16254,16675,2011,90606
131,43414,20600,22814,2011,90620
132,36338,17582,18756,2011,90621
133,15402,7092,8310,2011,90623
134,47881,22679,25202,2011,90630
135,67707,33244,34463,2011,90631
136,48922,24051,24871,2011,90638
137,62782,30339,32443,2011,90640
138,105348,53703,51645,2011,90650
139,62994,30863,32131,2011,90660
140,15321,7556,7765,2011,90670
141,30526,14609,15917,2011,90680
142,16573,8643,7930,2011,90701
143,49537,23488,26049,2011,90703
144,4060,2052,2008,2011,90704
145,76243,37005,39238,2011,90706
146,27672,13441,14231,2011,90710
147,31786,14599,17187,2011,90712
148,27344,13908,13436,2011,90713
149,20662,10553,10109,2011,90715
150,14265,7158,7107,2011,90716
151,21353,10105,11248,2011,90717
152,21360,10182,11178,2011,90720
153,54196,26320,27876,2011,90723
154,60467,29969,30498,2011,90731
155,20300,9170,11130,2011,90732
156,23875,10661,13214,2011,90740
157,1063,557,506,2011,90742
158,277,131,146,2011,90743
159,56811,28600,28211,2011,90744
160,57668,27803,29865,2011,90745
161,26021,12367,13654,2011,90746
162,0,0,0,2011,90747
163,10893,5461,5432,2011,90755
164,38669,20416,18253,2011,90802
165,30670,14379,16291,2011,90803
166,40817,19342,21475,2011,90804
167,92627,45239,47388,2011,90805
168,42486,20963,21523,2011,90806
169,31912,16159,15753,2011,90807
170,39848,19652,20196,2011,90808
171,37208,18154,19054,2011,90810
172,57602,28721,28881,2011,90813
173,18260,9156,9104,2011,90814
174,41278,20437,20841,2011,90815
175,47,11,36,2011,90822
176,0,0,0,2011,90831
177,38113,18400,19713,2011,91001
178,32233,15435,16798,2011,91006
179,33241,15742,17499,2011,91007
180,1271,614,657,2011,91008
181,24917,12015,12902,2011,91010
182,20308,10105,10203,2011,91011
183,41385,20214,21171,2011,91016
184,8682,3989,4693,2011,91020
185,10881,5269,5612,2011,91024
186,25465,12165,13300,2011,91030
187,20232,10467,9765,2011,91040
188,27593,13774,13819,2011,91042
189,123,15,108,2011,91046
190,21121,10369,10752,2011,91101
191,27330,13252,14078,2011,91103
192,37335,18660,18675,2011,91104
193,10548,5191,5357,2011,91105
194,25096,12623,12473,2011,91106
195,31329,15532,15797,2011,91107
196,13281,6150,7131,2011,91108
197,23419,11363,12056,2011,91201
198,22414,10510,11904,2011,91202
199,13016,6013,7003,2011,91203
200,15830,7897,7933,2011,91204
201,38321,18493,19828,2011,91205
202,32674,15347,17327,2011,91206
203,10566,5402,5164,2011,91207
204,15672,7488,8184,2011,91208
205,194,63,131,2011,91210
206,31642,15316,16326,2011,91214
207,25343,13136,12207,2011,91301
208,25802,12729,13073,2011,91302
209,26308,13537,12771,2011,91303
210,52249,25292,26957,2011,91304
211,47235,24147,23088,2011,91306
212,24506,12166,12340,2011,91307
213,37504,18014,19490,2011,91311
214,26586,12352,14234,2011,91316
215,45205,22226,22979,2011,91320
216,34948,18386,16562,2011,91321
217,26853,13038,13815,2011,91324
218,32497,16029,16468,2011,91325
219,34468,16733,17735,2011,91326
220,794,289,505,2011,91330
221,97523,48300,49223,2011,91331
222,75267,37655,37612,2011,91335
223,34516,17053,17463,2011,91340
224,87707,44428,43279,2011,91342
225,59886,30492,29394,2011,91343
226,53134,26073,27061,2011,91344
227,18629,9071,9558,2011,91345
228,32449,16144,16305,2011,91350
229,31596,16112,15484,2011,91351
230,46561,23377,23184,2011,91352
231,28330,14422,13908,2011,91354
232,32104,15500,16604,2011,91355
233,29905,14115,15790,2011,91356
234,42083,20303,21780,2011,91360
235,20193,9627,10566,2011,91361
236,35267,17131,18136,2011,91362
237,25087,12484,12603,2011,91364
238,39503,19156,20347,2011,91367
239,0,0,0,2011,91371
240,14045,6669,7376,2011,91377
241,18597,8913,9684,2011,91381
242,29617,18685,10932,2011,91384
243,39991,19742,20249,2011,91387
244,19348,9736,9612,2011,91390
245,38600,18624,19976,2011,91401
246,70676,35642,35034,2011,91402
247,23551,11668,11883,2011,91403
248,53395,26483,26912,2011,91405
249,52955,26942,26013,2011,91406
250,23520,12300,11220,2011,91411
251,30268,15068,15200,2011,91423
252,14294,6782,7512,2011,91436
253,20860,10127,10733,2011,91501
254,11134,5194,5940,2011,91502
255,25370,11933,13437,2011,91504
256,29835,14734,15101,2011,91505
257,19039,9321,9718,2011,91506
258,35830,18479,17351,2011,91601
259,17342,8799,8543,2011,91602
260,27107,13273,13834,2011,91604
261,54052,27132,26920,2011,91605
262,45897,23557,22340,2011,91606
263,28346,14091,14255,2011,91607
264,0,0,0,2011,91608
265,40394,19855,20539,2011,91701
266,59967,29483,30484,2011,91702
267,77012,38344,38668,2011,91706
268,3854,1123,2731,2011,91708
269,74765,37005,37760,2011,91709
270,79755,41438,38317,2011,91710
271,35460,16701,18759,2011,91711
272,35400,17522,17878,2011,91722
273,18753,8936,9817,2011,91723
274,24784,11978,12806,2011,91724
275,63925,31637,32288,2011,91730
276,29279,15084,14195,2011,91731
277,62661,30819,31842,2011,91732
278,43459,21653,21806,2011,91733
279,24872,12048,12824,2011,91737
280,34016,16872,17144,2011,91739
281,25235,11671,13564,2011,91740
282,25667,12301,13366,2011,91741
283,83241,41999,41242,2011,91744
284,55723,26383,29340,2011,91745
285,31680,15481,16199,2011,91746
286,47076,23402,23674,2011,91748
287,33800,16580,17220,2011,91750
288,28618,14116,14502,2011,91752
289,32778,15997,16781,2011,91754
290,27442,12871,14571,2011,91755
291,284,107,177,2011,91759
292,59903,29632,30271,2011,91761
293,55801,26248,29553,2011,91762
294,36725,18423,18302,2011,91763
295,53055,26719,26336,2011,91764
296,47017,23507,23510,2011,91765
297,70842,35532,35310,2011,91766
298,49461,24273,25188,2011,91767
299,35525,16742,18783,2011,91768
300,61869,30072,31797,2011,91770
301,33269,15908,17361,2011,91773
302,24677,11856,12821,2011,91775
303,37634,18773,18861,2011,91776
304,34139,16646,17493,2011,91780
305,27285,13428,13857,2011,91784
306,50650,24213,26437,2011,91786
307,42292,20927,21365,2011,91789
308,44720,20686,24034,2011,91790
309,32170,15168,17002,2011,91791
310,30560,14541,16019,2011,91792
311,53135,25420,27715,2011,91801
312,30197,14398,15799,2011,91803
313,16606,8418,8188,2011,91901
314,17399,8353,9046,2011,91902
315,955,537,418,2011,91905
316,3511,1854,1657,2011,91906
317,71887,34730,37157,2011,91910
318,79518,37795,41723,2011,91911
319,40633,19390,21243,2011,91913
320,16741,7176,9565,2011,91914
321,24329,12371,11958,2011,91915
322,1491,737,754,2011,91916
323,648,286,362,2011,91917
324,449,219,230,2011,91931
325,25334,12588,12746,2011,91932
326,477,200,277,2011,91934
327,8387,4351,4036,2011,91935
328,31762,15426,16336,2011,91941
329,38314,18135,20179,2011,91942
330,25343,12688,12655,2011,91945
331,43,14,29,2011,91948
332,60003,29761,30242,2011,91950
333,1027,561,466,2011,91962
334,1424,735,689,2011,91963
335,58402,28866,29536,2011,91977
336,8871,4600,4271,2011,91978
337,359,158,201,2011,91980
338,3841,1932,1909,2011,92003
339,2847,1640,1207,2011,92004
340,11094,5614,5480,2011,92007
341,26343,13512,12831,2011,92008
342,39781,19471,20310,2011,92009
343,14194,7158,7036,2011,92010
344,21982,10656,11326,2011,92011
345,13333,6754,6579,2011,92014
346,42914,20991,21923,2011,92019
347,56836,27776,29060,2011,92020
348,63397,30917,32480,2011,92021
349,48214,24173,24041,2011,92024
350,47937,23503,24434,2011,92025
351,48713,24243,24470,2011,92026
352,54956,26960,27996,2011,92027
353,47278,24443,22835,2011,92028
354,20170,10527,9643,2011,92029
355,2733,1355,1378,2011,92036
356,43149,21137,22012,2011,92037
357,41024,19621,21403,2011,92040
358,42829,21947,20882,2011,92054
359,12107,11119,988,2011,92055
360,50765,24974,25791,2011,92056
361,53061,27013,26048,2011,92057
362,44141,23286,20855,2011,92058
363,1473,768,705,2011,92059
364,212,107,105,2011,92060
365,2678,1407,1271,2011,92061
366,47942,23825,24117,2011,92064
367,36840,18266,18574,2011,92065
368,363,206,157,2011,92066
369,7576,3615,3961,2011,92067
370,45316,22554,22762,2011,92069
371,1243,680,563,2011,92070
372,53302,25584,27718,2011,92071
373,12083,5804,6279,2011,92075
374,41589,19427,22162,2011,92078
375,27927,13829,14098,2011,92081
376,19420,9858,9562,2011,92082
377,36247,17959,18288,2011,92083
378,46982,23489,23493,2011,92084
379,1188,550,638,2011,92086
380,1040,504,536,2011,92091
381,33886,19469,14417,2011,92101
382,42715,22462,20253,2011,92102
383,30324,16137,14187,2011,92103
384,43714,22218,21496,2011,92104
385,65746,32634,33112,2011,92105
386,19217,10028,9189,2011,92106
387,27264,12974,14290,2011,92107
388,17828,8587,9241,2011,92108
389,44095,23685,20410,2011,92109
390,26673,13385,13288,2011,92110
391,44737,21794,22943,2011,92111
392,55206,30655,24551,2011,92113
393,66461,32527,33934,2011,92114
394,59978,30305,29673,2011,92115
395,31847,16469,15378,2011,92116
396,52612,26639,25973,2011,92117
397,18838,9621,9217,2011,92118
398,23772,11526,12246,2011,92119
399,26430,13027,13403,2011,92120
400,4398,2251,2147,2011,92121
401,44768,21951,22817,2011,92122
402,27565,14237,13328,2011,92123
403,31360,15598,15762,2011,92124
404,76373,40539,35834,2011,92126
405,39425,19827,19598,2011,92127
406,47934,22811,25123,2011,92128
407,52942,26604,26338,2011,92129
408,47527,23035,24492,2011,92130
409,34073,16451,17622,2011,92131
410,0,0,0,2011,92132
411,30,30,0,2011,92134
412,793,712,81,2011,92135
413,35249,17570,17679,2011,92139
414,3854,3792,62,2011,92140
415,1014,474,540,2011,92145
416,412,368,44,2011,92147
417,79755,40874,38881,2011,92154
418,843,803,40,2011,92155
419,28055,13125,14930,2011,92173
420,61304,29701,31603,2011,92201
421,24016,12027,11989,2011,92203
422,4797,2311,2486,2011,92210
423,24271,11771,12500,2011,92211
424,31563,14876,16687,2011,92220
425,0,0,0,2011,92222
426,40779,19737,21042,2011,92223
427,25016,16725,8291,2011,92225
428,26079,13055,13024,2011,92227
429,1741,865,876,2011,92230
430,37694,17852,19842,2011,92231
431,10045,7011,3034,2011,92233
432,51130,25439,25691,2011,92234
433,39743,20257,19486,2011,92236
434,284,200,84,2011,92239
435,32695,16564,16131,2011,92240
436,8619,4470,4149,2011,92241
437,1331,565,766,2011,92242
438,47445,23231,24214,2011,92243
439,7347,3848,3499,2011,92249
440,8638,4382,4256,2011,92250
441,21119,12448,8671,2011,92251
442,9430,4858,4572,2011,92252
443,36322,17579,18743,2011,92253
444,10996,5577,5419,2011,92254
445,3632,1858,1774,2011,92256
446,1978,1075,903,2011,92257
447,665,321,344,2011,92258
448,305,183,122,2011,92259
449,31399,14714,16685,2011,92260
450,24827,13811,11016,2011,92262
451,20885,11779,9106,2011,92264
452,144,49,95,2011,92266
453,34,11,23,2011,92267
454,563,306,257,2011,92268
455,17022,8529,8493,2011,92270
456,1691,802,889,2011,92273
457,18184,10079,8105,2011,92274
458,1173,623,550,2011,92275
459,7564,3802,3762,2011,92276
460,23463,11331,12132,2011,92277
461,4835,4627,208,2011,92278
462,0,0,0,2011,92280
463,1872,905,967,2011,92281
464,879,520,359,2011,92282
465,2935,1476,1459,2011,92283
466,24896,12056,12840,2011,92284
467,2667,1412,1255,2011,92285
468,32014,17489,14525,2011,92301
469,38,38,0,2011,92304
470,146,107,39,2011,92305
471,36875,18001,18874,2011,92307
472,39109,17864,21245,2011,92308
473,713,494,219,2011,92309
474,9781,5521,4260,2011,92310
475,32774,16881,15893,2011,92311
476,12132,5870,6262,2011,92313
477,9433,4702,4731,2011,92314
478,5109,2480,2629,2011,92315
479,31232,15791,15441,2011,92316
480,7770,3802,3968,2011,92320
481,789,471,318,2011,92321
482,864,438,426,2011,92322
483,56103,27552,28551,2011,92324
484,7707,3959,3748,2011,92325
485,1253,585,668,2011,92327
486,249,125,124,2011,92328
487,8,8,0,2011,92332
488,663,317,346,2011,92333
489,97773,49701,48072,2011,92335
490,88670,43835,44835,2011,92336
491,35737,18003,17734,2011,92337
492,0,0,0,2011,92338
493,849,356,493,2011,92339
494,233,106,127,2011,92341
495,5207,2504,2703,2011,92342
496,20336,10022,10314,2011,92344
497,76950,38504,38446,2011,92345
498,56748,28351,28397,2011,92346
499,1551,817,734,2011,92347
500,6545,3124,3421,2011,92352
501,21196,10251,10945,2011,92354
502,6310,3017,3293,2011,92356
503,735,336,399,2011,92358
504,7425,3495,3930,2011,92359
505,5183,2568,2615,2011,92363
506,60,36,24,2011,92364
507,2972,1287,1685,2011,92365
508,1095,558,537,2011,92368
509,14618,7655,6963,2011,92371
510,5287,2610,2677,2011,92372
511,33506,16546,16960,2011,92373
512,40472,19158,21314,2011,92374
513,83759,41810,41949,2011,92376
514,19867,9786,10081,2011,92377
515,140,50,90,2011,92378
516,5428,2838,2590,2011,92382
517,42,24,18,2011,92384
518,223,121,102,2011,92385
519,2086,961,1125,2011,92386
520,98,51,47,2011,92389
521,1909,897,1012,2011,92391
522,51454,25098,26356,2011,92392
523,32351,17625,14726,2011,92394
524,42322,20014,22308,2011,92395
525,4757,2356,2401,2011,92397
526,1175,720,455,2011,92398
527,52219,26626,25593,2011,92399
528,2150,1147,1003,2011,92401
529,60073,29222,30851,2011,92404
530,31080,15485,15595,2011,92405
531,56774,28092,28682,2011,92407
532,14277,7331,6946,2011,92408
533,46272,23690,22582,2011,92410
534,25300,12031,13269,2011,92411
535,22186,11411,10775,2011,92501
536,89679,44621,45058,2011,92503
537,53676,26123,27553,2011,92504
538,48132,24535,23597,2011,92505
539,44064,21333,22731,2011,92506
540,52094,26034,26060,2011,92507
541,33685,16579,17106,2011,92508
542,77798,39357,38441,2011,92509
543,791,416,375,2011,92518
544,48418,24667,23751,2011,92530
545,17262,8761,8501,2011,92532
546,3829,1766,2063,2011,92536
547,4719,2289,2430,2011,92539
548,34674,16447,18227,2011,92543
549,44885,22380,22505,2011,92544
550,37241,17174,20067,2011,92545
551,7130,3348,3782,2011,92548
552,2309,1096,1213,2011,92549
553,29973,14905,15068,2011,92551
554,73633,35153,38480,2011,92553
555,37745,18088,19657,2011,92555
556,50049,24643,25406,2011,92557
557,1553,812,741,2011,92561
558,58727,29926,28801,2011,92562
559,52827,25904,26923,2011,92563
560,7891,3908,3983,2011,92567
561,53510,26777,26733,2011,92570
562,50051,24728,25323,2011,92571
563,14568,7104,7464,2011,92582
564,29797,14498,15299,2011,92583
565,42396,21420,20976,2011,92584
566,17015,8351,8664,2011,92585
567,19581,8853,10728,2011,92586
568,15832,7783,8049,2011,92587
569,3355,1583,1772,2011,92590
570,38325,18177,20148,2011,92591
571,68889,33501,35388,2011,92592
572,29855,15128,14727,2011,92595
573,24314,11900,12414,2011,92596
574,21191,10349,10842,2011,92602
575,18805,9366,9439,2011,92603
576,26649,12789,13860,2011,92604
577,20760,10544,10216,2011,92606
578,11811,5916,5895,2011,92610
579,25363,12614,12749,2011,92612
580,23585,11730,11855,2011,92614
581,16149,7321,8828,2011,92617
582,14899,7803,7096,2011,92618
583,37865,18556,19309,2011,92620
584,7531,4046,3485,2011,92624
585,12759,6080,6679,2011,92625
586,50230,25406,24824,2011,92626
587,60152,30341,29811,2011,92627
588,25910,13065,12845,2011,92629
589,58156,29278,28878,2011,92630
590,16246,5705,10541,2011,92637
591,56179,26942,29237,2011,92646
592,56112,28132,27980,2011,92647
593,45000,22224,22776,2011,92648
594,33130,16357,16773,2011,92649
595,23679,12257,11422,2011,92651
596,29358,14518,14840,2011,92653
597,7716,3809,3907,2011,92655
598,48216,22726,25490,2011,92656
599,9710,4860,4850,2011,92657
600,33508,16384,17124,2011,92660
601,4233,2095,2138,2011,92661
602,2761,1211,1550,2011,92662
603,21455,11399,10056,2011,92663
604,34210,16583,17627,2011,92672
605,27922,13775,14147,2011,92673
606,34524,17479,17045,2011,92675
607,2112,1120,992,2011,92676
608,62855,30416,32439,2011,92677
609,591,290,301,2011,92678
610,32974,16236,16738,2011,92679
611,89522,44637,44885,2011,92683
612,43852,21662,22190,2011,92688
613,46753,23255,23498,2011,92691
614,47385,23227,24158,2011,92692
615,20510,10456,10054,2011,92694
616,54353,28423,25930,2011,92701
617,67936,35110,32826,2011,92703
618,87910,44460,43450,2011,92704
619,43942,21759,22183,2011,92705
620,36013,18007,18006,2011,92706
621,59304,29347,29957,2011,92707
622,55554,27510,28044,2011,92708
623,57542,28821,28721,2011,92780
624,21978,10558,11420,2011,92782
625,61500,30618,30882,2011,92801
626,42797,21102,21695,2011,92802
627,85386,41939,43447,2011,92804
628,70267,36055,34212,2011,92805
629,35983,18076,17907,2011,92806
630,35999,17797,18202,2011,92807
631,20738,10242,10496,2011,92808
632,35308,16374,18934,2011,92821
633,3327,1538,1789,2011,92823
634,33851,15778,18073,2011,92831
635,24833,12863,11970,2011,92832
636,51958,25340,26618,2011,92833
637,23107,11090,12017,2011,92835
638,52846,26777,26069,2011,92840
639,32075,16594,15481,2011,92841
640,44127,22051,22076,2011,92843
641,25355,13000,12355,2011,92844
642,16762,7954,8808,2011,92845
643,27256,15210,12046,2011,92860
644,5784,3060,2724,2011,92861
645,17923,9189,8734,2011,92865
646,15035,7136,7899,2011,92866
647,42702,21193,21509,2011,92867
648,26192,14206,11986,2011,92868
649,39963,20214,19749,2011,92869
650,51648,25296,26352,2011,92870
651,45657,22447,23210,2011,92879
652,61035,30718,30317,2011,92880
653,30656,15156,15500,2011,92881
654,67830,34341,33489,2011,92882
655,29265,14517,14748,2011,92883
656,45398,22468,22930,2011,92886
657,20102,10039,10063,2011,92887
658,32940,16699,16241,2011,93001
659,50062,25241,24821,2011,93003
660,28485,13873,14612,2011,93004
661,42352,20858,21494,2011,93010
662,34263,16496,17767,2011,93012
663,15844,7971,7873,2011,93013
664,17571,9068,8503,2011,93015
665,35263,17625,17638,2011,93021
666,6146,3104,3042,2011,93022
667,20688,10256,10432,2011,93023
668,57414,28745,28669,2011,93030
669,80209,41395,38814,2011,93033
670,28146,14045,14101,2011,93035
671,41567,20757,20810,2011,93036
672,1548,727,821,2011,93040
673,24309,12125,12184,2011,93041
674,24,24,0,2011,93042
675,0,0,0,2011,93043
676,33103,16609,16494,2011,93060
677,54866,27090,27776,2011,93063
678,0,0,0,2011,93064
679,71661,34909,36752,2011,93065
680,3113,1639,1474,2011,93066
681,666,308,358,2011,93067
682,31543,15858,15685,2011,93101
683,20724,10737,9987,2011,93103
684,24511,11609,12902,2011,93105
685,11735,5180,6555,2011,93108
686,10227,5181,5046,2011,93109
687,16801,8655,8146,2011,93110
688,17177,8281,8896,2011,93111
689,53028,27624,25404,2011,93117
690,1093,512,581,2011,93201
691,3585,1818,1767,2011,93202
692,20554,10640,9914,2011,93203
693,15705,8766,6939,2011,93204
694,2050,894,1156,2011,93205
695,2134,1087,1047,2011,93206
696,227,114,113,2011,93207
697,96,29,67,2011,93208
698,17756,11599,6157,2011,93210
699,25937,19172,6765,2011,93212
700,55398,32956,22442,2011,93215
701,850,398,452,2011,93218
702,8801,4427,4374,2011,93219
703,28,28,0,2011,93220
704,14519,7621,6898,2011,93221
705,1472,822,650,2011,93222
706,10579,4978,5601,2011,93223
707,503,248,255,2011,93224
708,4722,2331,2391,2011,93225
709,412,227,185,2011,93226
710,65664,34112,31552,2011,93230
711,7026,3265,3761,2011,93234
712,4614,2241,2373,2011,93235
713,1625,898,727,2011,93238
714,1502,820,682,2011,93239
715,5818,2804,3014,2011,93240
716,18119,9318,8801,2011,93241
717,3243,1541,1702,2011,93242
718,1808,844,964,2011,93243
719,305,152,153,2011,93244
720,36606,19829,16777,2011,93245
721,18368,9160,9208,2011,93247
722,2465,1435,1030,2011,93249
723,13661,7936,5725,2011,93250
724,253,150,103,2011,93251
725,4028,3125,903,2011,93252
726,629,354,275,2011,93254
727,338,162,176,2011,93255
728,5196,2880,2316,2011,93256
729,75451,37837,37614,2011,93257
730,1455,750,705,2011,93258
731,137,82,55,2011,93260
732,2895,1488,1407,2011,93261
733,19,0,19,2011,93262
734,19130,9608,9522,2011,93263
735,3438,1799,1639,2011,93265
736,1655,932,723,2011,93266
737,6993,3379,3614,2011,93267
738,16891,8584,8307,2011,93268
739,5649,2732,2917,2011,93270
740,2218,1103,1115,2011,93271
741,3202,1788,1414,2011,93272
742,68532,34305,34227,2011,93274
743,102,68,34,2011,93276
744,50853,24239,26614,2011,93277
745,26732,16775,9957,2011,93280
746,1936,997,939,2011,93283
747,2446,1217,1229,2011,93285
748,9482,4843,4639,2011,93286
749,126,68,58,2011,93287
750,51573,26651,24922,2011,93291
751,37371,18695,18676,2011,93292
752,12138,5983,6155,2011,93301
753,50801,24944,25857,2011,93304
754,36878,19031,17847,2011,93305
755,65735,32321,33414,2011,93306
756,79117,39108,40009,2011,93307
757,52993,26642,26351,2011,93308
758,58934,28835,30099,2011,93309
759,39076,19003,20073,2011,93311
760,53979,26493,27486,2011,93312
761,42406,21779,20627,2011,93313
762,21591,11156,10435,2011,93314
763,27618,13495,14123,2011,93401
764,15014,7260,7754,2011,93402
765,33485,21482,12003,2011,93405
766,0,0,0,2011,93410
767,29480,14473,15007,2011,93420
768,30777,15828,14949,2011,93422
769,805,350,455,2011,93424
770,1086,545,541,2011,93426
771,5229,2703,2526,2011,93427
772,6499,2971,3528,2011,93428
773,224,58,166,2011,93429
774,3094,1590,1504,2011,93430
775,1050,541,509,2011,93432
776,13189,6366,6823,2011,93433
777,6914,3444,3470,2011,93434
778,54014,28169,25845,2011,93436
779,3886,2207,1679,2011,93437
780,1641,804,837,2011,93440
781,1174,571,603,2011,93441
782,10803,5454,5349,2011,93442
783,18948,9397,9551,2011,93444
784,7123,3324,3799,2011,93445
785,42527,21361,21166,2011,93446
786,7753,3659,4094,2011,93449
787,722,381,341,2011,93450
788,4231,1994,2237,2011,93451
789,641,353,288,2011,93452
790,2998,1429,1569,2011,93453
791,34666,17041,17625,2011,93454
792,40718,19417,21301,2011,93455
793,55328,27782,27546,2011,93458
794,5633,2819,2814,2011,93460
795,1397,772,625,2011,93461
796,7712,3974,3738,2011,93463
797,9962,5015,4947,2011,93465
798,5233,2732,2501,2011,93501
799,13658,6531,7127,2011,93505
800,7236,3780,3456,2011,93510
801,61,15,46,2011,93512
802,1430,750,680,2011,93513
803,14978,7479,7499,2011,93514
804,2355,1109,1246,2011,93516
805,516,290,226,2011,93517
806,1139,617,522,2011,93518
807,91,33,58,2011,93519
808,32,18,14,2011,93522
809,3021,1611,1410,2011,93523
810,793,668,125,2011,93524
811,591,276,315,2011,93526
812,2265,1109,1156,2011,93527
813,179,77,102,2011,93528
814,406,309,97,2011,93529
815,20,14,6,2011,93530
816,336,153,183,2011,93531
817,2800,1359,1441,2011,93532
818,37983,18230,19753,2011,93534
819,70008,33844,36164,2011,93535
820,69120,37076,32044,2011,93536
821,554,314,240,2011,93541
822,12639,6744,5895,2011,93543
823,1095,527,568,2011,93544
824,2155,1188,967,2011,93545
825,9207,4866,4341,2011,93546
826,396,175,221,2011,93549
827,72388,35310,37078,2011,93550
828,49896,24707,25189,2011,93551
829,38178,18286,19892,2011,93552
830,2130,1186,944,2011,93553
831,26,16,10,2011,93554
832,31755,15863,15892,2011,93555
833,66,25,41,2011,93558
834,18639,9501,9138,2011,93560
835,35542,20621,14921,2011,93561
836,2047,1064,983,2011,93562
837,353,254,99,2011,93563
838,6935,3551,3384,2011,93591
839,79,61,18,2011,93592
840,1741,798,943,2011,93601
841,4192,2129,2063,2011,93602
842,281,97,184,2011,93603
843,690,320,370,2011,93604
844,227,110,117,2011,93605
845,540,303,237,2011,93606
846,711,308,403,2011,93608
847,5837,2957,2880,2011,93609
848,24456,8345,16111,2011,93610
849,46034,22428,23606,2011,93611
850,34055,16074,17981,2011,93612
851,10786,5552,5234,2011,93614
852,6182,3197,2985,2011,93615
853,3054,1724,1330,2011,93616
854,27670,13935,13735,2011,93618
855,28715,13932,14783,2011,93619
856,9101,5113,3988,2011,93620
857,305,149,156,2011,93621
858,9261,4750,4511,2011,93622
859,53,22,31,2011,93623
860,1177,697,480,2011,93624
861,6715,3450,3265,2011,93625
862,730,414,316,2011,93626
863,0,0,0,2011,93627
864,472,222,250,2011,93628
865,17946,8799,9147,2011,93630
866,15789,8010,7779,2011,93631
867,49,49,0,2011,93633
868,55,32,23,2011,93634
869,38298,18957,19341,2011,93635
870,11850,5761,6089,2011,93636
871,39827,20225,19602,2011,93637
872,46574,24153,22421,2011,93638
873,11505,6130,5375,2011,93640
874,494,335,159,2011,93641
875,3244,1562,1682,2011,93643
876,8353,4312,4041,2011,93644
877,482,228,254,2011,93645
878,10627,4988,5639,2011,93646
879,12323,6088,6235,2011,93647
880,15068,7614,7454,2011,93648
881,4137,1731,2406,2011,93650
882,1561,759,802,2011,93651
883,373,236,137,2011,93652
884,1096,597,499,2011,93653
885,30658,15877,14781,2011,93654
886,6994,3696,3298,2011,93656
887,35191,17501,17690,2011,93657
888,4399,2299,2100,2011,93660
889,29711,15179,14532,2011,93662
890,662,397,265,2011,93664
891,559,352,207,2011,93665
892,266,138,128,2011,93666
893,2403,1191,1212,2011,93667
894,1668,764,904,2011,93668
895,193,46,147,2011,93669
896,1046,628,418,2011,93673
897,2563,1148,1415,2011,93675
898,11183,6163,5020,2011,93701
899,48368,25032,23336,2011,93702
900,32765,16597,16168,2011,93703
901,26249,13110,13139,2011,93704
902,37665,18013,19652,2011,93705
903,39076,19870,19206,2011,93706
904,31448,15495,15953,2011,93710
905,39723,18804,20919,2011,93711
906,46908,22603,24305,2011,93720
907,7227,4451,2776,2011,93721
908,76432,37996,38436,2011,93722
909,9137,4539,4598,2011,93723
910,24553,12602,11951,2011,93725
911,40978,19705,21273,2011,93726
912,67324,32805,34519,2011,93727
913,15532,7793,7739,2011,93728
914,9391,4572,4819,2011,93730
915,26409,13328,13081,2011,93901
916,59341,30371,28970,2011,93905
917,59947,29838,30109,2011,93906
918,22251,11477,10774,2011,93907
919,12948,6330,6618,2011,93908
920,977,595,382,2011,93920
921,3118,1426,1692,2011,93921
922,13310,5941,7369,2011,93923
923,6070,3070,3000,2011,93924
924,1720,844,876,2011,93925
925,8149,4295,3854,2011,93926
926,16406,8128,8278,2011,93927
927,381,220,161,2011,93928
928,15936,8750,7186,2011,93930
929,452,268,184,2011,93932
930,22920,11362,11558,2011,93933
931,31668,15740,15928,2011,93940
932,62,59,3,2011,93943
933,14995,7145,7850,2011,93950
934,4312,1948,2364,2011,93953
935,291,140,151,2011,93954
936,33027,16867,16160,2011,93955
937,26631,18393,8238,2011,93960
938,803,440,363,2011,93962
939,25797,12757,13040,2011,94002
940,4179,2038,2141,2011,94005
941,40296,19686,20610,2011,94010
942,47087,23740,23347,2011,94014
943,59825,28946,30879,2011,94015
944,17984,8683,9301,2011,94019
945,1819,967,852,2011,94020
946,83,33,50,2011,94021
947,18850,9463,9387,2011,94022
948,22448,10791,11657,2011,94024
949,39790,18973,20817,2011,94025
950,7028,3504,3524,2011,94027
951,6740,3285,3455,2011,94028
952,21275,10353,10922,2011,94030
953,2739,1167,1572,2011,94037
954,2439,1101,1338,2011,94038
955,33366,16881,16485,2011,94040
956,12838,6545,6293,2011,94041
957,26940,13804,13136,2011,94043
958,37286,18478,18808,2011,94044
959,1671,828,843,2011,94060
960,35697,17071,18626,2011,94061
961,26346,12825,13521,2011,94062
962,30788,16443,14345,2011,94063
963,10954,5408,5546,2011,94065
964,40974,20151,20823,2011,94066
965,29044,14012,15032,2011,94070
966,193,121,72,2011,94074
967,63275,31315,31960,2011,94080
968,22898,11790,11108,2011,94085
969,43843,22912,20931,2011,94086
970,52495,26409,26086,2011,94087
971,19994,9669,10325,2011,94089
972,24754,14883,9871,2011,94102
973,23361,13368,9993,2011,94103
974,286,107,179,2011,94104
975,4225,2484,1741,2011,94105
976,27185,14391,12794,2011,94107
977,13851,6971,6880,2011,94108
978,53809,26992,26817,2011,94109
979,70174,36973,33201,2011,94110
980,3562,1805,1757,2011,94111
981,79915,39602,40313,2011,94112
982,32175,19117,13058,2011,94114
983,32180,15137,17043,2011,94115
984,43980,20590,23390,2011,94116
985,41214,21361,19853,2011,94117
986,38529,18823,19706,2011,94118
987,44169,20792,23377,2011,94121
988,56859,28080,28779,2011,94122
989,22350,10030,12320,2011,94123
990,33558,16307,17251,2011,94124
991,19300,9830,9470,2011,94127
992,31,0,31,2011,94128
993,2690,1544,1146,2011,94129
994,2300,1400,900,2011,94130
995,27718,14811,12907,2011,94131
996,30306,14344,15962,2011,94132
997,27357,13505,13852,2011,94133
998,39032,19316,19716,2011,94134
999,3144,1927,1217,2011,94158
1000,16855,8672,8183,2011,94301
1001,44714,22400,22314,2011,94303
1002,3594,1792,1802,2011,94304
1003,13397,7295,6102,2011,94305
1004,26309,13025,13284,2011,94306
1005,34845,17504,17341,2011,94401
1006,23408,11463,11945,2011,94402
1007,39102,18755,20347,2011,94403
1008,32986,16145,16841,2011,94404
1009,60099,28860,31239,2011,94501
1010,13140,6352,6788,2011,94502
1011,18776,8879,9897,2011,94503
1012,12560,6640,5920,2011,94505
1013,21283,10431,10852,2011,94506
1014,15844,7814,8030,2011,94507
1015,3607,1863,1744,2011,94508
1016,61266,29053,32213,2011,94509
1017,27163,13353,13810,2011,94510
1018,1882,893,989,2011,94511
1019,300,65,235,2011,94512
1020,51493,25438,26055,2011,94513
1021,1393,735,658,2011,94514
1022,6843,3396,3447,2011,94515
1023,144,78,66,2011,94516
1024,12542,6577,5965,2011,94517
1025,26322,12938,13384,2011,94518
1026,18937,9542,9395,2011,94519
1027,36321,18730,17591,2011,94520
1028,41880,20321,21559,2011,94521
1029,33545,16393,17152,2011,94523
1030,2946,1507,1439,2011,94525
1031,31644,14935,16709,2011,94526
1032,1043,489,554,2011,94528
1033,23742,11085,12657,2011,94530
1034,40115,19946,20169,2011,94531
1035,67287,32840,34447,2011,94533
1036,33850,15958,17892,2011,94534
1037,6549,4448,2101,2011,94535
1038,66617,33616,33001,2011,94536
1039,60461,30210,30251,2011,94538
1040,51021,25370,25651,2011,94539
1041,59173,29266,29907,2011,94541
1042,12534,6225,6309,2011,94542
1043,74499,36930,37569,2011,94544
1044,28935,14236,14699,2011,94545
1045,42100,19981,22119,2011,94546
1046,23573,11225,12348,2011,94547
1047,396,200,196,2011,94548
1048,26822,13087,13735,2011,94549
1049,45154,21989,23165,2011,94550
1050,36815,19101,17714,2011,94551
1051,14568,7278,7290,2011,94552
1052,46823,23295,23528,2011,94553
1053,33656,17177,16479,2011,94555
1054,14342,6690,7652,2011,94556
1055,65916,33335,32581,2011,94558
1056,27331,13857,13474,2011,94559
1057,42322,21004,21318,2011,94560
1058,35383,17746,17637,2011,94561
1059,17595,8524,9071,2011,94563
1060,18470,9120,9350,2011,94564
1061,84558,41558,43000,2011,94565
1062,40443,19663,20780,2011,94566
1063,803,406,397,2011,94567
1064,44101,22173,21928,2011,94568
1065,274,171,103,2011,94569
1066,7515,3459,4056,2011,94571
1067,8847,4456,4391,2011,94572
1068,100,55,45,2011,94573
1069,9298,4333,4965,2011,94574
1070,1770,889,881,2011,94575
1071,89,32,57,2011,94576
1072,44521,21894,22627,2011,94577
1073,37757,17968,19789,2011,94578
1074,20167,9643,10524,2011,94579
1075,28430,13409,15021,2011,94580
1076,35156,17078,18078,2011,94582
1077,35147,17715,17432,2011,94583
1078,28859,15080,13779,2011,94585
1079,785,360,425,2011,94586
1080,68830,34002,34828,2011,94587
1081,29918,15514,14404,2011,94588
1082,30961,14147,16814,2011,94589
1083,34466,17377,17089,2011,94590
1084,53310,25357,27953,2011,94591
1085,493,213,280,2011,94592
1086,16170,6329,9841,2011,94595
1087,19869,9373,10496,2011,94596
1088,20473,9739,10734,2011,94597
1089,26180,12074,14106,2011,94598
1090,3041,1508,1533,2011,94599
1091,49479,25134,24345,2011,94601
1092,28827,13354,15473,2011,94602
1093,32716,15659,17057,2011,94603
1094,40356,19169,21187,2011,94605
1095,35835,17638,18197,2011,94606
1096,22745,10465,12280,2011,94607
1097,25847,12705,13142,2011,94608
1098,20728,9704,11024,2011,94609
1099,30242,14104,16138,2011,94610
1100,37192,18077,19115,2011,94611
1101,12492,6237,6255,2011,94612
1102,722,172,550,2011,94613
1103,16753,7981,8772,2011,94618
1104,23581,11608,11973,2011,94619
1105,30509,15205,15304,2011,94621
1106,15994,7723,8271,2011,94702
1107,20593,10158,10435,2011,94703
1108,22873,10692,12181,2011,94704
1109,12560,6277,6283,2011,94705
1110,19168,9160,10008,2011,94706
1111,12191,5774,6417,2011,94707
1112,11120,5476,5644,2011,94708
1113,12584,6916,5668,2011,94709
1114,6205,3042,3163,2011,94710
1115,2805,1309,1496,2011,94720
1116,28215,13799,14416,2011,94801
1117,26040,12613,13427,2011,94803
1118,37841,18021,19820,2011,94804
1119,13647,6723,6924,2011,94805
1120,59944,29892,30052,2011,94806
1121,0,0,0,2011,94850
1122,40364,20588,19776,2011,94901
1123,29062,13935,15127,2011,94903
1124,12384,5819,6565,2011,94904
1125,12477,5747,6730,2011,94920
1126,212,86,126,2011,94922
1127,1065,507,558,2011,94923
1128,1140,569,571,2011,94924
1129,9191,4231,4960,2011,94925
1130,42021,20045,21976,2011,94928
1131,132,62,70,2011,94929
1132,8367,4174,4193,2011,94930
1133,8601,4267,4334,2011,94931
1134,1236,623,613,2011,94933
1135,1096,631,465,2011,94937
1136,900,398,502,2011,94938
1137,6551,3023,3528,2011,94939
1138,170,92,78,2011,94940
1139,30571,14592,15979,2011,94941
1140,16965,8235,8730,2011,94945
1141,507,259,248,2011,94946
1142,24007,11320,12687,2011,94947
1143,16539,7918,8621,2011,94949
1144,42,10,32,2011,94950
1145,3866,1950,1916,2011,94951
1146,32063,16067,15996,2011,94952
1147,37333,18189,19144,2011,94954
1148,1911,769,1142,2011,94956
1149,1034,489,545,2011,94957
1150,15417,7295,8122,2011,94960
1151,494,265,229,2011,94963
1152,5770,5520,250,2011,94964
1153,10883,4982,5901,2011,94965
1154,519,284,235,2011,94970
1155,548,299,249,2011,94971
1156,233,167,66,2011,94972
1157,1549,798,751,2011,94973
1158,1716,832,884,2011,95002
1159,24421,11858,12563,2011,95003
1160,3494,1759,1735,2011,95004
1161,6002,2795,3207,2011,95005
1162,9176,4657,4519,2011,95006
1163,604,449,155,2011,95007
1164,44419,21880,22539,2011,95008
1165,9109,4583,4526,2011,95010
1166,10278,5187,5091,2011,95012
1167,0,0,0,2011,95013
1168,59944,28992,30952,2011,95014
1169,760,399,361,2011,95017
1170,8316,4142,4174,2011,95018
1171,8417,4002,4415,2011,95019
1172,56708,28247,28461,2011,95020
1173,49326,24505,24821,2011,95023
1174,13477,6308,7169,2011,95030
1175,24573,12268,12305,2011,95032
1176,9193,4720,4473,2011,95033
1177,66437,34251,32186,2011,95035
1178,45429,22147,23282,2011,95037
1179,1134,530,604,2011,95039
1180,150,77,73,2011,95041
1181,524,262,262,2011,95043
1182,3633,1926,1707,2011,95045
1183,6346,3265,3081,2011,95046
1184,35088,17589,17499,2011,95050
1185,53844,26613,27231,2011,95051
1186,2369,1178,1191,2011,95053
1187,22233,11282,10951,2011,95054
1188,46942,24069,22873,2011,95060
1189,34933,17516,17417,2011,95062
1190,6020,2944,3076,2011,95064
1191,8587,4241,4346,2011,95065
1192,14836,7281,7555,2011,95066
1193,30215,14906,15309,2011,95070
1194,9828,4934,4894,2011,95073
1195,254,126,128,2011,95075
1196,80273,39871,40402,2011,95076
1197,17717,9832,7885,2011,95110
1198,56572,28526,28046,2011,95111
1199,50940,26799,24141,2011,95112
1200,713,399,314,2011,95113
1201,47858,24728,23130,2011,95116
1202,29924,15425,14499,2011,95117
1203,30455,14603,15852,2011,95118
1204,10031,5215,4816,2011,95119
1205,38552,19125,19427,2011,95120
1206,38094,19215,18879,2011,95121
1207,52829,26813,26016,2011,95122
1208,61994,30464,31530,2011,95123
1209,47031,23680,23351,2011,95124
1210,51718,24775,26943,2011,95125
1211,31343,15898,15445,2011,95126
1212,65318,33347,31971,2011,95127
1213,34776,18437,16339,2011,95128
1214,38450,18751,19699,2011,95129
1215,14265,7390,6875,2011,95130
1216,28809,14833,13976,2011,95131
1217,40779,20113,20666,2011,95132
1218,25772,12677,13095,2011,95133
1219,15467,8295,7172,2011,95134
1220,20691,9972,10719,2011,95135
1221,42382,21063,21319,2011,95136
1222,20113,9606,10507,2011,95138
1223,6515,3022,3493,2011,95139
1224,109,71,38,2011,95140
1225,45384,22686,22698,2011,95148
1226,5591,2929,2662,2011,95202
1227,15155,7958,7197,2011,95203
1228,29342,14138,15204,2011,95204
1229,36019,18568,17451,2011,95205
1230,63292,31742,31550,2011,95206
1231,47448,22538,24910,2011,95207
1232,41533,19813,21720,2011,95209
1233,41066,19827,21239,2011,95210
1234,1957,594,1363,2011,95211
1235,24795,12578,12217,2011,95212
1236,23088,12146,10942,2011,95215
1237,27370,13014,14356,2011,95219
1238,6721,3419,3302,2011,95220
1239,5055,2281,2774,2011,95222
1240,3709,1886,1823,2011,95223
1241,303,147,156,2011,95224
1242,504,226,278,2011,95225
1243,297,168,129,2011,95226
1244,937,479,458,2011,95227
1245,4247,2205,2042,2011,95228
1246,564,279,285,2011,95230
1247,5496,3534,1962,2011,95231
1248,264,81,183,2011,95232
1249,237,79,158,2011,95233
1250,216,199,17,2011,95234
1251,3824,1804,2020,2011,95236
1252,3321,1666,1655,2011,95237
1253,46825,22855,23970,2011,95240
1254,25033,12181,12852,2011,95242
1255,2214,1192,1022,2011,95245
1256,1291,691,600,2011,95246
1257,4459,2053,2406,2011,95247
1258,227,62,165,2011,95248
1259,3769,2108,1661,2011,95249
1260,35,18,17,2011,95250
1261,979,524,455,2011,95251
1262,15154,7624,7530,2011,95252
1263,144,62,82,2011,95254
1264,2516,1291,1225,2011,95255
1265,431,172,259,2011,95257
1266,4163,2081,2082,2011,95258
1267,36199,18380,17819,2011,95301
1268,1049,515,534,2011,95303
1269,17191,10377,6814,2011,95304
1270,82,37,45,2011,95305
1271,933,480,453,2011,95306
1272,43518,21743,21775,2011,95307
1273,1779,858,921,2011,95310
1274,2544,1335,1209,2011,95311
1275,540,294,246,2011,95312
1276,1812,1151,661,2011,95313
1277,0,0,0,2011,95314
1278,12340,6216,6124,2011,95315
1279,6581,2985,3596,2011,95316
1280,837,490,347,2011,95317
1281,520,171,349,2011,95318
1282,1428,693,735,2011,95319
1283,13044,6583,6461,2011,95320
1284,3423,1667,1756,2011,95321
1285,10167,5169,4998,2011,95322
1286,1099,575,524,2011,95323
1287,6607,3466,3141,2011,95324
1288,67,51,16,2011,95325
1289,8561,3999,4562,2011,95326
1290,9891,6553,3338,2011,95327
1291,3749,1902,1847,2011,95328
1292,2538,1248,1290,2011,95329
1293,17328,8809,8519,2011,95330
1294,3094,1574,1520,2011,95333
1295,15777,8135,7642,2011,95334
1296,750,273,477,2011,95335
1297,42331,21113,21218,2011,95336
1298,30478,14762,15716,2011,95337
1299,11713,5711,6002,2011,95338
1300,32014,14786,17228,2011,95340
1301,33881,17276,16605,2011,95341
1302,198,113,85,2011,95345
1303,815,431,384,2011,95346
1304,29398,14512,14886,2011,95348
1305,50103,24405,25698,2011,95350
1306,46354,22844,23510,2011,95351
1307,24643,12543,12100,2011,95354
1308,59159,27229,31930,2011,95355
1309,31669,15427,16242,2011,95356
1310,11004,5308,5696,2011,95357
1311,30664,15376,15288,2011,95358
1312,11408,5557,5851,2011,95360
1313,32328,15860,16468,2011,95361
1314,25235,13578,11657,2011,95363
1315,0,0,0,2011,95364
1316,4882,2569,2313,2011,95365
1317,16022,7823,8199,2011,95366
1318,22686,11691,10995,2011,95367
1319,15128,8009,7119,2011,95368
1320,1436,730,706,2011,95369
1321,27767,13747,14020,2011,95370
1322,1744,922,822,2011,95372
1323,1819,1099,720,2011,95374
1324,168,92,76,2011,95375
1325,48593,24359,24234,2011,95376
1326,29649,15180,14469,2011,95377
1327,3986,1966,2020,2011,95379
1328,39661,19882,19779,2011,95380
1329,36863,18301,18562,2011,95382
1330,3885,2078,1807,2011,95383
1331,366,156,210,2011,95385
1332,9802,5136,4666,2011,95386
1333,759,414,345,2011,95387
1334,14248,7473,6775,2011,95388
1335,1015,722,293,2011,95389
1336,9066,4251,4815,2011,95391
1337,35290,17612,17678,2011,95401
1338,44676,22412,22264,2011,95403
1339,38803,19321,19482,2011,95404
1340,20898,10230,10668,2011,95405
1341,39221,20252,18969,2011,95407
1342,26843,12586,14257,2011,95409
1343,884,312,572,2011,95410
1344,235,129,106,2011,95412
1345,1605,885,720,2011,95415
1346,123,60,63,2011,95417
1347,494,226,268,2011,95420
1348,1405,726,679,2011,95421
1349,15403,7687,7716,2011,95422
1350,2949,1652,1297,2011,95423
1351,10524,5230,5294,2011,95425
1352,2287,1132,1155,2011,95426
1353,266,156,110,2011,95427
1354,2458,1127,1331,2011,95428
1355,150,85,65,2011,95429
1356,0,0,0,2011,95430
1357,435,211,224,2011,95431
1358,516,239,277,2011,95432
1359,193,147,46,2011,95435
1360,5107,2649,2458,2011,95436
1361,13992,6998,6994,2011,95437
1362,812,386,426,2011,95439
1363,2538,1545,993,2011,95441
1364,3859,1888,1971,2011,95442
1365,219,123,96,2011,95443
1366,905,291,614,2011,95444
1367,1754,912,842,2011,95445
1368,5004,2718,2286,2011,95446
1369,17448,8378,9070,2011,95448
1370,1898,967,931,2011,95449
1371,257,108,149,2011,95450
1372,11311,5695,5616,2011,95451
1373,801,352,449,2011,95452
1374,11721,5957,5764,2011,95453
1375,2256,1216,1040,2011,95454
1376,807,228,579,2011,95456
1377,3191,1550,1641,2011,95457
1378,2493,1256,1237,2011,95458
1379,444,191,253,2011,95459
1380,2698,1250,1448,2011,95460
1381,3598,1909,1689,2011,95461
1382,1277,531,746,2011,95462
1383,0,0,0,2011,95463
1384,2183,907,1276,2011,95464
1385,2279,1215,1064,2011,95465
1386,910,572,338,2011,95466
1387,6243,3152,3091,2011,95467
1388,1282,602,680,2011,95468
1389,1890,990,900,2011,95469
1390,5960,3096,2864,2011,95470
1391,452,180,272,2011,95471
1392,29119,14509,14610,2011,95472
1393,36452,17041,19411,2011,95476
1394,33119,17138,15981,2011,95482
1395,2377,1207,1170,2011,95485
1396,45,14,31,2011,95486
1397,352,181,171,2011,95488
1398,12768,6040,6728,2011,95490
1399,28079,13448,14631,2011,95492
1400,166,55,111,2011,95493
1401,154,86,68,2011,95494
1402,812,396,416,2011,95497
1403,23564,11846,11718,2011,95501
1404,25003,12124,12879,2011,95503
1405,306,128,178,2011,95511
1406,134,59,75,2011,95514
1407,18992,9743,9249,2011,95519
1408,20055,9814,10241,2011,95521
1409,2002,1003,999,2011,95524
1410,1681,899,782,2011,95525
1411,517,244,273,2011,95526
1412,496,251,245,2011,95527
1413,1071,491,580,2011,95528
1414,24605,13654,10951,2011,95531
1415,3030,1525,1505,2011,95536
1416,195,102,93,2011,95537
1417,13464,6731,6733,2011,95540
1418,2105,975,1130,2011,95542
1419,652,376,276,2011,95543
1420,58,30,28,2011,95545
1421,3387,1610,1777,2011,95546
1422,1108,603,505,2011,95547
1423,1685,967,718,2011,95548
1424,758,381,377,2011,95549
1425,242,159,83,2011,95550
1426,2002,1160,842,2011,95551
1427,554,324,230,2011,95552
1428,663,406,257,2011,95553
1429,485,253,232,2011,95554
1430,360,200,160,2011,95555
1431,600,387,213,2011,95556
1432,300,175,125,2011,95558
1433,130,35,95,2011,95559
1434,1257,628,629,2011,95560
1435,3378,1672,1706,2011,95562
1436,631,333,298,2011,95563
1437,560,316,244,2011,95564
1438,1150,578,572,2011,95565
1439,1619,691,928,2011,95567
1440,118,52,66,2011,95568
1441,331,219,112,2011,95569
1442,2286,1191,1095,2011,95570
1443,87,53,34,2011,95571
1444,1197,618,579,2011,95573
1445,477,164,313,2011,95585
1446,27,21,6,2011,95587
1447,1114,504,610,2011,95589
1448,191,107,84,2011,95595
1449,213,118,95,2011,95601
1450,18263,9142,9121,2011,95602
1451,28001,13434,14567,2011,95603
1452,0,0,0,2011,95604
1453,13039,6258,6781,2011,95605
1454,187,87,100,2011,95606
1455,364,174,190,2011,95607
1456,61399,29402,31997,2011,95608
1457,43566,21338,22228,2011,95610
1458,1238,575,663,2011,95612
1459,4059,1983,2076,2011,95614
1460,1047,564,483,2011,95615
1461,48127,22178,25949,2011,95616
1462,26679,13952,12727,2011,95618
1463,5246,2623,2623,2011,95619
1464,20272,9971,10301,2011,95620
1465,40944,19266,21678,2011,95621
1466,3685,1949,1736,2011,95623
1467,58693,28516,30177,2011,95624
1468,143,58,85,2011,95625
1469,5832,2886,2946,2011,95626
1470,3481,1765,1716,2011,95627
1471,39002,19051,19951,2011,95628
1472,1041,488,553,2011,95629
1473,70520,39285,31235,2011,95630
1474,6081,2900,3181,2011,95631
1475,28909,14382,14527,2011,95632
1476,3399,1668,1731,2011,95633
1477,2964,1544,1420,2011,95634
1478,1250,649,601,2011,95635
1479,923,571,352,2011,95636
1480,473,197,276,2011,95637
1481,2059,1136,923,2011,95638
1482,206,64,142,2011,95639
1483,11152,7489,3663,2011,95640
1484,1674,895,779,2011,95641
1485,6330,3105,3225,2011,95642
1486,1688,1001,687,2011,95645
1487,123,41,82,2011,95646
1488,44892,21504,23388,2011,95648
1489,11596,5875,5721,2011,95650
1490,460,181,279,2011,95651
1491,946,464,482,2011,95652
1492,308,136,172,2011,95653
1493,4643,2088,2555,2011,95655
1494,6553,3095,3458,2011,95658
1495,759,398,361,2011,95659
1496,30695,14903,15792,2011,95660
1497,30730,14956,15774,2011,95661
1498,31712,16040,15672,2011,95662
1499,2738,1301,1437,2011,95663
1500,1032,540,492,2011,95664
1501,4971,2478,2493,2011,95665
1502,5310,2470,2840,2011,95666
1503,36713,17915,18798,2011,95667
1504,980,546,434,2011,95668
1505,2509,1280,1229,2011,95669
1506,52757,26238,26519,2011,95670
1507,5374,2747,2627,2011,95672
1508,14589,7238,7351,2011,95673
1509,796,401,395,2011,95674
1510,578,365,213,2011,95675
1511,23591,11170,12421,2011,95677
1512,41215,20463,20752,2011,95678
1513,29,8,21,2011,95679
1514,42,0,42,2011,95680
1515,1444,736,708,2011,95681
1516,28938,14132,14806,2011,95682
1517,7015,3188,3827,2011,95683
1518,2918,1460,1458,2011,95684
1519,4954,2469,2485,2011,95685
1520,1020,536,484,2011,95686
1521,65467,36372,29095,2011,95687
1522,33595,16380,17215,2011,95688
1523,1088,533,555,2011,95689
1524,1678,859,819,2011,95690
1525,34310,16482,17828,2011,95691
1526,5145,2549,2596,2011,95692
1527,5873,2977,2896,2011,95693
1528,9764,4868,4896,2011,95694
1529,37712,18244,19468,2011,95695
1530,335,227,108,2011,95697
1531,164,130,34,2011,95698
1532,138,105,33,2011,95699
1533,755,374,381,2011,95701
1534,1038,565,473,2011,95703
1535,4173,2135,2038,2011,95709
1536,8855,4376,4479,2011,95713
1537,354,210,144,2011,95714
1538,96,45,51,2011,95715
1539,176,75,101,2011,95717
1540,72,43,29,2011,95720
1541,14,14,0,2011,95721
1542,4397,2188,2209,2011,95722
1543,0,0,0,2011,95724
1544,9402,4519,4883,2011,95726
1545,227,87,140,2011,95728
1546,17,11,6,2011,95735
1547,260,138,122,2011,95736
1548,7896,4096,3800,2011,95742
1549,23220,11636,11584,2011,95746
1550,49554,23912,25642,2011,95747
1551,38705,20366,18339,2011,95757
1552,59496,27929,31567,2011,95758
1553,39336,19906,19430,2011,95762
1554,32831,15953,16878,2011,95765
1555,21848,11224,10624,2011,95776
1556,7096,3681,3415,2011,95811
1557,9155,5624,3531,2011,95814
1558,25727,12741,12986,2011,95815
1559,16195,7569,8626,2011,95816
1560,13006,5858,7148,2011,95817
1561,20317,9426,10891,2011,95818
1562,16561,7479,9082,2011,95819
1563,33573,15745,17828,2011,95820
1564,32860,15396,17464,2011,95821
1565,41315,19170,22145,2011,95822
1566,74609,35486,39123,2011,95823
1567,31097,16286,14811,2011,95824
1568,30777,14628,16149,2011,95825
1569,37748,18693,19055,2011,95826
1570,20223,9792,10431,2011,95827
1571,59409,29385,30024,2011,95828
1572,25850,12815,13035,2011,95829
1573,856,453,403,2011,95830
1574,41345,19264,22081,2011,95831
1575,12556,6153,6403,2011,95832
1576,36997,17068,19929,2011,95833
1577,23715,12107,11608,2011,95834
1578,35980,18710,17270,2011,95835
1579,346,221,125,2011,95837
1580,35604,18042,17562,2011,95838
1581,19143,9013,10130,2011,95841
1582,31547,15615,15932,2011,95842
1583,45549,21239,24310,2011,95843
1584,21646,10420,11226,2011,95864
1585,32266,16011,16255,2011,95901
1586,2279,1362,917,2011,95903
1587,82,57,25,2011,95910
1588,4548,2236,2312,2011,95912
1589,614,285,329,2011,95914
1590,56,14,42,2011,95915
1591,1370,761,609,2011,95916
1592,3541,1926,1615,2011,95917
1593,1773,855,918,2011,95918
1594,1672,858,814,2011,95919
1595,475,224,251,2011,95920
1596,610,320,290,2011,95922
1597,22,10,12,2011,95923
1598,247,90,157,2011,95925
1599,38064,19022,19042,2011,95926
1600,37059,17928,19131,2011,95928
1601,0,0,0,2011,95930
1602,7716,4066,3650,2011,95932
1603,249,78,171,2011,95934
1604,359,250,109,2011,95935
1605,192,125,67,2011,95936
1606,1278,554,724,2011,95937
1607,3797,2024,1773,2011,95938
1608,579,280,299,2011,95939
1609,491,291,200,2011,95941
1610,1352,724,628,2011,95942
1611,903,496,407,2011,95943
1612,156,66,90,2011,95944
1613,24162,11435,12727,2011,95945
1614,9814,4825,4989,2011,95946
1615,1899,937,962,2011,95947
1616,10251,5365,4886,2011,95948
1617,20505,10034,10471,2011,95949
1618,805,489,316,2011,95950
1619,2769,1508,1261,2011,95951
1620,10241,4962,5279,2011,95953
1621,12262,5978,6284,2011,95954
1622,1500,730,770,2011,95955
1623,376,197,179,2011,95956
1624,890,422,468,2011,95957
1625,18235,9086,9149,2011,95959
1626,876,396,480,2011,95960
1627,25552,12839,12713,2011,95961
1628,1073,655,418,2011,95962
1629,15003,7523,7480,2011,95963
1630,19735,10106,9629,2011,95965
1631,31303,15345,15958,2011,95966
1632,1544,708,836,2011,95968
1633,27735,13377,14358,2011,95969
1634,418,211,207,2011,95970
1635,5940,2762,3178,2011,95971
1636,30415,14735,15680,2011,95973
1637,0,0,0,2011,95974
1638,1645,901,744,2011,95975
1639,1410,757,653,2011,95977
1640,58,30,28,2011,95978
1641,517,328,189,2011,95979
1642,82,50,32,2011,95981
1643,3241,1590,1651,2011,95982
1644,558,374,184,2011,95983
1645,79,35,44,2011,95984
1646,19,0,19,2011,95986
1647,6013,3048,2965,2011,95987
1648,8664,4295,4369,2011,95988
1649,40719,19562,21157,2011,95991
1650,35798,18635,17163,2011,95993
1651,33577,16065,17512,2011,96001
1652,34875,16667,18208,2011,96002
1653,44404,21534,22870,2011,96003
1654,615,321,294,2011,96006
1655,22469,11183,11286,2011,96007
1656,839,509,330,2011,96008
1657,585,306,279,2011,96009
1658,192,100,92,2011,96010
1659,181,88,93,2011,96011
1660,3614,1772,1842,2011,96013
1661,210,116,94,2011,96014
1662,647,361,286,2011,96015
1663,624,325,299,2011,96016
1664,200,87,113,2011,96017
1665,10063,5122,4941,2011,96019
1666,2008,998,1010,2011,96020
1667,15417,7874,7543,2011,96021
1668,16335,8164,8171,2011,96022
1669,1166,594,572,2011,96023
1670,1274,676,598,2011,96024
1671,2444,1176,1268,2011,96025
1672,2271,1175,1096,2011,96027
1673,1676,800,876,2011,96028
1674,136,63,73,2011,96029
1675,131,63,68,2011,96031
1676,2378,1256,1122,2011,96032
1677,343,185,158,2011,96033
1678,334,191,143,2011,96034
1679,3359,1890,1469,2011,96035
1680,395,192,203,2011,96037
1681,480,177,303,2011,96038
1682,1180,565,615,2011,96039
1683,198,105,93,2011,96040
1684,2391,1353,1038,2011,96041
1685,1186,571,615,2011,96044
1686,214,110,104,2011,96046
1687,716,396,320,2011,96047
1688,1039,484,555,2011,96048
1689,101,65,36,2011,96049
1690,467,254,213,2011,96050
1691,996,549,447,2011,96051
1692,1624,999,625,2011,96052
1693,332,167,165,2011,96054
1694,4358,2200,2158,2011,96055
1695,1332,657,675,2011,96056
1696,1622,772,850,2011,96057
1697,672,311,361,2011,96058
1698,703,382,321,2011,96059
1699,46,23,23,2011,96061
1700,1023,518,505,2011,96062
1701,133,73,60,2011,96063
1702,4173,2061,2112,2011,96064
1703,341,227,114,2011,96065
1704,7320,3541,3779,2011,96067
1705,279,236,43,2011,96068
1706,929,474,455,2011,96069
1707,49,29,20,2011,96071
1708,4484,2333,2151,2011,96073
1709,230,187,43,2011,96074
1710,355,223,132,2011,96075
1711,134,82,52,2011,96076
1712,29057,13917,15140,2011,96080
1713,629,279,350,2011,96084
1714,37,25,12,2011,96085
1715,384,209,175,2011,96086
1716,456,287,169,2011,96087
1717,4412,2432,1980,2011,96088
1718,383,184,199,2011,96090
1719,755,407,348,2011,96091
1720,213,102,111,2011,96092
1721,4259,1923,2336,2011,96093
1722,6385,3349,3036,2011,96094
1723,724,374,350,2011,96096
1724,10084,4950,5134,2011,96097
1725,4760,2358,2402,2011,96101
1726,1334,645,689,2011,96103
1727,775,354,421,2011,96104
1728,665,282,383,2011,96105
1729,239,134,105,2011,96106
1730,1498,868,630,2011,96107
1731,0,0,0,2011,96108
1732,659,309,350,2011,96109
1733,120,57,63,2011,96110
1734,64,18,46,2011,96111
1735,169,87,82,2011,96112
1736,1884,1542,342,2011,96113
1737,3075,1640,1435,2011,96114
1738,195,68,127,2011,96115
1739,340,152,188,2011,96116
1740,225,114,111,2011,96117
1741,1512,796,716,2011,96118
1742,36,18,18,2011,96119
1743,1012,550,462,2011,96120
1744,262,122,140,2011,96121
1745,4575,2392,2183,2011,96122
1746,15,8,7,2011,96123
1747,445,140,305,2011,96124
1748,298,89,209,2011,96125
1749,229,132,97,2011,96126
1750,491,283,208,2011,96128
1751,215,127,88,2011,96129
1752,22192,14296,7896,2011,96130
1753,46,33,13,2011,96132
1754,113,38,75,2011,96133
1755,2641,1415,1226,2011,96134
1756,79,37,42,2011,96135
1757,170,82,88,2011,96136
1758,3605,2070,1535,2011,96137
1759,1248,625,623,2011,96140
1760,607,296,311,2011,96141
1761,785,416,369,2011,96142
1762,3582,2130,1452,2011,96143
1763,3017,1718,1299,2011,96145
1764,921,415,506,2011,96146
1765,855,378,477,2011,96148
1766,29206,15087,14119,2011,96150
1767,0,0,0,2011,96155
1768,17887,9421,8466,2011,96161
1769,709,388,321,2011,97635
